"cCode","village","SumOfMale","SumOfFemale","PopTotal","ProvCode","DistCode","SectCode","CellCode"
101010102,"Gihanga",294,258,552,1,101,10101,1010101
101010103,"Iterambere",330,262,592,1,101,10101,1010101
101010104,"Izuba",261,242,503,1,101,10101,1010101
101010105,"Nyaburanga",157,150,307,1,101,10101,1010101
101010106,"Nyenyeri",288,290,578,1,101,10101,1010101
101010107,"Ubukorikori",170,149,319,1,101,10101,1010101
101010108,"Ubumwe",260,203,463,1,101,10101,1010101
101010109,"Ubwiyunge",293,278,571,1,101,10101,1010101
101010110,"Umucyo",302,234,536,1,101,10101,1010101
101010111,"Umurabyo",257,199,456,1,101,10101,1010101
101010112,"Umuseke",413,427,840,1,101,10101,1010101
101010113,"Vugizo",359,297,656,1,101,10101,1010101
101010201,"Akinyambo",328,236,564,1,101,10101,1010102
101010202,"Amayaga",308,253,561,1,101,10101,1010102
101010203,"Gitwa",330,252,582,1,101,10101,1010102
101010204,"Ituze",290,236,526,1,101,10101,1010102
101010205,"Mpazi",238,202,440,1,101,10101,1010102
101010301,"Amahoro",362,296,658,1,101,10101,1010103
101010302,"Impuhwe",354,337,691,1,101,10101,1010103
101010303,"Intsinzi",404,360,764,1,101,10101,1010103
101010304,"Kivumu",296,246,542,1,101,10101,1010103
101010305,"Ubumwe",296,269,565,1,101,10101,1010103
101010306,"Urukundo",230,259,489,1,101,10101,1010103
101010307,"Ururembo",257,265,522,1,101,10101,1010103
101010401,"Ingenzi",359,377,736,1,101,10101,1010104
101010402,"Sangwa",360,297,657,1,101,10101,1010104
101010403,"Umubano",311,251,562,1,101,10101,1010104
101010404,"Umucyo",396,345,741,1,101,10101,1010104
101010405,"Umuhoza",375,291,666,1,101,10101,1010104
101010406,"Umurava",281,239,520,1,101,10101,1010104
101010501,"Akabugenewe",153,141,294,1,101,10101,1010105
101010502,"Ihuriro",128,107,235,1,101,10101,1010105
101010503,"Isangano",245,180,425,1,101,10101,1010105
101010504,"Isano",255,255,510,1,101,10101,1010105
101010505,"Karitasi",144,130,274,1,101,10101,1010105
101010506,"Ubumanzi",163,114,277,1,101,10101,1010105
101010507,"Uburezi",149,140,289,1,101,10101,1010105
101010508,"Ubwiza",225,195,420,1,101,10101,1010105
101010509,"Umucyo",134,147,281,1,101,10101,1010105
101010510,"Umwembe",222,165,387,1,101,10101,1010105
101010511,"Urugano",195,201,396,1,101,10101,1010105
101010601,"Isangano",439,340,779,1,101,10101,1010106
101010602,"Kanunga",275,277,552,1,101,10101,1010106
101010603,"Kinyambo",320,223,543,1,101,10101,1010106
101010604,"Kivumu",366,226,592,1,101,10101,1010106
101010605,"Kora",381,307,688,1,101,10101,1010106
101010606,"Mpazi",325,264,589,1,101,10101,1010106
101010607,"Rugano",329,194,523,1,101,10101,1010106
101010608,"Rugari",355,318,673,1,101,10101,1010106
101010609,"Ubumwe",403,305,708,1,101,10101,1010106
101020101,"Bwimo",449,412,861,1,101,10102,1010201
101020102,"Gatare",415,403,818,1,101,10102,1010201
101020103,"Mubuga",232,319,551,1,101,10102,1010201
101020104,"Nyakirambi",224,251,475,1,101,10102,1010201
101020105,"Nyamweru",353,418,771,1,101,10102,1010201
101020106,"Ruhengeri",208,202,410,1,101,10102,1010201
101020201,"Bibungo",186,239,425,1,101,10102,1010202
101020202,"Bwiza ",208,245,453,1,101,10102,1010202
101020203,"Gateko",165,199,364,1,101,10102,1010202
101020204,"Kagasa",181,221,402,1,101,10102,1010202
101020205,"Nyabihu",260,257,517,1,101,10102,1010202
101020206,"Rutagara I",497,475,972,1,101,10102,1010202
101020207,"Rutagara Ii",296,306,602,1,101,10102,1010202
101020208,"Ruyenzi",471,419,890,1,101,10102,1010202
101020301,"Kagaramira",360,443,803,1,101,10102,1010203
101020302,"Ngendo",389,398,787,1,101,10102,1010203
101020303,"Nyarurama",183,207,390,1,101,10102,1010203
101020304,"Nyarusange",293,350,643,1,101,10102,1010203
101020305,"Rwakivumu",258,291,549,1,101,10102,1010203
101020306,"Taba",227,272,499,1,101,10102,1010203
101030101,"Akirwanda",245,226,471,1,101,10103,1010301
101030102,"Gisenga",261,273,534,1,101,10103,1010301
101030103,"Kadobogo",179,180,359,1,101,10103,1010301
101030104,"Kagarama",137,142,279,1,101,10103,1010301
101030105,"Kibisogi",167,192,359,1,101,10103,1010301
101030106,"Muganza",204,217,421,1,101,10103,1010301
101030107,"Murama",161,175,336,1,101,10103,1010301
101030108,"Rubuye",190,176,366,1,101,10103,1010301
101030109,"Ruhango",151,133,284,1,101,10103,1010301
101030110,"Ryasharangabo",122,119,241,1,101,10103,1010301
101030201,"Agakomeye",101,123,224,1,101,10103,1010302
101030202,"Akagugu",116,131,247,1,101,10103,1010302
101030203,"Amahoro",103,108,211,1,101,10103,1010302
101030204,"Amajyambere",134,149,283,1,101,10103,1010302
101030205,"Birambo",112,143,255,1,101,10103,1010302
101030206,"Isangano",111,121,232,1,101,10103,1010302
101030207,"Kanyabami",101,128,229,1,101,10103,1010302
101030208,"Karambo",111,113,224,1,101,10103,1010302
101030209,"Mwendo",99,93,192,1,101,10103,1010302
101030210,"Ruhuha",142,127,269,1,101,10103,1010302
101030211,"Ubuzima",112,131,243,1,101,10103,1010302
101030212,"Umutekano",117,121,238,1,101,10103,1010302
101030301,"Gakoni",239,273,512,1,101,10103,1010303
101030302,"Gatare",320,322,642,1,101,10103,1010303
101030303,"Giticyinyoni",591,507,1098,1,101,10103,1010303
101030304,"Kadobogo",215,233,448,1,101,10103,1010303
101030305,"Kamenge",622,539,1161,1,101,10103,1010303
101030306,"Karama",207,249,456,1,101,10103,1010303
101030307,"Kiruhura",965,869,1834,1,101,10103,1010303
101030308,"Nyabikoni",819,654,1473,1,101,10103,1010303
101030309,"Nyabugogo",461,396,857,1,101,10103,1010303
101030310,"Ruhondo",332,361,693,1,101,10103,1010303
101030401,"Misibya",109,131,240,1,101,10103,1010304
101030402,"Nyabitare",149,151,300,1,101,10103,1010304
101030403,"Ruhango",131,133,264,1,101,10103,1010304
101030404,"Ruharabuge",118,144,262,1,101,10103,1010304
101030405,"Ruriba",145,143,288,1,101,10103,1010304
101030406,"Ruzigimbogo",115,129,244,1,101,10103,1010304
101030407,"Ryamakomari",87,118,205,1,101,10103,1010304
101030408,"Tubungo",91,145,236,1,101,10103,1010304
101030501,"Akanyamirambo",80,90,170,1,101,10103,1010305
101030502,"Akinama",148,150,298,1,101,10103,1010305
101030503,"Makaga",140,117,257,1,101,10103,1010305
101030504,"Musimba",156,160,316,1,101,10103,1010305
101030505,"Ruhogo",159,155,314,1,101,10103,1010305
101030506,"Rwesero",162,176,338,1,101,10103,1010305
101030507,"Rweza",111,138,249,1,101,10103,1010305
101030508,"Vuganyana",163,144,307,1,101,10103,1010305
101040101,"Buhoro",439,405,844,1,101,10104,1010401
101040102,"Busasamana",369,325,694,1,101,10104,1010401
101040103,"Isimbi",486,469,955,1,101,10104,1010401
101040104,"Ituze",315,302,617,1,101,10104,1010401
101040105,"Karama",432,407,839,1,101,10104,1010401
101040106,"Karwarugabo",425,356,781,1,101,10104,1010401
101040107,"Kigabiro",328,277,605,1,101,10104,1010401
101040108,"Mataba",362,412,774,1,101,10104,1010401
101040109,"Munini",403,334,737,1,101,10104,1010401
101040110,"Ntaraga",435,323,758,1,101,10104,1010401
101040111,"Nunga",400,348,748,1,101,10104,1010401
101040112,"Rurama",471,488,959,1,101,10104,1010401
101040113,"Rutunga",601,486,1087,1,101,10104,1010401
101040114,"Tetero",453,400,853,1,101,10104,1010401
101040201,"Akamahoro",446,348,794,1,101,10104,1010402
101040202,"Akishinge",467,391,858,1,101,10104,1010402
101040203,"Akishuri",382,249,631,1,101,10104,1010402
101040204,"Amahumbezi",334,290,624,1,101,10104,1010402
101040205,"Inganzo",707,638,1345,1,101,10104,1010402
101040206,"Kigarama",391,349,740,1,101,10104,1010402
101040207,"Mpazi",568,432,1000,1,101,10104,1010402
101040208,"Mugina",451,388,839,1,101,10104,1010402
101040209,"Ubumwe",585,471,1056,1,101,10104,1010402
101040210,"Ubusabane",452,385,837,1,101,10104,1010402
101040211,"Umubano",340,275,615,1,101,10104,1010402
101040212,"Umurinzi",784,717,1501,1,101,10104,1010402
101040213,"Uruyange",318,278,596,1,101,10104,1010402
101040301,"Akabeza",442,244,686,1,101,10104,1010403
101040302,"Amahoro",739,666,1405,1,101,10104,1010403
101040303,"Birama",738,646,1384,1,101,10104,1010403
101040304,"Buhoro",376,325,701,1,101,10104,1010403
101040305,"Bwiza ",238,199,437,1,101,10104,1010403
101040306,"Byimana",369,373,742,1,101,10104,1010403
101040307,"Gakaraza",387,230,617,1,101,10104,1010403
101040308,"Gaseke",311,232,543,1,101,10104,1010403
101040309,"Ihuriro",489,380,869,1,101,10104,1010403
101040310,"Inkurunziza",386,316,702,1,101,10104,1010403
101040311,"Karambi",263,245,508,1,101,10104,1010403
101040312,"Kigina",327,263,590,1,101,10104,1010403
101040313,"Kimisagara ",519,411,930,1,101,10104,1010403
101040314,"Kove",218,189,407,1,101,10104,1010403
101040315,"Muganza",390,375,765,1,101,10104,1010403
101040316,"Nyabugogo",423,222,645,1,101,10104,1010403
101040317,"Nyagakoki",342,283,625,1,101,10104,1010403
101040318,"Nyakabingo ",345,280,625,1,101,10104,1010403
101040319,"Nyamabuye",475,389,864,1,101,10104,1010403
101040320,"Sangwa",360,364,724,1,101,10104,1010403
101040321,"Sano",308,256,564,1,101,10104,1010403
101050101,"Kamatamu",259,335,594,1,101,10105,1010501
101050102,"Kankuba",426,226,652,1,101,10105,1010501
101050103,"Karukina",249,255,504,1,101,10105,1010501
101050104,"Musave",402,167,569,1,101,10105,1010501
101050105,"Nyarumanga",122,149,271,1,101,10105,1010501
101050106,"Rugendabari",267,268,535,1,101,10105,1010501
101050201,"Ayabatanga",107,125,232,1,101,10105,1010502
101050202,"Kankurimba",145,137,282,1,101,10105,1010502
101050203,"Kavumu",127,149,276,1,101,10105,1010502
101050204,"Mubura",151,126,277,1,101,10105,1010502
101050205,"Murondo",142,150,292,1,101,10105,1010502
101050206,"Nyakabingo",80,106,186,1,101,10105,1010502
101050207,"Nyarubuye",173,192,365,1,101,10105,1010502
101050301,"Burema",238,272,510,1,101,10105,1010503
101050302,"Gahombo",127,157,284,1,101,10105,1010503
101050303,"Kabeza",209,209,418,1,101,10105,1010503
101050304,"Karambi",242,270,512,1,101,10105,1010503
101050305,"Kwisanga",214,193,407,1,101,10105,1010503
101050306,"Mageragere",227,218,445,1,101,10105,1010503
101050307,"Mataba",225,222,447,1,101,10105,1010503
101050308,"Rushubi",257,260,517,1,101,10105,1010503
101050401,"Akanakamageragere",171,187,358,1,101,10105,1010504
101050402,"Gatovu",174,188,362,1,101,10105,1010504
101050403,"Nyabitare",160,198,358,1,101,10105,1010504
101050404,"Nyarubande",316,297,613,1,101,10105,1010504
101050405,"Rubungo",187,186,373,1,101,10105,1010504
101050406,"Rwindonyi",105,104,209,1,101,10105,1010504
101050501,"Akabungo",144,166,310,1,101,10105,1010505
101050502,"Akamashinge",257,269,526,1,101,10105,1010505
101050503,"Maya",200,244,444,1,101,10105,1010505
101050504,"Nyarufunzo",212,242,454,1,101,10105,1010505
101050505,"Nyarurama",113,135,248,1,101,10105,1010505
101050506,"Rubete",243,262,505,1,101,10105,1010505
101050601,"Amahoro",210,251,461,1,101,10105,1010506
101050602,"Ayabaramba",263,296,559,1,101,10105,1010506
101050603,"Gikuyu",246,236,482,1,101,10105,1010506
101050604,"Iterambere",437,416,853,1,101,10105,1010506
101050605,"Nyabirondo",190,227,417,1,101,10105,1010506
101050606,"Nyarurenzi",265,243,508,1,101,10105,1010506
101050701,"Gisunzu",175,239,414,1,101,10105,1010507
101050702,"Mpanga",148,154,302,1,101,10105,1010507
101050703,"Nkomero",137,160,297,1,101,10105,1010507
101050704,"Runzenze",224,225,449,1,101,10105,1010507
101050705,"Uwurugenge",194,215,409,1,101,10105,1010507
101060101,"Amahoro",501,420,921,1,101,10106,1010601
101060102,"Amizero",571,496,1067,1,101,10106,1010601
101060103,"Inyarurembo",260,196,456,1,101,10106,1010601
101060104,"Kabirizi",537,473,1010,1,101,10106,1010601
101060105,"Ubuzima",653,509,1162,1,101,10106,1010601
101060106,"Uruhimbi",538,452,990,1,101,10106,1010601
101060201,"Icyeza",455,361,816,1,101,10106,1010602
101060202,"Ikana",374,226,600,1,101,10106,1010602
101060203,"Intwari",669,617,1286,1,101,10106,1010602
101060204,"Kabasengerezi",263,159,422,1,101,10106,1010602
101060301,"Hirwa",466,381,847,1,101,10106,1010603
101060302,"Ikaze",450,360,810,1,101,10106,1010603
101060303,"Imanzi",345,234,579,1,101,10106,1010603
101060304,"Ingenzi",273,223,496,1,101,10106,1010603
101060305,"Ituze",559,454,1013,1,101,10106,1010603
101060306,"Sangwa",627,520,1147,1,101,10106,1010603
101060307,"Umwezi",5274,980,6254,1,101,10106,1010603
101060401,"Abeza",450,358,808,1,101,10106,1010604
101060402,"Icyerekezo",536,301,837,1,101,10106,1010604
101060403,"Indatwa",379,254,633,1,101,10106,1010604
101060404,"Rwezangoro",514,453,967,1,101,10106,1010604
101060405,"Ubucuruzi",372,227,599,1,101,10106,1010604
101060406,"Umutekano",312,247,559,1,101,10106,1010604
101060501,"Imihigo",565,495,1060,1,101,10106,1010605
101060502,"Impala",347,306,653,1,101,10106,1010605
101060503,"Rugenge",466,439,905,1,101,10106,1010605
101060504,"Ubumanzi",552,580,1132,1,101,10106,1010605
101060601,"Indamutsa",413,274,687,1,101,10106,1010606
101060602,"Ingoro",558,416,974,1,101,10106,1010606
101060603,"Inkingi",306,275,581,1,101,10106,1010606
101060604,"Intiganda ",469,252,721,1,101,10106,1010606
101060605,"Iwacu",311,259,570,1,101,10106,1010606
101060606,"Tetero",714,397,1111,1,101,10106,1010606
101060701,"Bwahirimba",314,295,609,1,101,10106,1010607
101060702,"Duterimbere",436,339,775,1,101,10106,1010607
101060703,"Isangano",442,406,848,1,101,10106,1010607
101060704,"Nyanza",438,421,859,1,101,10106,1010607
101060705,"Urugwiro",356,359,715,1,101,10106,1010607
101060706,"Urwego",218,183,401,1,101,10106,1010607
101070101,"Kabusunzu",667,648,1315,1,101,10107,1010701
101070102,"Munanira ",613,527,1140,1,101,10107,1010701
101070103,"Ntaraga",680,635,1315,1,101,10107,1010701
101070104,"Nyagasozi",510,445,955,1,101,10107,1010701
101070105,"Rurembo",347,373,720,1,101,10107,1010701
101070201,"Gasiza",596,553,1149,1,101,10107,1010702
101070202,"Kamwiza",351,370,721,1,101,10107,1010702
101070203,"Kanyange",419,363,782,1,101,10107,1010702
101070204,"Karudandi",283,279,562,1,101,10107,1010702
101070205,"Kigabiro",752,926,1678,1,101,10107,1010702
101070206,"Kokobe",661,605,1266,1,101,10107,1010702
101070207,"Mucyuranyana ",495,435,930,1,101,10107,1010702
101070208,"Nkundumurimbo",427,400,827,1,101,10107,1010702
101070301,"Akinkware",485,458,943,1,101,10107,1010703
101070302,"Gapfupfu",328,284,612,1,101,10107,1010703
101070303,"Gasiza",468,431,899,1,101,10107,1010703
101070304,"Kariyeri",445,392,837,1,101,10107,1010703
101070305,"Kokobe",366,301,667,1,101,10107,1010703
101070306,"Munini",726,697,1423,1,101,10107,1010703
101070307,"Nyakabanda",475,355,830,1,101,10107,1010703
101070308,"Rwagitanga",588,536,1124,1,101,10107,1010703
101070401,"Ibuhoro",576,585,1161,1,101,10107,1010704
101070402,"Kabeza",234,196,430,1,101,10107,1010704
101070403,"Kanyiranganji",345,326,671,1,101,10107,1010704
101070404,"Karujongi",280,241,521,1,101,10107,1010704
101070405,"Kigarama",181,188,369,1,101,10107,1010704
101070406,"Kirwa",531,461,992,1,101,10107,1010704
101080101,"Amizero",462,448,910,1,101,10108,1010801
101080102,"Gabiro",460,413,873,1,101,10108,1010801
101080103,"Imanzi",527,435,962,1,101,10108,1010801
101080104,"Ingenzi",346,321,667,1,101,10108,1010801
101080105,"Intwari",504,410,914,1,101,10108,1010801
101080106,"Karisimbi",396,419,815,1,101,10108,1010801
101080107,"Mahoro",212,201,413,1,101,10108,1010801
101080108,"Mpano",457,447,904,1,101,10108,1010801
101080109,"Muhabura",364,356,720,1,101,10108,1010801
101080110,"Muhoza",495,508,1003,1,101,10108,1010801
101080111,"Munini",250,221,471,1,101,10108,1010801
101080112,"Rugero",434,439,873,1,101,10108,1010801
101080113,"Shema",359,353,712,1,101,10108,1010801
101080201,"Kagunga",385,415,800,1,101,10108,1010802
101080202,"Karukoro",239,268,507,1,101,10108,1010802
101080203,"Rwintare",163,165,328,1,101,10108,1010802
101080301,"Akanyana",475,430,905,1,101,10108,1010803
101080302,"Akanyirazaninka",528,569,1097,1,101,10108,1010803
101080303,"Akarekare",655,632,1287,1,101,10108,1010803
101080304,"Akatabaro",510,404,914,1,101,10108,1010803
101080305,"Irembo ",579,489,1068,1,101,10108,1010803
101080306,"Itaba",570,575,1145,1,101,10108,1010803
101080307,"Kiberinka",654,559,1213,1,101,10108,1010803
101080308,"Mumena",968,835,1803,1,101,10108,1010803
101080309,"Rwampara",546,423,969,1,101,10108,1010803
101080401,"Gatare",684,655,1339,1,101,10108,1010804
101080402,"Kiberinka",300,342,642,1,101,10108,1010804
101080403,"Munanira",979,841,1820,1,101,10108,1010804
101080404,"Riba",407,410,817,1,101,10108,1010804
101080405,"Rubona",475,494,969,1,101,10108,1010804
101080406,"Rugarama",837,909,1746,1,101,10108,1010804
101080407,"Runyinya",369,343,712,1,101,10108,1010804
101080408,"Rusisiro",769,741,1510,1,101,10108,1010804
101080409,"Tetero ",564,518,1082,1,101,10108,1010804
101090101,"Agatare",520,513,1033,1,101,10109,1010901
101090102,"Amajyambere ",332,282,614,1,101,10109,1010901
101090103,"Inyambo",363,330,693,1,101,10109,1010901
101090104,"Meraneza",461,465,926,1,101,10109,1010901
101090105,"Uburezi",315,225,540,1,101,10109,1010901
101090106,"Umucyo",185,164,349,1,101,10109,1010901
101090107,"Umurava",282,273,555,1,101,10109,1010901
101090201,"Biryogo",441,404,845,1,101,10109,1010902
101090202,"Gabiro",635,510,1145,1,101,10109,1010902
101090203,"Isoko",291,195,486,1,101,10109,1010902
101090204,"Nyiranuma",409,373,782,1,101,10109,1010902
101090205,"Umurimo",455,363,818,1,101,10109,1010902
101090301,"Amizero",361,283,644,1,101,10109,1010903
101090302,"Cercle Sportif",637,591,1228,1,101,10109,1010903
101090303,"Ganza ",145,96,241,1,101,10109,1010903
101090304,"Imena",334,294,628,1,101,10109,1010903
101090305,"Indangamirwa",281,508,789,1,101,10109,1010903
101090306,"Ingenzi",193,156,349,1,101,10109,1010903
101090307,"Inyarurembo",783,261,1044,1,101,10109,1010903
101090308,"Ishema",158,118,276,1,101,10109,1010903
101090309,"Isibo",1472,417,1889,1,101,10109,1010903
101090310,"Muhabura ",327,221,548,1,101,10109,1010903
101090311,"Rugunga ",569,491,1060,1,101,10109,1010903
101090312,"Sugira",341,270,611,1,101,10109,1010903
101090401,"Amahoro",420,344,764,1,101,10109,1010904
101090402,"Gacaca ",483,449,932,1,101,10109,1010904
101090403,"Intwari",445,348,793,1,101,10109,1010904
101090404,"Rwampara",554,584,1138,1,101,10109,1010904
101090405,"Umucyo ",633,559,1192,1,101,10109,1010904
101090406,"Umuganda",349,346,695,1,101,10109,1010904
101100101,"Muhoza",408,366,774,1,101,10110,1011001
101100102,"Muhuza",179,165,344,1,101,10110,1011001
101100103,"Mumararungu",671,576,1247,1,101,10110,1011001
101100104,"Murambi",641,581,1222,1,101,10110,1011001
101100201,"Buhoro",667,552,1219,1,101,10110,1011002
101100202,"Gasabo",627,534,1161,1,101,10110,1011002
101100203,"Mutara",600,512,1112,1,101,10110,1011002
101100204,"Ubusabane",366,358,724,1,101,10110,1011002
101100301,"Abatarushwa",1305,1206,2511,1,101,10110,1011003
101100302,"Indatwa",742,673,1415,1,101,10110,1011003
101100303,"Inkerakubanza",604,623,1227,1,101,10110,1011003
101100304,"Intwari",871,738,1609,1,101,10110,1011003
101100401,"Amahoro",547,383,930,1,101,10110,1011004
101100402,"Umucyo",630,506,1136,1,101,10110,1011004
101100403,"Urumuri",374,271,645,1,101,10110,1011004
102010101,"Akakaza",230,284,514,1,102,10201,1020101
102010102,"Kigarama",173,205,378,1,102,10201,1020101
102010103,"Kingabo",205,225,430,1,102,10201,1020101
102010104,"Muhozi",173,181,354,1,102,10201,1020101
102010105,"Rubungo",247,267,514,1,102,10201,1020101
102010106,"Ryakigogo",145,162,307,1,102,10201,1020101
102010107,"Zindiro",504,486,990,1,102,10201,1020101
102010201,"Kagarama",301,305,606,1,102,10201,1020102
102010202,"Kayumba",235,263,498,1,102,10201,1020102
102010203,"Ramba",232,231,463,1,102,10201,1020102
102010204,"Rebero",241,273,514,1,102,10201,1020102
102010205,"Rugando",252,273,525,1,102,10201,1020102
102010301,"Kigabiro",313,356,669,1,102,10201,1020103
102010302,"Kiyoro",213,286,499,1,102,10201,1020103
102010303,"Murarambo",142,179,321,1,102,10201,1020103
102010304,"Nkona",162,220,382,1,102,10201,1020103
102010305,"Nyakabingo",132,154,286,1,102,10201,1020103
102010306,"Rukoma",157,162,319,1,102,10201,1020103
102010401,"Birembo",242,295,537,1,102,10201,1020104
102010402,"Gisasa",333,356,689,1,102,10201,1020104
102010403,"Munini",305,348,653,1,102,10201,1020104
102010404,"Ruhinga",296,322,618,1,102,10201,1020104
102010405,"Uwaruraza",240,314,554,1,102,10201,1020104
102010501,"Akabenejuru",233,259,492,1,102,10201,1020105
102010502,"Akasedogo",326,366,692,1,102,10201,1020105
102010503,"Akimpama",220,277,497,1,102,10201,1020105
102010504,"Burima",309,314,623,1,102,10201,1020105
102010505,"Kityazo",262,317,579,1,102,10201,1020105
102010601,"Bushya",101,103,204,1,102,10201,1020106
102010602,"Gikumba",133,161,294,1,102,10201,1020106
102010603,"Kamutamu",167,188,355,1,102,10201,1020106
102010604,"Karama",327,367,694,1,102,10201,1020106
102010605,"Kayenzi",275,283,558,1,102,10201,1020106
102010606,"Kigara",159,192,351,1,102,10201,1020106
102010607,"Kiriza",89,88,177,1,102,10201,1020106
102010608,"Masizi",251,234,485,1,102,10201,1020106
102010609,"Mbogo",105,124,229,1,102,10201,1020106
102010610,"Nyampamo",137,153,290,1,102,10201,1020106
102010701,"Akanyiramugarura",201,216,417,1,102,10201,1020107
102010702,"Akigabiro",229,221,450,1,102,10201,1020107
102010703,"Gishaka",413,417,830,1,102,10201,1020107
102010704,"Kabuye",157,178,335,1,102,10201,1020107
102010705,"Mpabwa",227,274,501,1,102,10201,1020107
102010706,"Nyagasambu",304,333,637,1,102,10201,1020107
102010707,"Urutarishonga",236,235,471,1,102,10201,1020107
102020101,"Akamamana",267,235,502,1,102,10202,1020201
102020102,"Akimihigo",213,197,410,1,102,10202,1020201
102020103,"Bigega",216,231,447,1,102,10202,1020201
102020104,"Busasamana",390,358,748,1,102,10202,1020201
102020105,"Kingasire",235,179,414,1,102,10202,1020201
102020106,"Kumuyange",357,330,687,1,102,10202,1020201
102020107,"Muremera",254,241,495,1,102,10202,1020201
102020108,"Nyagasozi",400,465,865,1,102,10202,1020201
102020109,"Rugoro",261,258,519,1,102,10202,1020201
102020110,"Rwesero",310,320,630,1,102,10202,1020201
102020111,"Tetero",198,196,394,1,102,10202,1020201
102020201,"Agakomeye",462,404,866,1,102,10202,1020202
102020202,"Gashubi",429,348,777,1,102,10202,1020202
102020203,"Gisiza",410,376,786,1,102,10202,1020202
102020204,"Hanika",432,370,802,1,102,10202,1020202
102020205,"Juru",448,419,867,1,102,10202,1020202
102020206,"Kibaya",221,235,456,1,102,10202,1020202
102020207,"Mpakabavu",264,199,463,1,102,10202,1020202
102020208,"Musango",432,368,800,1,102,10202,1020202
102020209,"Ndengo",279,217,496,1,102,10202,1020202
102020210,"Nyakabande",282,227,509,1,102,10202,1020202
102020211,"Nyakanunga",448,432,880,1,102,10202,1020202
102020212,"Rubonobono",320,308,628,1,102,10202,1020202
102020213,"Runyonza",395,257,652,1,102,10202,1020202
102020214,"Rusoro",162,141,303,1,102,10202,1020202
102020215,"Ruvumero",358,338,696,1,102,10202,1020202
102020216,"Uwagatovu",420,375,795,1,102,10202,1020202
102020301,"Agataramo",374,365,739,1,102,10202,1020203
102020302,"Akamwunguzi",490,429,919,1,102,10202,1020203
102020303,"Akarubimbura",258,217,475,1,102,10202,1020203
102020304,"Akisoko",200,187,387,1,102,10202,1020203
102020305,"Amarembo",284,276,560,1,102,10202,1020203
102020306,"Amizero",256,201,457,1,102,10202,1020203
102020307,"Bwiza",267,584,851,1,102,10202,1020203
102020308,"Ihuriro",581,264,845,1,102,10202,1020203
102020309,"Isangano",511,396,907,1,102,10202,1020203
102020310,"Kanyonyomba",242,204,446,1,102,10202,1020203
102020311,"Nyakariba",268,276,544,1,102,10202,1020203
102020312,"Rwakarihejuru",450,460,910,1,102,10202,1020203
102030101,"Bwimiyange",366,416,782,1,102,10203,1020301
102030102,"Bwingeyo",333,384,717,1,102,10203,1020301
102030103,"Gasagara",351,348,699,1,102,10203,1020301
102030104,"Rugwiza",385,383,768,1,102,10203,1020301
102030201,"Ntaganzwa",401,465,866,1,102,10203,1020302
102030202,"Nyagasozi",368,405,773,1,102,10203,1020302
102030203,"Nyagisozi",380,400,780,1,102,10203,1020302
102030204,"Ruganda",332,373,705,1,102,10203,1020302
102030301,"Gahinga",398,434,832,1,102,10203,1020303
102030302,"Gasharu",299,343,642,1,102,10203,1020303
102030303,"Kibobo",363,378,741,1,102,10203,1020303
102030304,"Nombe",406,441,847,1,102,10203,1020303
102030401,"Munini",266,285,551,1,102,10203,1020304
102030402,"Mutokerezwa",317,343,660,1,102,10203,1020304
102030403,"Rudakabukirwa",547,497,1044,1,102,10203,1020304
102030404,"Runyinya",332,354,686,1,102,10203,1020304
102030501,"Kimisebeya",295,340,635,1,102,10203,1020305
102030502,"Kivugiza",259,335,594,1,102,10203,1020305
102030503,"Rugarama",305,350,655,1,102,10203,1020305
102030504,"Twina",721,413,1134,1,102,10203,1020305
102040101,"Amajyambere",732,744,1476,1,102,10204,1020401
102040102,"Amarembo",777,633,1410,1,102,10204,1020401
102040103,"Byimana",481,872,1353,1,102,10204,1020401
102040104,"Gasave",661,598,1259,1,102,10204,1020401
102040105,"Gasharu",612,528,1140,1,102,10204,1020401
102040106,"Kagara",748,625,1373,1,102,10204,1020401
102040107,"Nyakariba",633,641,1274,1,102,10204,1020401
102040108,"Rwinyana",158,137,295,1,102,10204,1020401
102040201,"Kanyinya",1285,1229,2514,1,102,10204,1020402
102040202,"Kumukenke",1310,1109,2419,1,102,10204,1020402
102040203,"Murambi",730,660,1390,1,102,10204,1020402
102040204,"Ntora",749,735,1484,1,102,10204,1020402
102040205,"Rukeri",844,794,1638,1,102,10204,1020402
102040206,"Umurava",691,591,1282,1,102,10204,1020402
102050101,"Akamatamu",230,245,475,1,102,10205,1020501
102050102,"Cyeyere",468,487,955,1,102,10205,1020501
102050103,"Murehe",355,380,735,1,102,10205,1020501
102050104,"Nyacyonga",244,145,389,1,102,10205,1020501
102050105,"Nyagasozi",255,323,578,1,102,10205,1020501
102050106,"Nyarukurazo",300,315,615,1,102,10205,1020501
102050201,"Agakenke",253,272,525,1,102,10205,1020502
102050202,"Agatare",253,255,508,1,102,10205,1020502
102050203,"Akinyana",330,356,686,1,102,10205,1020502
102050204,"Gikingo",217,251,468,1,102,10205,1020502
102050205,"Gitega",385,372,757,1,102,10205,1020502
102050206,"Gitenga",218,241,459,1,102,10205,1020502
102050207,"Nyakabingo",149,196,345,1,102,10205,1020502
102050208,"Nyarurama",160,197,357,1,102,10205,1020502
102050209,"Rugogwe",266,322,588,1,102,10205,1020502
102050210,"Taba",239,282,521,1,102,10205,1020502
102050301,"Amakawa",361,390,751,1,102,10205,1020503
102050302,"Amasangano",687,505,1192,1,102,10205,1020503
102050303,"Buliza",319,351,670,1,102,10205,1020503
102050304,"Ihuriro",298,334,632,1,102,10205,1020503
102050305,"Kabeza",367,330,697,1,102,10205,1020503
102050306,"Karuruma",308,232,540,1,102,10205,1020503
102050307,"Murama",295,282,577,1,102,10205,1020503
102050308,"Nyagasozi",266,290,556,1,102,10205,1020503
102050309,"Rebero",318,374,692,1,102,10205,1020503
102050310,"Rugarama",307,317,624,1,102,10205,1020503
102050311,"Tetero",465,441,906,1,102,10205,1020503
102050401,"Agasekabuye",184,235,419,1,102,10205,1020504
102050402,"Agatare",296,325,621,1,102,10205,1020504
102050403,"Amasangano",278,316,594,1,102,10205,1020504
102050404,"Mubuga",277,308,585,1,102,10205,1020504
102050405,"Nyamweru",225,310,535,1,102,10205,1020504
102050501,"Agahama",244,280,524,1,102,10205,1020505
102050502,"Agasharu",214,262,476,1,102,10205,1020505
102050503,"Akabuga",165,206,371,1,102,10205,1020505
102050504,"Jurwe",151,164,315,1,102,10205,1020505
102050505,"Kiberinka",237,309,546,1,102,10205,1020505
102050506,"Nyakirehe",356,450,806,1,102,10205,1020505
102050507,"Nyarubuye",204,218,422,1,102,10205,1020505
102050508,"Rubona",307,248,555,1,102,10205,1020505
102050509,"Rwanyanza",343,353,696,1,102,10205,1020505
102050510,"Uwanyange",360,344,704,1,102,10205,1020505
102060101,"Bugarama",279,316,595,1,102,10206,1020601
102060102,"Bukamba",285,283,568,1,102,10206,1020601
102060103,"Byimana",418,427,845,1,102,10206,1020601
102060104,"Kabizoza",222,229,451,1,102,10206,1020601
102060105,"Kinunga",643,541,1184,1,102,10206,1020601
102060106,"Runyinya",343,377,720,1,102,10206,1020601
102060107,"Rwankuba",338,321,659,1,102,10206,1020601
102060201,"Akabande",394,446,840,1,102,10206,1020602
102060202,"Gatare",330,359,689,1,102,10206,1020602
102060203,"Nyamugali",285,376,661,1,102,10206,1020602
102060204,"Nyarubuye",280,276,556,1,102,10206,1020602
102060301,"Gahinga",319,361,680,1,102,10206,1020603
102060302,"Gatare",311,346,657,1,102,10206,1020603
102060303,"Umunyinya",384,477,861,1,102,10206,1020603
102060401,"Agatwa",272,310,582,1,102,10206,1020604
102060402,"Kabagina",250,309,559,1,102,10206,1020604
102060403,"Kajevuba",306,320,626,1,102,10206,1020604
102060404,"Kigarama",268,343,611,1,102,10206,1020604
102060405,"Nyagasayo",271,300,571,1,102,10206,1020604
102060501,"Byimana",218,308,526,1,102,10206,1020605
102060502,"Kirehe",352,348,700,1,102,10206,1020605
102060503,"Mataba",267,316,583,1,102,10206,1020605
102060504,"Nyarurembo",264,278,542,1,102,10206,1020605
102060505,"Rubona",292,303,595,1,102,10206,1020605
102060601,"Bwocya",288,343,631,1,102,10206,1020606
102060602,"Gitaba",302,338,640,1,102,10206,1020606
102060603,"Karenge",317,359,676,1,102,10206,1020606
102060604,"Rugina",255,303,558,1,102,10206,1020606
102060605,"Ruhihi",382,398,780,1,102,10206,1020606
102060701,"Agasharu",194,295,489,1,102,10206,1020607
102060702,"Agatare",386,455,841,1,102,10206,1020607
102060703,"Kabuga",227,265,492,1,102,10206,1020607
102060704,"Urunyinya",321,408,729,1,102,10206,1020607
102070101,"Amajyambere",843,671,1514,1,102,10207,1020701
102070102,"Bukinanyana",570,554,1124,1,102,10207,1020701
102070103,"Cyimana",440,354,794,1,102,10207,1020701
102070104,"Gataba",252,215,467,1,102,10207,1020701
102070105,"Itetero",497,445,942,1,102,10207,1020701
102070106,"Kabare",959,832,1791,1,102,10207,1020701
102070107,"Kamuhire",1215,1062,2277,1,102,10207,1020701
102070108,"Karukamba",757,713,1470,1,102,10207,1020701
102070109,"Nyagacyamo",164,102,266,1,102,10207,1020701
102070110,"Rwinzovu",461,412,873,1,102,10207,1020701
102070111,"Urugwiro ",406,312,718,1,102,10207,1020701
102070112,"Uruhongore",354,352,706,1,102,10207,1020701
102070201,"Agasaro",573,486,1059,1,102,10207,1020702
102070202,"Gasharu",538,458,996,1,102,10207,1020702
102070203,"Inkingi",773,578,1351,1,102,10207,1020702
102070204,"Kanserege",912,839,1751,1,102,10207,1020702
102070205,"Kigugu",1137,897,2034,1,102,10207,1020702
102070206,"Ruganwa",554,498,1052,1,102,10207,1020702
102070207,"Umuco",476,403,879,1,102,10207,1020702
102070208,"Umutekano",267,195,462,1,102,10207,1020702
102070209,"Urugero",1104,952,2056,1,102,10207,1020702
102070210,"Urwibutso",700,446,1146,1,102,10207,1020702
102070301,"Amahoro",682,625,1307,1,102,10207,1020703
102070302,"Bwiza",236,237,473,1,102,10207,1020703
102070303,"Ihuriro",669,485,1154,1,102,10207,1020703
102070304,"Ineza",260,234,494,1,102,10207,1020703
102070305,"Inyange",340,356,696,1,102,10207,1020703
102070306,"Iriba",519,399,918,1,102,10207,1020703
102070307,"Kabagari",349,294,643,1,102,10207,1020703
102070308,"Ubumwe",615,590,1205,1,102,10207,1020703
102070309,"Umutako",619,546,1165,1,102,10207,1020703
102070310,"Urukundo",997,891,1888,1,102,10207,1020703
102070311,"Virunga",337,299,636,1,102,10207,1020703
102080101,"Inyamibwa",946,760,1706,1,102,10208,1020801
102080102,"Isangano",560,437,997,1,102,10208,1020801
102080103,"Isano",506,325,831,1,102,10208,1020801
102080104,"Ituze",700,481,1181,1,102,10208,1020801
102080105,"Izuba",882,754,1636,1,102,10208,1020801
102080106,"Juru",663,544,1207,1,102,10208,1020801
102080107,"Nyenyeri",510,433,943,1,102,10208,1020801
102080108,"Umurava",469,400,869,1,102,10208,1020801
102080109,"Urumuri",419,341,760,1,102,10208,1020801
102080201,"Amahoro",515,451,966,1,102,10208,1020802
102080202,"Amajyambere",1289,176,1465,1,102,10208,1020802
102080203,"Imihigo",223,191,414,1,102,10208,1020802
102080204,"Intambwe",779,615,1394,1,102,10208,1020802
102080205,"Mutara",60,52,112,1,102,10208,1020802
102080206,"Rugarama",579,445,1024,1,102,10208,1020802
102080207,"Ubumwe",670,495,1165,1,102,10208,1020802
102080208,"Umutekano",181,143,324,1,102,10208,1020802
102080209,"Urwego",791,637,1428,1,102,10208,1020802
102080301,"Gasange",667,622,1289,1,102,10208,1020803
102080302,"Gasasa",1050,870,1920,1,102,10208,1020803
102080303,"Marembo",665,643,1308,1,102,10208,1020803
102080304,"Rebero",189,199,388,1,102,10208,1020803
102080305,"Taba",410,329,739,1,102,10208,1020803
102090101,"Abatuje",269,262,531,1,102,10209,1020901
102090102,"Amariza",605,589,1194,1,102,10209,1020901
102090103,"Imanzi",752,611,1363,1,102,10209,1020901
102090104,"Imena",874,928,1802,1,102,10209,1020901
102090105,"Imitari",338,302,640,1,102,10209,1020901
102090106,"Inganji",330,306,636,1,102,10209,1020901
102090107,"Ingenzi",474,440,914,1,102,10209,1020901
102090108,"Ingeri",427,422,849,1,102,10209,1020901
102090109,"Inshuti",455,363,818,1,102,10209,1020901
102090110,"Intashyo",954,884,1838,1,102,10209,1020901
102090111,"Intwari",596,533,1129,1,102,10209,1020901
102090112,"Inyamibwa",698,534,1232,1,102,10209,1020901
102090113,"Inyange",854,749,1603,1,102,10209,1020901
102090114,"Ubwiza",706,531,1237,1,102,10209,1020901
102090115,"Umwezi",633,531,1164,1,102,10209,1020901
102090201,"Akintwari",350,339,689,1,102,10209,1020902
102090202,"Buranga",435,362,797,1,102,10209,1020902
102090203,"Gasharu",547,446,993,1,102,10209,1020902
102090204,"Ibuhoro",848,753,1601,1,102,10209,1020902
102090205,"Kageyo",5087,456,5543,1,102,10209,1020902
102090206,"Kamahinda",386,306,692,1,102,10209,1020902
102090207,"Karisimbi",428,369,797,1,102,10209,1020902
102090208,"Karongi",285,310,595,1,102,10209,1020902
102090209,"Nyirabwana",608,607,1215,1,102,10209,1020902
102090210,"Ramiro",281,198,479,1,102,10209,1020902
102090211,"Rindiro",1079,953,2032,1,102,10209,1020902
102090212,"Rugero",227,182,409,1,102,10209,1020902
102090213,"Rukurazo",731,638,1369,1,102,10209,1020902
102090214,"Rumuri",221,181,402,1,102,10209,1020902
102090301,"Bukinanyana",1078,982,2060,1,102,10209,1020903
102090302,"Ibuhoro",908,884,1792,1,102,10209,1020903
102090303,"Ijabiro",2016,1193,3209,1,102,10209,1020903
102090304,"Isangano",511,408,919,1,102,10209,1020903
102090305,"Itetero",936,729,1665,1,102,10209,1020903
102090306,"Urugwiro ",1998,1583,3581,1,102,10209,1020903
102100101,"Agatare",1341,1056,2397,1,102,10210,1021001
102100102,"Akanyamugabo",716,595,1311,1,102,10210,1021001
102100103,"Akarambo",795,597,1392,1,102,10210,1021001
102100104,"Akaruvusha",840,678,1518,1,102,10210,1021001
102100105,"Bishikiri",1763,1350,3113,1,102,10210,1021001
102100106,"Cyeru",916,760,1676,1,102,10210,1021001
102100107,"Gacuriro 2020",568,432,1000,1,102,10210,1021001
102100108,"Kabuhunde Ii",733,577,1310,1,102,10210,1021001
102100109,"Kirira",1144,891,2035,1,102,10210,1021001
102100110,"Urubanda",899,735,1634,1,102,10210,1021001
102100111,"Urugarama",389,350,739,1,102,10210,1021001
102100201,"Agatare",472,511,983,1,102,10210,1021002
102100202,"Gasharu",352,433,785,1,102,10210,1021002
102100203,"Kami",1377,393,1770,1,102,10210,1021002
102100204,"Rwankuba",281,325,606,1,102,10210,1021002
102100301,"Dusenyi",338,318,656,1,102,10210,1021003
102100302,"Gicikiza",662,570,1232,1,102,10210,1021003
102100303,"Giheka",529,521,1050,1,102,10210,1021003
102100304,"Kabuhunde I",1095,1054,2149,1,102,10210,1021003
102100305,"Kadobogo",1919,1682,3601,1,102,10210,1021003
102100306,"Kagarama",245,211,456,1,102,10210,1021003
102100307,"Muhororo",332,349,681,1,102,10210,1021003
102100308,"Nyakabungo",644,612,1256,1,102,10210,1021003
102100309,"Rukingu",977,918,1895,1,102,10210,1021003
102100401,"Binunga",702,699,1401,1,102,10210,1021004
102100402,"Ngaruyinka",612,710,1322,1,102,10210,1021004
102100403,"Rusenyi",1167,1116,2283,1,102,10210,1021004
102100404,"Taba",686,657,1343,1,102,10210,1021004
102110101,"Akarwasa",199,206,405,1,102,10211,1021101
102110102,"Akasemuromba",186,243,429,1,102,10211,1021101
102110103,"Bucyemba",229,245,474,1,102,10211,1021101
102110104,"Gasharu",123,155,278,1,102,10211,1021101
102110105,"Kagarama",269,298,567,1,102,10211,1021101
102110106,"Ruhangare",160,190,350,1,102,10211,1021101
102110201,"Ayabakora",566,593,1159,1,102,10211,1021102
102110202,"Cyaruzinge",284,310,594,1,102,10211,1021102
102110203,"Gashure",264,303,567,1,102,10211,1021102
102110204,"Gatare",226,264,490,1,102,10211,1021102
102110205,"Gisura",211,209,420,1,102,10211,1021102
102110206,"Karubibi",280,256,536,1,102,10211,1021102
102110207,"Murindi",396,405,801,1,102,10211,1021102
102110301,"Bahoze",594,478,1072,1,102,10211,1021103
102110302,"Berwa",906,886,1792,1,102,10211,1021103
102110303,"Buhoro",428,463,891,1,102,10211,1021103
102110304,"Burunga",291,338,629,1,102,10211,1021103
102110305,"Gitaraga",213,251,464,1,102,10211,1021103
102110306,"Kira",363,392,755,1,102,10211,1021103
102110307,"Nezerwa",336,389,725,1,102,10211,1021103
102110308,"Rugazi",327,363,690,1,102,10211,1021103
102110309,"Runyonza",405,399,804,1,102,10211,1021103
102110310,"Tumurere",240,208,448,1,102,10211,1021103
102110311,"Ururembo",554,453,1007,1,102,10211,1021103
102110401,"Byimana",58,56,114,1,102,10211,1021104
102110402,"Kabeza",113,92,205,1,102,10211,1021104
102110403,"Masoro",717,612,1329,1,102,10211,1021104
102110404,"Matwari",442,363,805,1,102,10211,1021104
102110405,"Mubuga",608,635,1243,1,102,10211,1021104
102110406,"Munini",161,140,301,1,102,10211,1021104
102110501,"Akamusare",247,263,510,1,102,10211,1021105
102110502,"Akimana",247,269,516,1,102,10211,1021105
102110503,"Gasharu",333,360,693,1,102,10211,1021105
102110504,"Jurwe",208,251,459,1,102,10211,1021105
102110505,"Karambo",327,321,648,1,102,10211,1021105
102110506,"Kigabiro",270,328,598,1,102,10211,1021105
102110507,"Ruseno",163,182,345,1,102,10211,1021105
102110601,"Kacyinyaga",190,232,422,1,102,10211,1021106
102110602,"Kamahoro",255,276,531,1,102,10211,1021106
102110603,"Munini",212,260,472,1,102,10211,1021106
102110604,"Nyakagezi",280,303,583,1,102,10211,1021106
102110605,"Ruhangare",186,217,403,1,102,10211,1021106
102110606,"Ruhogo",272,322,594,1,102,10211,1021106
102120101,"Kanani",160,195,355,1,102,10212,1021201
102120102,"Kidahe",192,232,424,1,102,10212,1021201
102120103,"Kigabiro",243,280,523,1,102,10212,1021201
102120104,"Nyamurambi",235,257,492,1,102,10212,1021201
102120105,"Nyarubuye",192,238,430,1,102,10212,1021201
102120106,"Nyura",143,148,291,1,102,10212,1021201
102120201,"Gatagara",195,199,394,1,102,10212,1021202
102120202,"Kagarama",147,132,279,1,102,10212,1021202
102120203,"Nyabitare",180,248,428,1,102,10212,1021202
102120204,"Nyakabungo",220,232,452,1,102,10212,1021202
102120205,"Nyarubande",199,216,415,1,102,10212,1021202
102120206,"Uruhetse",162,191,353,1,102,10212,1021202
102120301,"Agacyamo",185,183,368,1,102,10212,1021203
102120302,"Gashinya",200,243,443,1,102,10212,1021203
102120303,"Gikombe",140,175,315,1,102,10212,1021203
102120304,"Kazi",183,196,379,1,102,10212,1021203
102120305,"Kigufi",216,243,459,1,102,10212,1021203
102120306,"Nyirakibehe",269,323,592,1,102,10212,1021203
102120307,"Uruhahiro",206,220,426,1,102,10212,1021203
102120401,"Agasharu",106,146,252,1,102,10212,1021204
102120402,"Amataba",151,164,315,1,102,10212,1021204
102120403,"Burungero",186,219,405,1,102,10212,1021204
102120404,"Karama",129,156,285,1,102,10212,1021204
102120405,"Nyange",141,173,314,1,102,10212,1021204
102120406,"Rebero",155,164,319,1,102,10212,1021204
102120407,"Uruyange",184,215,399,1,102,10212,1021204
102120501,"Gatobotobo",204,239,443,1,102,10212,1021205
102120502,"Kibungo",178,212,390,1,102,10212,1021205
102120503,"Musezero",350,235,585,1,102,10212,1021205
102120504,"Nyaburoro",154,197,351,1,102,10212,1021205
102120505,"Taba",164,198,362,1,102,10212,1021205
102120601,"Bikumba",182,192,374,1,102,10212,1021206
102120602,"Gakizi",198,224,422,1,102,10212,1021206
102120603,"Gatare",193,221,414,1,102,10212,1021206
102120604,"Kamuyange",158,187,345,1,102,10212,1021206
102120605,"Kigarama",239,278,517,1,102,10212,1021206
102120606,"Ngara",226,289,515,1,102,10212,1021206
102120701,"Akazi",213,245,458,1,102,10212,1021207
102120702,"Kaduha",231,273,504,1,102,10212,1021207
102120703,"Kamuhoza",195,238,433,1,102,10212,1021207
102120704,"Mirambi",271,332,603,1,102,10212,1021207
102120705,"Munini",218,246,464,1,102,10212,1021207
102120706,"Ndanyoye",155,102,257,1,102,10212,1021207
102120707,"Nyamigina",258,280,538,1,102,10212,1021207
102120708,"Rugarama",198,274,472,1,102,10212,1021207
102130101,"Amarembo I",999,769,1768,1,102,10213,1021301
102130102,"Amarembo Il",964,857,1821,1,102,10213,1021301
102130103,"Gihogere",803,621,1424,1,102,10213,1021301
102130104,"Kagara",786,680,1466,1,102,10213,1021301
102130105,"Kinunga",848,789,1637,1,102,10213,1021301
102130106,"Nyabisindu",1066,964,2030,1,102,10213,1021301
102130107,"Rugarama",913,905,1818,1,102,10213,1021301
102130201,"Gishushu",643,483,1126,1,102,10213,1021302
102130202,"Juru",325,292,617,1,102,10213,1021302
102130203,"Kamahwa",506,324,830,1,102,10213,1021302
102130204,"Kangondo I",705,548,1253,1,102,10213,1021302
102130205,"Kangondo Ii",1174,958,2132,1,102,10213,1021302
102130206,"Kibiraro I",1017,764,1781,1,102,10213,1021302
102130207,"Kibiraro Ii",710,436,1146,1,102,10213,1021302
102130301,"Agashyitsi",488,369,857,1,102,10213,1021303
102130302,"Amajyambere",719,528,1247,1,102,10213,1021303
102130303,"Izuba",1156,816,1972,1,102,10213,1021303
102130304,"Kisimenti",385,329,714,1,102,10213,1021303
102130305,"Ubumwe",466,385,851,1,102,10213,1021303
102130306,"Ukwezi",472,362,834,1,102,10213,1021303
102130307,"Urumuri",510,460,970,1,102,10213,1021303
102130401,"Amahoro",974,630,1604,1,102,10213,1021304
102130402,"Rebero",482,341,823,1,102,10213,1021304
102130403,"Ruturusu I",370,389,759,1,102,10213,1021304
102130404,"Ruturusu Ii",518,532,1050,1,102,10213,1021304
102130405,"Ubumwe",642,613,1255,1,102,10213,1021304
102140101,"Bisenga",315,264,579,1,102,10214,1021401
102140102,"Gakenyeri",326,317,643,1,102,10214,1021401
102140103,"Gasiza",268,284,552,1,102,10214,1021401
102140104,"Kidogo",235,260,495,1,102,10214,1021401
102140201,"Agatare",213,222,435,1,102,10214,1021402
102140202,"Gasagara",251,266,517,1,102,10214,1021402
102140203,"Kamasasa",217,251,468,1,102,10214,1021402
102140204,"Rugagi",251,276,527,1,102,10214,1021402
102140205,"Ryabazana",133,154,287,1,102,10214,1021402
102140301,"Abatangampundu",227,220,447,1,102,10214,1021403
102140302,"Amahoro",363,326,689,1,102,10214,1021403
102140303,"Isangano",671,610,1281,1,102,10214,1021403
102140304,"Kabeza",670,515,1185,1,102,10214,1021403
102140305,"Kalisimbi",509,550,1059,1,102,10214,1021403
102140306,"Masango",303,269,572,1,102,10214,1021403
102140401,"Bwiza",193,214,407,1,102,10214,1021404
102140402,"Cyanamo",164,166,330,1,102,10214,1021404
102140403,"Gatare",158,187,345,1,102,10214,1021404
102140404,"Kamashashi",264,347,611,1,102,10214,1021404
102140405,"Mataba",189,180,369,1,102,10214,1021404
102140406,"Nyagakombe",136,161,297,1,102,10214,1021404
102140407,"Ruhangare",161,189,350,1,102,10214,1021404
102140501,"Busenyi",202,209,411,1,102,10214,1021405
102140502,"Kigabiro",293,298,591,1,102,10214,1021405
102140503,"Kinyana",305,339,644,1,102,10214,1021405
102140504,"Nyagisozi",258,315,573,1,102,10214,1021405
102140601,"Cyeru",537,658,1195,1,102,10214,1021406
102140602,"Karambo",418,444,862,1,102,10214,1021406
102140603,"Kataruha",263,269,532,1,102,10214,1021406
102140604,"Mugeyo",304,344,648,1,102,10214,1021406
102140605,"Rugarama",197,192,389,1,102,10214,1021406
102140606,"Samuduha",427,406,833,1,102,10214,1021406
102140701,"Gisharara",831,905,1736,1,102,10214,1021407
102140702,"Kabutare",500,545,1045,1,102,10214,1021407
102140703,"Kanyinya",343,366,709,1,102,10214,1021407
102140704,"Kigarama",586,585,1171,1,102,10214,1021407
102140705,"Nyarucundura",286,293,579,1,102,10214,1021407
102140706,"Runyonza",748,755,1503,1,102,10214,1021407
102140707,"Urumuri",374,483,857,1,102,10214,1021407
102140801,"Kinyaga",176,192,368,1,102,10214,1021408
102140802,"Mirama",231,216,447,1,102,10214,1021408
102140803,"Nyagacyamo",203,226,429,1,102,10214,1021408
102140804,"Rugende",368,388,756,1,102,10214,1021408
102140805,"Ruhanga",253,291,544,1,102,10214,1021408
102150101,"Gasharu",250,318,568,1,102,10215,1021501
102150102,"Mulindi",185,239,424,1,102,10215,1021501
102150103,"Vugavuge",336,398,734,1,102,10215,1021501
102150201,"Kabarera",345,386,731,1,102,10215,1021502
102150202,"Kamusengo",331,396,727,1,102,10215,1021502
102150203,"Karekare",248,329,577,1,102,10215,1021502
102150204,"Karuranga",400,423,823,1,102,10215,1021502
102150205,"Nyakabande",234,310,544,1,102,10215,1021502
102150301,"Kabaliza",278,347,625,1,102,10215,1021503
102150302,"Nyamise",275,348,623,1,102,10215,1021503
102150303,"Rwanyanza",303,376,679,1,102,10215,1021503
102150401,"Cyili",309,385,694,1,102,10215,1021504
102150402,"Kacyatwa",297,360,657,1,102,10215,1021504
102150403,"Kandamira",269,300,569,1,102,10215,1021504
102150404,"Kantabana",223,262,485,1,102,10215,1021504
102150405,"Munini",235,280,515,1,102,10215,1021504
102150501,"Abanyangeyo",355,372,727,1,102,10215,1021505
102150502,"Kibenga",609,420,1029,1,102,10215,1021505
102150503,"Nyamvumvu",404,423,827,1,102,10215,1021505
102150601,"Kamusare",365,338,703,1,102,10215,1021506
102150602,"Karwiru",314,375,689,1,102,10215,1021506
102150603,"Kigabiro",270,314,584,1,102,10215,1021506
102150604,"Rukerereza",316,311,627,1,102,10215,1021506
102150605,"Rwintare",273,307,580,1,102,10215,1021506
103010101,"Gahanga",196,221,417,1,103,10301,1030101
103010102,"Gatare",261,292,553,1,103,10301,1030101
103010103,"Gatovu",245,258,503,1,103,10301,1030101
103010104,"Rinini",381,392,773,1,103,10301,1030101
103010105,"Rwinanka",263,287,550,1,103,10301,1030101
103010106,"Ubumwe",339,346,685,1,103,10301,1030101
103010201,"Kabeza",215,207,422,1,103,10301,1030102
103010202,"Kabidandi",292,320,612,1,103,10301,1030102
103010203,"Kiyanja",286,272,558,1,103,10301,1030102
103010204,"Nyacyonga",177,196,373,1,103,10301,1030102
103010205,"Nyagafunzo",246,211,457,1,103,10301,1030102
103010206,"Nyakuguma",280,298,578,1,103,10301,1030102
103010207,"Rugando Ii",157,153,310,1,103,10301,1030102
103010301,"Amahoro",186,190,376,1,103,10301,1030103
103010302,"Bigo",185,211,396,1,103,10301,1030103
103010303,"Kabeza",205,249,454,1,103,10301,1030103
103010304,"Kamuyinga",182,140,322,1,103,10301,1030103
103010305,"Karembure",213,252,465,1,103,10301,1030103
103010306,"Kimena",188,184,372,1,103,10301,1030103
103010307,"Mubuga",237,231,468,1,103,10301,1030103
103010308,"Rwamaya",171,192,363,1,103,10301,1030103
103010401,"Kampuro",102,117,219,1,103,10301,1030104
103010402,"Kigasa",152,145,297,1,103,10301,1030104
103010403,"Mashyiga",152,169,321,1,103,10301,1030104
103010404,"Nyabigugu",306,330,636,1,103,10301,1030104
103010405,"Nyamuharaza",137,147,284,1,103,10301,1030104
103010406,"Rukore",126,121,247,1,103,10301,1030104
103010407,"Runyoni",188,249,437,1,103,10301,1030104
103010408,"Sabununga",157,160,317,1,103,10301,1030104
103010501,"Kigarama",233,217,450,1,103,10301,1030105
103010502,"Kinyana",197,202,399,1,103,10301,1030105
103010503,"Mugendo ",406,270,676,1,103,10301,1030105
103010504,"Nunga I",265,236,501,1,103,10301,1030105
103010505,"Nunga Ii",176,190,366,1,103,10301,1030105
103010506,"Rugasa",237,249,486,1,103,10301,1030105
103010601,"Gahosha",196,207,403,1,103,10301,1030106
103010602,"Gashubi",177,171,348,1,103,10301,1030106
103010603,"Kaboshya",170,220,390,1,103,10301,1030106
103010604,"Karambo",173,173,346,1,103,10301,1030106
103010605,"Rebero",140,189,329,1,103,10301,1030106
103010606,"Rugando I",147,165,312,1,103,10301,1030106
103020101,"Amahoro",721,644,1365,1,103,10302,1030201
103020102,"Gakoki",775,735,1510,1,103,10302,1030201
103020103,"Gatenga",768,545,1313,1,103,10302,1030201
103020104,"Ihuriro",633,561,1194,1,103,10302,1030201
103020105,"Isangano",648,600,1248,1,103,10302,1030201
103020106,"Rugari",620,601,1221,1,103,10302,1030201
103020201,"Gwiza",501,461,962,1,103,10302,1030202
103020202,"Ihuriro",300,272,572,1,103,10302,1030202
103020203,"Jyambere",499,544,1043,1,103,10302,1030202
103020204,"Kamabuye",617,580,1197,1,103,10302,1030202
103020205,"Mahoro",718,653,1371,1,103,10302,1030202
103020206,"Ramiro",549,463,1012,1,103,10302,1030202
103020207,"Rebero",608,573,1181,1,103,10302,1030202
103020208,"Rugwiro",565,541,1106,1,103,10302,1030202
103020209,"Ruhuka",417,429,846,1,103,10302,1030202
103020210,"Sangwa",431,357,788,1,103,10302,1030202
103020301,"Bwiza",574,562,1136,1,103,10302,1030203
103020302,"Cyeza",392,380,772,1,103,10302,1030203
103020303,"Gasabo",380,362,742,1,103,10302,1030203
103020304,"Ihuriro",549,532,1081,1,103,10302,1030203
103020305,"Isonga",594,603,1197,1,103,10302,1030203
103020306,"Juru",551,559,1110,1,103,10302,1030203
103020307,"Marembo",367,338,705,1,103,10302,1030203
103020308,"Murambi",1057,997,2054,1,103,10302,1030203
103020309,"Nyanza",425,357,782,1,103,10302,1030203
103020310,"Rebero",304,280,584,1,103,10302,1030203
103020311,"Rusororo",394,431,825,1,103,10302,1030203
103020312,"Sabaganga",815,853,1668,1,103,10302,1030203
103020313,"Taba",675,600,1275,1,103,10302,1030203
103020401,"Bigo",449,517,966,1,103,10302,1030204
103020402,"Bisambu",367,353,720,1,103,10302,1030204
103020403,"Kabeza",487,325,812,1,103,10302,1030204
103020404,"Nyabikenke",317,414,731,1,103,10302,1030204
103030101,"Gatare",757,721,1478,1,103,10303,1030301
103030102,"Kabuye I",1078,989,2067,1,103,10303,1030301
103030103,"Kabuye Ii",347,313,660,1,103,10303,1030301
103030104,"Kagunga I",304,264,568,1,103,10303,1030301
103030105,"Kagunga Ii",317,288,605,1,103,10303,1030301
103030106,"Rebero",681,653,1334,1,103,10303,1030301
103030201,"Kanserege I",595,536,1131,1,103,10303,1030302
103030202,"Kanserege Ii",378,291,669,1,103,10303,1030302
103030203,"Kanserege Iii",450,347,797,1,103,10303,1030302
103030204,"Marembo I",640,344,984,1,103,10303,1030302
103030205,"Marembo Ii",860,782,1642,1,103,10303,1030302
103030206,"Marembo Iii",393,366,759,1,103,10303,1030302
103030301,"Kigugu I",160,119,279,1,103,10303,1030303
103030302,"Kigugu Ii",258,210,468,1,103,10303,1030303
103030303,"Kigugu Iii",232,209,441,1,103,10303,1030303
103030304,"Kinunga",603,516,1119,1,103,10303,1030303
103030305,"Ruganwa I",307,234,541,1,103,10303,1030303
103030306,"Ruganwa Ii",670,421,1091,1,103,10303,1030303
103030307,"Ruganwa Iii",205,185,390,1,103,10303,1030303
103040101,"Bwiza",352,300,652,1,103,10304,1030401
103040102,"Byimana",501,455,956,1,103,10304,1030401
103040103,"Ituze",199,199,398,1,103,10304,1030401
103040104,"Kanserege",209,157,366,1,103,10304,1030401
103040105,"Kinunga",410,389,799,1,103,10304,1030401
103040201,"Kamuna",159,127,286,1,103,10304,1030402
103040202,"Mugeyo",243,259,502,1,103,10304,1030402
103040203,"Muyange",370,373,743,1,103,10304,1030402
103040204,"Rugunga",364,317,681,1,103,10304,1030402
103040301,"Inshuti",528,490,1018,1,103,10304,1030403
103040302,"Mpingayanyanza",475,394,869,1,103,10304,1030403
103040303,"Nyacyonga",340,365,705,1,103,10304,1030403
103040304,"Nyanza ",679,488,1167,1,103,10304,1030403
103040305,"Rukatsa",717,653,1370,1,103,10304,1030403
103040306,"Taba",559,551,1110,1,103,10304,1030403
103050101,"Amahoro",175,188,363,1,103,10305,1030501
103050102,"Antene",375,395,770,1,103,10305,1030501
103050103,"Bamporeze I",173,191,364,1,103,10305,1030501
103050104,"Bamporeze Ii",103,121,224,1,103,10305,1030501
103050105,"Gashyushya ",346,357,703,1,103,10305,1030501
103050106,"Gishikiri",153,156,309,1,103,10305,1030501
103050107,"Hope",153,156,309,1,103,10305,1030501
103050108,"Kariyeri",110,142,252,1,103,10305,1030501
103050109,"Nyarugugu",148,171,319,1,103,10305,1030501
103050110,"Radari",255,237,492,1,103,10305,1030501
103050111,"Rukore",202,241,443,1,103,10305,1030501
103050201,"Akagera",481,490,971,1,103,10305,1030502
103050202,"Bwiza",575,466,1041,1,103,10305,1030502
103050203,"Gasabo",577,560,1137,1,103,10305,1030502
103050204,"Giporoso I",914,614,1528,1,103,10305,1030502
103050205,"Giporoso Ii",904,703,1607,1,103,10305,1030502
103050206,"Juru",406,380,786,1,103,10305,1030502
103050207,"Kabeza",503,514,1017,1,103,10305,1030502
103050208,"Karisimbi",422,348,770,1,103,10305,1030502
103050209,"Muhabura",595,498,1093,1,103,10305,1030502
103050210,"Mulindi",803,757,1560,1,103,10305,1030502
103050211,"Nyarurembo",863,779,1642,1,103,10305,1030502
103050212,"Nyenyeri",731,703,1434,1,103,10305,1030502
103050213,"Rebero",410,324,734,1,103,10305,1030502
103050301,"Bitare",263,315,578,1,103,10305,1030503
103050302,"Byimana",275,272,547,1,103,10305,1030503
103050303,"Cyurusagara",134,137,271,1,103,10305,1030503
103050304,"Gakorokombe",189,187,376,1,103,10305,1030503
103050305,"Gikundiro",280,249,529,1,103,10305,1030503
103050306,"Gitarama",134,147,281,1,103,10305,1030503
103050307,"Karama",273,234,507,1,103,10305,1030503
103050308,"Nyabyunyu",206,212,418,1,103,10305,1030503
103050309,"Nyarutovu",167,211,378,1,103,10305,1030503
103050310,"Urukundo",156,184,340,1,103,10305,1030503
103050401,"Beninka",951,716,1667,1,103,10305,1030504
103050402,"Bukunzi",294,282,576,1,103,10305,1030504
103050403,"Cyeru",553,494,1047,1,103,10305,1030504
103050404,"Intwari",323,303,626,1,103,10305,1030504
103050405,"Itunda ",934,778,1712,1,103,10305,1030504
103050406,"Kavumu",301,267,568,1,103,10305,1030504
103050407,"Susuruka",505,448,953,1,103,10305,1030504
103050408,"Ubumwe",717,555,1272,1,103,10305,1030504
103050409,"Umunara",238,197,435,1,103,10305,1030504
103050410,"Uwabarezi",759,681,1440,1,103,10305,1030504
103050411,"Zirakamwa",470,461,931,1,103,10305,1030504
103060101,"Amajyambere",357,262,619,1,103,10306,1030601
103060102,"Gasharu",257,222,479,1,103,10306,1030601
103060103,"Sakirwa",307,215,522,1,103,10306,1030601
103060104,"Umunyinya",307,272,579,1,103,10306,1030601
103060201,"Gashiha",495,408,903,1,103,10306,1030602
103060202,"Iriba",282,276,558,1,103,10306,1030602
103060203,"Multimedia",259,262,521,1,103,10306,1030602
103060204,"Umunyinya",206,248,454,1,103,10306,1030602
103060205,"Umuremure",265,177,442,1,103,10306,1030602
103060206,"Urugero",179,164,343,1,103,10306,1030602
103060301,"Gasave",296,243,539,1,103,10306,1030603
103060302,"Isoko",392,300,692,1,103,10306,1030603
103060303,"Karisimbi",528,491,1019,1,103,10306,1030603
103060304,"Kicukiro",824,715,1539,1,103,10306,1030603
103060305,"Triangle",279,237,516,1,103,10306,1030603
103060306,"Ubumwe",599,553,1152,1,103,10306,1030603
103060401,"Ahitegeye",403,336,739,1,103,10306,1030604
103060402,"Intaho",876,727,1603,1,103,10306,1030604
103060403,"Iriba",346,344,690,1,103,10306,1030604
103060404,"Isangano",699,644,1343,1,103,10306,1030604
103060405,"Urugero",367,328,695,1,103,10306,1030604
103070101,"Gakokobe",381,415,796,1,103,10307,1030701
103070102,"Gatare",246,290,536,1,103,10307,1030701
103070103,"Imena",352,343,695,1,103,10307,1030701
103070104,"Ituze",270,248,518,1,103,10307,1030701
103070105,"Kabutare",205,174,379,1,103,10307,1030701
103070106,"Kimisange",514,498,1012,1,103,10307,1030701
103070107,"Nyenyeri",338,421,759,1,103,10307,1030701
103070108,"Ubumenyi",328,333,661,1,103,10307,1030701
103070201,"Ibuga",582,453,1035,1,103,10307,1030702
103070202,"Ihuriro",422,360,782,1,103,10307,1030702
103070203,"Murambi",373,354,727,1,103,10307,1030702
103070204,"Rutoki",666,704,1370,1,103,10307,1030702
103070205,"Taba",350,375,725,1,103,10307,1030702
103070206,"Terimbere",567,532,1099,1,103,10307,1030702
103070207,"Ubutare",449,417,866,1,103,10307,1030702
103070208,"Umurimo",781,618,1399,1,103,10307,1030702
103070301,"Akimana",443,386,829,1,103,10307,1030703
103070302,"Amahoro ",456,469,925,1,103,10307,1030703
103070303,"Byimana",416,396,812,1,103,10307,1030703
103070304,"Indatwa",277,200,477,1,103,10307,1030703
103070305,"Ingenzi",322,295,617,1,103,10307,1030703
103070306,"Kabeza",405,381,786,1,103,10307,1030703
103070307,"Karurayi",366,360,726,1,103,10307,1030703
103070308,"Mataba",571,546,1117,1,103,10307,1030703
103070309,"Umucyo",659,622,1281,1,103,10307,1030703
103070401,"Kamabuye",306,344,650,1,103,10307,1030704
103070402,"Karuyenzi",409,391,800,1,103,10307,1030704
103070403,"Kivu",272,263,535,1,103,10307,1030704
103070404,"Rebero",287,324,611,1,103,10307,1030704
103070405,"Twishorezo",438,417,855,1,103,10307,1030704
103070406,"Zuba",271,318,589,1,103,10307,1030704
103070501,"Amajyambere",408,332,740,1,103,10307,1030705
103070502,"Bwiza",576,486,1062,1,103,10307,1030705
103070503,"Nyarurembo",491,466,957,1,103,10307,1030705
103070504,"Ubumwe",424,404,828,1,103,10307,1030705
103070505,"Umutekano",439,434,873,1,103,10307,1030705
103070506,"Urumuri",442,382,824,1,103,10307,1030705
103070507,"Uwateke",484,453,937,1,103,10307,1030705
103080101,"Akababyeyi",202,207,409,1,103,10308,1030801
103080102,"Ayabaraya",303,362,665,1,103,10308,1030801
103080103,"Nyamico",236,264,500,1,103,10308,1030801
103080104,"Nyamyijima",213,253,466,1,103,10308,1030801
103080105,"Nyirakavomo",257,264,521,1,103,10308,1030801
103080106,"Rususa",265,228,493,1,103,10308,1030801
103080201,"Biryogo",443,361,804,1,103,10308,1030802
103080202,"Bwiza",365,432,797,1,103,10308,1030802
103080203,"Cyimo",246,249,495,1,103,10308,1030802
103080204,"Kabeza",413,354,767,1,103,10308,1030802
103080205,"Kiyovu",305,344,649,1,103,10308,1030802
103080206,"Masaka",420,453,873,1,103,10308,1030802
103080207,"Murambi",418,432,850,1,103,10308,1030802
103080208,"Nyakagunga",372,421,793,1,103,10308,1030802
103080209,"Urugwiro",298,276,574,1,103,10308,1030802
103080301,"Bamporeze",259,255,514,1,103,10308,1030803
103080302,"Butangampundu",357,373,730,1,103,10308,1030803
103080303,"Butare",188,194,382,1,103,10308,1030803
103080304,"Cyugamo",428,418,846,1,103,10308,1030803
103080305,"Gicaca",169,197,366,1,103,10308,1030803
103080306,"Gihuke",316,360,676,1,103,10308,1030803
103080307,"Kabeza",585,580,1165,1,103,10308,1030803
103080308,"Kibande",186,207,393,1,103,10308,1030803
103080309,"Rebero",294,266,560,1,103,10308,1030803
103080310,"Rugende",247,181,428,1,103,10308,1030803
103080311,"Ruyaga",165,168,333,1,103,10308,1030803
103080401,"Gitaraga",325,342,667,1,103,10308,1030804
103080402,"Kabeza",261,244,505,1,103,10308,1030804
103080403,"Kajevuba",183,226,409,1,103,10308,1030804
103080404,"Nyakarambi",285,255,540,1,103,10308,1030804
103080405,"Nyange",191,187,378,1,103,10308,1030804
103080406,"Ruhanga",250,244,494,1,103,10308,1030804
103080407,"Rwintare",222,226,448,1,103,10308,1030804
103080501,"Kabeza",316,369,685,1,103,10308,1030805
103080502,"Kamashashi",280,270,550,1,103,10308,1030805
103080503,"Mbabe",352,445,797,1,103,10308,1030805
103080504,"Murambi",278,297,575,1,103,10308,1030805
103080505,"Ngarama",316,307,623,1,103,10308,1030805
103080506,"Sangano",281,312,593,1,103,10308,1030805
103080601,"Cyankongi",319,355,674,1,103,10308,1030806
103080602,"Cyeru",335,336,671,1,103,10308,1030806
103080603,"Gatare",330,320,650,1,103,10308,1030806
103080604,"Kagese",361,390,751,1,103,10308,1030806
103080605,"Kanyetabi",347,398,745,1,103,10308,1030806
103080606,"Mubano",351,386,737,1,103,10308,1030806
103080607,"Ruhosha",265,245,510,1,103,10308,1030806
103090101,"Byimana",370,265,635,1,103,10309,1030901
103090102,"Gatare",479,430,909,1,103,10309,1030901
103090103,"Imena",210,192,402,1,103,10309,1030901
103090104,"Kamahoro",271,278,549,1,103,10309,1030901
103090105,"Kigarama",351,303,654,1,103,10309,1030901
103090106,"Rugunga",504,389,893,1,103,10309,1030901
103090107,"Rurembo",249,200,449,1,103,10309,1030901
103090108,"Taba",370,221,591,1,103,10309,1030901
103090201,"Buhoro",187,169,356,1,103,10309,1030902
103090202,"Gaseke",188,159,347,1,103,10309,1030902
103090203,"Gateke",361,305,666,1,103,10309,1030902
103090204,"Gorora",342,297,639,1,103,10309,1030902
103090205,"Kigabiro",391,336,727,1,103,10309,1030902
103090206,"Kinunga",225,144,369,1,103,10309,1030902
103090207,"Kiruhura",411,372,783,1,103,10309,1030902
103090208,"Munini",210,161,371,1,103,10309,1030902
103090209,"Murehe",134,142,276,1,103,10309,1030902
103090210,"Mwijabo",225,197,422,1,103,10309,1030902
103090211,"Mwijuto",211,184,395,1,103,10309,1030902
103090212,"Nyarubande",348,326,674,1,103,10309,1030902
103090213,"Rwezamenyo",514,429,943,1,103,10309,1030902
103090214,"Sovu",325,273,598,1,103,10309,1030902
103090215,"Taba",206,226,432,1,103,10309,1030902
103090301,"Amahoro",371,325,696,1,103,10309,1030903
103090302,"Amarebe",232,245,477,1,103,10309,1030903
103090303,"Amarembo",393,321,714,1,103,10309,1030903
103090304,"Bigabiro",284,239,523,1,103,10309,1030903
103090305,"Bukinanyana",241,223,464,1,103,10309,1030903
103090306,"Bumanzi",250,190,440,1,103,10309,1030903
103090307,"Bwiza",189,147,336,1,103,10309,1030903
103090308,"Gatsibo",253,183,436,1,103,10309,1030903
103090309,"Gikundiro",618,595,1213,1,103,10309,1030903
103090310,"Indakemwa",384,359,743,1,103,10309,1030903
103090311,"Indamutsa",297,235,532,1,103,10309,1030903
103090312,"Indatwa",262,252,514,1,103,10309,1030903
103090313,"Inyarurembo",215,196,411,1,103,10309,1030903
103090314,"Isangano",192,183,375,1,103,10309,1030903
103090315,"Karama",236,212,448,1,103,10309,1030903
103090316,"Kinyana",184,197,381,1,103,10309,1030903
103090317,"Rugwiro",258,206,464,1,103,10309,1030903
103090318,"Umurava",329,292,621,1,103,10309,1030903
103100101,"Akindege",975,1000,1975,1,103,10310,1031001
103100102,"Indatwa",733,899,1632,1,103,10310,1031001
103100103,"Intwari",2879,650,3529,1,103,10310,1031001
103100104,"Kabagendwa",1532,1517,3049,1,103,10310,1031001
103100105,"Kibaya",487,453,940,1,103,10310,1031001
103100106,"Mukoni",464,426,890,1,103,10310,1031001
103100107,"Mulindi",768,660,1428,1,103,10310,1031001
103100108,"Umucyo",569,577,1146,1,103,10310,1031001
103100109,"Uruhongore",570,509,1079,1,103,10310,1031001
103100201,"Gasaraba",450,486,936,1,103,10310,1031002
103100202,"Gihanga",333,375,708,1,103,10310,1031002
103100203,"Gitara",671,627,1298,1,103,10310,1031002
103100204,"Kavumu",606,633,1239,1,103,10310,1031002
103100205,"Mahoro",554,537,1091,1,103,10310,1031002
103100206,"Nyarutovu",358,373,731,1,103,10310,1031002
103100207,"Rugali",385,399,784,1,103,10310,1031002
103100208,"Runyonza",650,558,1208,1,103,10310,1031002
103100301,"Gabiro",361,294,655,1,103,10310,1031003
103100302,"Kabaya",553,517,1070,1,103,10310,1031003
103100303,"Kanogo",486,509,995,1,103,10310,1031003
103100304,"Marembo",717,733,1450,1,103,10310,1031003
103100305,"Mushumbamwiza",426,465,891,1,103,10310,1031003
103100306,"Nyandungu",740,686,1426,1,103,10310,1031003
103100307,"Ruragendwa",499,439,938,1,103,10310,1031003
103100308,"Rwinyana",399,399,798,1,103,10310,1031003
103100309,"Rwinyange",544,535,1079,1,103,10310,1031003
103100310,"Rwiza",671,601,1272,1,103,10310,1031003
103100311,"Urwibutso",316,309,625,1,103,10310,1031003
201010101,"Bigega",342,300,642,2,201,20101,2010101
201010102,"Bugura",212,246,458,2,201,20101,2010101
201010103,"Kamatovu",452,381,833,2,201,20101,2010101
201010104,"Karama",162,210,372,2,201,20101,2010101
201010105,"Kavumu",230,253,483,2,201,20101,2010101
201010106,"Kibaga",260,301,561,2,201,20101,2010101
201010107,"Kiberinka",168,192,360,2,201,20101,2010101
201010108,"Nyakwibereka",187,238,425,2,201,20101,2010101
201010109,"Nyarutovu",158,165,323,2,201,20101,2010101
201010201,"Akirabo",297,320,617,2,201,20101,2010102
201010202,"Gihisi A",186,222,408,2,201,20101,2010102
201010203,"Gihisi B",550,368,918,2,201,20101,2010102
201010204,"Karukoranya A",222,217,439,2,201,20101,2010102
201010205,"Karukoranya B",197,226,423,2,201,20101,2010102
201010206,"Majyambere",466,364,830,2,201,20101,2010102
201010207,"Mugandamure A",274,331,605,2,201,20101,2010102
201010208,"Mugandamure B",158,171,329,2,201,20101,2010102
201010209,"Mukoni",499,528,1027,2,201,20101,2010102
201010210,"Nyagatovu",580,584,1164,2,201,20101,2010102
201010211,"Nyamagana B",114,343,457,2,201,20101,2010102
201010212,"Rukandiro",228,280,508,2,201,20101,2010102
201010213,"Ruvumera",154,170,324,2,201,20101,2010102
201010214,"Kavumu",143,211,354,2,201,20101,2010102
201010215,"Nyamagana A",104,141,245,2,201,20101,2010102
201010301,"Kabuzuru",277,303,580,2,201,20101,2010103
201010302,"Kigarama",217,255,472,2,201,20101,2010103
201010303,"Mukindo",295,378,673,2,201,20101,2010103
201010304,"Ngorongari",276,271,547,2,201,20101,2010103
201010305,"Rebero",206,241,447,2,201,20101,2010103
201010306,"Rugarama",198,216,414,2,201,20101,2010103
201010307,"Rugari A",164,180,344,2,201,20101,2010103
201010308,"Rugari B",264,293,557,2,201,20101,2010103
201010401,"Bunyeshywa",238,262,500,2,201,20101,2010104
201010402,"Gakenyeri A",462,516,978,2,201,20101,2010104
201010403,"Gakenyeri B",429,424,853,2,201,20101,2010104
201010404,"Gatare",269,273,542,2,201,20101,2010104
201010405,"Gatsinsino",395,347,742,2,201,20101,2010104
201010406,"Gatunguru",177,234,411,2,201,20101,2010104
201010407,"Gishike",212,298,510,2,201,20101,2010104
201010408,"Kavumu",841,760,1601,2,201,20101,2010104
201010409,"Kigarama",715,644,1359,2,201,20101,2010104
201010410,"Kivumu",3795,802,4597,2,201,20101,2010104
201010411,"Mugonzi",533,537,1070,2,201,20101,2010104
201010412,"Nyanza",650,553,1203,2,201,20101,2010104
201010413,"Nyarunyinya",165,172,337,2,201,20101,2010104
201010414,"Rubona",204,198,402,2,201,20101,2010104
201010501,"Bukinankwavu",264,283,547,2,201,20101,2010105
201010502,"Gahanda",249,296,545,2,201,20101,2010105
201010503,"Gisando",259,271,530,2,201,20101,2010105
201010504,"Kabona",184,185,369,2,201,20101,2010105
201010505,"Kidaturwa",264,349,613,2,201,20101,2010105
201010506,"Murambi",187,147,334,2,201,20101,2010105
201010507,"Mwima",272,297,569,2,201,20101,2010105
201010508,"Nyabisindu",196,282,478,2,201,20101,2010105
201010509,"Rugarama",297,359,656,2,201,20101,2010105
201010510,"Rukari",269,292,561,2,201,20101,2010105
201010511,"Rwesero",134,177,311,2,201,20101,2010105
201010512,"Taba",287,300,587,2,201,20101,2010105
201020101,"Gitega",350,396,746,2,201,20102,2010201
201020102,"Kabeza",324,390,714,2,201,20102,2010201
201020103,"Kayenzi",464,549,1013,2,201,20102,2010201
201020104,"Muhindo",272,289,561,2,201,20102,2010201
201020105,"Musumba",478,568,1046,2,201,20102,2010201
201020106,"Nazareti",254,269,523,2,201,20102,2010201
201020107,"Nyacyonga",239,257,496,2,201,20102,2010201
201020108,"Nyagasambu",265,299,564,2,201,20102,2010201
201020109,"Rushoka",199,259,458,2,201,20102,2010201
201020201,"Gitwa",323,337,660,2,201,20102,2010202
201020202,"Kimirama",345,372,717,2,201,20102,2010202
201020203,"Kireranyana",265,283,548,2,201,20102,2010202
201020204,"Ndamira",264,286,550,2,201,20102,2010202
201020205,"Nyamiyonga",223,251,474,2,201,20102,2010202
201020206,"Nyarugenge",420,433,853,2,201,20102,2010202
201020207,"Rugarama",538,612,1150,2,201,20102,2010202
201020301,"Busoro",428,405,833,2,201,20102,2010203
201020302,"Bweramana",445,395,840,2,201,20102,2010203
201020303,"Gikombe",286,336,622,2,201,20102,2010203
201020304,"Masangano",407,414,821,2,201,20102,2010203
201020305,"Murambi",232,251,483,2,201,20102,2010203
201020306,"Nyarugunga",276,306,582,2,201,20102,2010203
201020307,"Runyonza",379,465,844,2,201,20102,2010203
201020308,"Shinga",333,341,674,2,201,20102,2010203
201020401,"Kagarama",401,470,871,2,201,20102,2010204
201020402,"Karambi",344,425,769,2,201,20102,2010204
201020403,"Kigali",437,542,979,2,201,20102,2010204
201020404,"Kivugiza",471,534,1005,2,201,20102,2010204
201020405,"Rwara",385,433,818,2,201,20102,2010204
201020501,"Cyamugani",345,416,761,2,201,20102,2010205
201020502,"Cyuriro",210,222,432,2,201,20102,2010205
201020503,"Gasambu",386,456,842,2,201,20102,2010205
201020504,"Runazi",248,300,548,2,201,20102,2010205
201020505,"Rwanamiza",294,311,605,2,201,20102,2010205
201020506,"Rwangoga",281,296,577,2,201,20102,2010205
201020601,"Gahogo",423,460,883,2,201,20102,2010206
201020602,"Kinkanga",314,351,665,2,201,20102,2010206
201020603,"Nyamoyaga",461,509,970,2,201,20102,2010206
201020604,"Rucyamo",326,366,692,2,201,20102,2010206
201020605,"Rusharu",261,308,569,2,201,20102,2010206
201020606,"Saruduha",387,433,820,2,201,20102,2010206
201030101,"Gahengeri",281,328,609,2,201,20103,2010301
201030102,"Gasenyi",197,212,409,2,201,20103,2010301
201030103,"Gataba",195,230,425,2,201,20103,2010301
201030104,"Gitega",323,352,675,2,201,20103,2010301
201030105,"Kabere",258,301,559,2,201,20103,2010301
201030106,"Kabeza",305,369,674,2,201,20103,2010301
201030107,"Kadaho",167,215,382,2,201,20103,2010301
201030108,"Nyabisazi",310,385,695,2,201,20103,2010301
201030109,"Nyabyiyoni",165,226,391,2,201,20103,2010301
201030201,"Butembo",244,250,494,2,201,20103,2010302
201030202,"Cyarera",288,289,577,2,201,20103,2010302
201030203,"Gahondo",252,301,553,2,201,20103,2010302
201030204,"Gatongati",280,328,608,2,201,20103,2010302
201030205,"Kamabuye",269,308,577,2,201,20103,2010302
201030206,"Kamonyi",204,275,479,2,201,20103,2010302
201030207,"Karama",300,319,619,2,201,20103,2010302
201030208,"Nyabinombe",148,176,324,2,201,20103,2010302
201030301,"Kabuga",133,191,324,2,201,20103,2010303
201030302,"Kandihe",206,252,458,2,201,20103,2010303
201030303,"Karehe",188,210,398,2,201,20103,2010303
201030304,"Kimiyumbu",201,236,437,2,201,20103,2010303
201030305,"Nyabinyenga",291,304,595,2,201,20103,2010303
201030306,"Rugwa",204,219,423,2,201,20103,2010303
201030307,"Rwamagana",230,238,468,2,201,20103,2010303
201030308,"Taba",287,296,583,2,201,20103,2010303
201030401,"Kabyuma",184,177,361,2,201,20103,2010304
201030402,"Kigarama A",147,184,331,2,201,20103,2010304
201030403,"Kirombozi",150,174,324,2,201,20103,2010304
201030404,"Nyakabingo",191,191,382,2,201,20103,2010304
201030405,"Rugote",197,226,423,2,201,20103,2010304
201030406,"Ruvuzo",148,181,329,2,201,20103,2010304
201030407,"Rwabatwa",129,123,252,2,201,20103,2010304
201030408,"Rwamiko",290,332,622,2,201,20103,2010304
201030501,"Bikombe",261,282,543,2,201,20103,2010305
201030502,"Bugarama",211,245,456,2,201,20103,2010305
201030503,"Gahunga",221,254,475,2,201,20103,2010305
201030504,"Karambo",123,155,278,2,201,20103,2010305
201030505,"Kavumu",215,285,500,2,201,20103,2010305
201030506,"Murambi",252,265,517,2,201,20103,2010305
201030507,"Nyabishike",244,292,536,2,201,20103,2010305
201030508,"Nyaminazi",248,269,517,2,201,20103,2010305
201030509,"Nyarutovu",162,198,360,2,201,20103,2010305
201030510,"Rugendabari",275,339,614,2,201,20103,2010305
201040101,"Gasagara",310,351,661,2,201,20104,2010401
201040102,"Gisika",309,378,687,2,201,20104,2010401
201040103,"Kamatamu",374,471,845,2,201,20104,2010401
201040104,"Karama",287,343,630,2,201,20104,2010401
201040105,"Matara",425,468,893,2,201,20104,2010401
201040106,"Muyebe",465,476,941,2,201,20104,2010401
201040107,"Nyamunini",689,778,1467,2,201,20104,2010401
201040108,"Rutete",262,321,583,2,201,20104,2010401
201040201,"Binyana",325,329,654,2,201,20104,2010402
201040202,"Gako",335,425,760,2,201,20104,2010402
201040203,"Gihama",382,446,828,2,201,20104,2010402
201040204,"Karambi",466,530,996,2,201,20104,2010402
201040205,"Karehe",419,507,926,2,201,20104,2010402
201040206,"Kigarama",368,451,819,2,201,20104,2010402
201040207,"Mukoni",402,511,913,2,201,20104,2010402
201040208,"Rukore",329,374,703,2,201,20104,2010402
201040301,"Gatongati",438,514,952,2,201,20104,2010403
201040302,"Gicumbi",714,747,1461,2,201,20104,2010403
201040303,"Kabeza",761,869,1630,2,201,20104,2010403
201040304,"Kanyinya",422,471,893,2,201,20104,2010403
201040305,"Kivugiza",489,541,1030,2,201,20104,2010403
201040306,"Masangano",412,434,846,2,201,20104,2010403
201040401,"Bigarama",297,302,599,2,201,20104,2010404
201040402,"Kabuga",252,324,576,2,201,20104,2010404
201040403,"Kibilizi",463,571,1034,2,201,20104,2010404
201040404,"Mubano",246,315,561,2,201,20104,2010404
201040405,"Mubuga",225,270,495,2,201,20104,2010404
201040406,"Mutima",237,276,513,2,201,20104,2010404
201040407,"Nyarurama",559,631,1190,2,201,20104,2010404
201040408,"Runyonza",179,231,410,2,201,20104,2010404
201040409,"Rusagara",207,288,495,2,201,20104,2010404
201040410,"Saruhembe",336,436,772,2,201,20104,2010404
201050101,"Butatsinda",475,257,732,2,201,20105,2010501
201050102,"Gitare",349,341,690,2,201,20105,2010501
201050103,"Ishusho",271,299,570,2,201,20105,2010501
201050104,"Karama",308,398,706,2,201,20105,2010501
201050105,"Karambo",347,365,712,2,201,20105,2010501
201050106,"Kayange",226,247,473,2,201,20105,2010501
201050107,"Kibaza",201,229,430,2,201,20105,2010501
201050108,"Kigoma",237,302,539,2,201,20105,2010501
201050109,"Marongi",336,421,757,2,201,20105,2010501
201050110,"Mataba",313,318,631,2,201,20105,2010501
201050111,"Nyesonga",384,411,795,2,201,20105,2010501
201050201,"Buruba",258,282,540,2,201,20105,2010502
201050202,"Butara",366,451,817,2,201,20105,2010502
201050203,"Gasharu",423,384,807,2,201,20105,2010502
201050204,"Kavumu",211,256,467,2,201,20105,2010502
201050205,"Kigufi",226,254,480,2,201,20105,2010502
201050206,"Kirundo",286,305,591,2,201,20105,2010502
201050207,"Nyarusheshe",102,223,325,2,201,20105,2010502
201050208,"Runyinya",343,395,738,2,201,20105,2010502
201050301,"Birembo",307,317,624,2,201,20105,2010503
201050302,"Cyingina",211,244,455,2,201,20105,2010503
201050303,"Gashikiri",261,280,541,2,201,20105,2010503
201050304,"Gicunshu",231,272,503,2,201,20105,2010503
201050305,"Gisore",238,318,556,2,201,20105,2010503
201050306,"Karugando",233,306,539,2,201,20105,2010503
201050307,"Kaziba",259,296,555,2,201,20105,2010503
201050308,"Kirerabana",263,293,556,2,201,20105,2010503
201050309,"Nyagacyamo",331,345,676,2,201,20105,2010503
201050310,"Rugarama",250,317,567,2,201,20105,2010503
201050311,"Serivise",273,318,591,2,201,20105,2010503
201050401,"Bugarura",208,263,471,2,201,20105,2010504
201050402,"Bwambika",198,226,424,2,201,20105,2010504
201050403,"Gisoro",201,220,421,2,201,20105,2010504
201050404,"Giturwa",233,240,473,2,201,20105,2010504
201050405,"Kabacuzi",242,263,505,2,201,20105,2010504
201050406,"Kajevuba",197,238,435,2,201,20105,2010504
201050407,"Kinene",197,233,430,2,201,20105,2010504
201050408,"Mutende",341,387,728,2,201,20105,2010504
201050409,"Nyabubare",259,269,528,2,201,20105,2010504
201050410,"Nyakabungo",217,236,453,2,201,20105,2010504
201050411,"Runyanzige",260,267,527,2,201,20105,2010504
201050412,"Sholi",310,336,646,2,201,20105,2010504
201050501,"Akana Ka Mulinja",250,257,507,2,201,20105,2010505
201050502,"Akintare",285,296,581,2,201,20105,2010505
201050503,"Buharankakara",345,404,749,2,201,20105,2010505
201050504,"Buhoro",299,272,571,2,201,20105,2010505
201050505,"Burambi",241,281,522,2,201,20105,2010505
201050506,"Karama",470,527,997,2,201,20105,2010505
201050507,"Kigarama",223,246,469,2,201,20105,2010505
201050508,"Muramba",388,388,776,2,201,20105,2010505
201050509,"Nyarukurazo",233,274,507,2,201,20105,2010505
201050510,"Sabununga",234,265,499,2,201,20105,2010505
201060101,"Birambo",313,356,669,2,201,20106,2010601
201060102,"Bweramana",208,262,470,2,201,20106,2010601
201060103,"Cyerezo",258,294,552,2,201,20106,2010601
201060104,"Cyikirehe",218,229,447,2,201,20106,2010601
201060105,"Cyumba",166,195,361,2,201,20106,2010601
201060106,"Gasharu",277,337,614,2,201,20106,2010601
201060107,"Kamabuye",301,321,622,2,201,20106,2010601
201060108,"Karambi",226,252,478,2,201,20106,2010601
201060109,"Nyarutovu",258,257,515,2,201,20106,2010601
201060201,"Cyahafi",247,290,537,2,201,20106,2010602
201060202,"Gatagara",418,485,903,2,201,20106,2010602
201060203,"Kamushatsi",297,334,631,2,201,20106,2010602
201060204,"Karama ",262,281,543,2,201,20106,2010602
201060205,"Karuhwanya",218,225,443,2,201,20106,2010602
201060206,"Kinyogoto",429,470,899,2,201,20106,2010602
201060207,"Muhororo ",191,229,420,2,201,20106,2010602
201060208,"Nyamiyaga  ",208,228,436,2,201,20106,2010602
201060209,"Nyamuko",491,514,1005,2,201,20106,2010602
201060301,"Gahoko",429,472,901,2,201,20106,2010603
201060302,"Kaganza",220,254,474,2,201,20106,2010603
201060303,"Kiganda ",208,252,460,2,201,20106,2010603
201060304,"Kigarama",468,456,924,2,201,20106,2010603
201060305,"Masambu",172,173,345,2,201,20106,2010603
201060306,"Muganza",346,419,765,2,201,20106,2010603
201060307,"Murehe  ",190,190,380,2,201,20106,2010603
201060308,"Muturirwa",483,530,1013,2,201,20106,2010603
201060309,"Nkiko",157,208,365,2,201,20106,2010603
201060310,"Nyabishinge",270,316,586,2,201,20106,2010603
201060311,"Nyankunamirwa",210,203,413,2,201,20106,2010603
201060401,"Birembo ",207,246,453,2,201,20106,2010604
201060402,"Karambi",191,209,400,2,201,20106,2010604
201060403,"Kinyinya",309,375,684,2,201,20106,2010604
201060404,"Mataba",132,170,302,2,201,20106,2010604
201060405,"Nkinda",208,226,434,2,201,20106,2010604
201060406,"Nyakabuye",274,337,611,2,201,20106,2010604
201060407,"Nyamazi",4230,628,4858,2,201,20106,2010604
201060408,"Remera",301,343,644,2,201,20106,2010604
201060501,"Bikire",148,165,313,2,201,20106,2010605
201060502,"Biroro",280,296,576,2,201,20106,2010605
201060503,"Gasiza",117,141,258,2,201,20106,2010605
201060504,"Kagwa  A",255,312,567,2,201,20106,2010605
201060505,"Karambi  A",109,111,220,2,201,20106,2010605
201060506,"Karenge",221,263,484,2,201,20106,2010605
201060507,"Kidaturwa",133,148,281,2,201,20106,2010605
201060508,"Kigarama",343,441,784,2,201,20106,2010605
201060509,"Mwanabiri",273,316,589,2,201,20106,2010605
201060510,"Nyarunyinya A",122,161,283,2,201,20106,2010605
201060511,"Rutete",360,403,763,2,201,20106,2010605
201060601,"Cyimana",253,288,541,2,201,20106,2010606
201060602,"Gisuma",235,267,502,2,201,20106,2010606
201060603,"Kabarima",298,328,626,2,201,20106,2010606
201060604,"Kibonde",185,221,406,2,201,20106,2010606
201060605,"Kigarama",195,212,407,2,201,20106,2010606
201060606,"Nyacyoma",173,223,396,2,201,20106,2010606
201060607,"Nyakabungo",144,212,356,2,201,20106,2010606
201060608,"Nyankokoma",311,367,678,2,201,20106,2010606
201060609,"Nzuki",221,273,494,2,201,20106,2010606
201060610,"Ruhosha",183,238,421,2,201,20106,2010606
201070101,"Buhaza",819,986,1805,2,201,20107,2010701
201070102,"Kimfizi",314,373,687,2,201,20107,2010701
201070103,"Kinyoni",914,1028,1942,2,201,20107,2010701
201070104,"Ruyenzi",545,713,1258,2,201,20107,2010701
201070105,"Rwabihanga",478,566,1044,2,201,20107,2010701
201070201,"Bugina",405,489,894,2,201,20107,2010702
201070202,"Kalilisi",463,586,1049,2,201,20107,2010702
201070203,"Kavumu",371,353,724,2,201,20107,2010702
201070204,"Kinyana",491,630,1121,2,201,20107,2010702
201070205,"Musenyi",448,521,969,2,201,20107,2010702
201070301,"Gihama",252,303,555,2,201,20107,2010703
201070302,"Kabuye",336,358,694,2,201,20107,2010703
201070303,"Kiniga",428,558,986,2,201,20107,2010703
201070304,"Nzovi",290,342,632,2,201,20107,2010703
201070305,"Rugese",396,474,870,2,201,20107,2010703
201070401,"Cyegera",515,524,1039,2,201,20107,2010704
201070402,"Gatare",686,766,1452,2,201,20107,2010704
201070403,"Gituza",655,752,1407,2,201,20107,2010704
201070404,"Kanyundo",462,507,969,2,201,20107,2010704
201070405,"Nyarugunga",588,727,1315,2,201,20107,2010704
201070501,"Jari",277,297,574,2,201,20107,2010705
201070502,"Nyundo",118,162,280,2,201,20107,2010705
201070503,"Mugari",454,489,943,2,201,20107,2010705
201070504,"Muyira",301,329,630,2,201,20107,2010705
201070505,"Nzoga",587,458,1045,2,201,20107,2010705
201080101,"Gakindo",247,291,538,2,201,20108,2010801
201080102,"Gisayura",199,257,456,2,201,20108,2010801
201080103,"Kabusheja",325,329,654,2,201,20108,2010801
201080104,"Kiruhura",323,365,688,2,201,20108,2010801
201080105,"Marabage",225,293,518,2,201,20108,2010801
201080106,"Ndago",210,240,450,2,201,20108,2010801
201080107,"Nkomane",265,335,600,2,201,20108,2010801
201080108,"Nyabitare",287,338,625,2,201,20108,2010801
201080109,"Rugarama",471,528,999,2,201,20108,2010801
201080201,"Bayi",310,362,672,2,201,20108,2010802
201080202,"Kankima",310,391,701,2,201,20108,2010802
201080203,"Karuyumbo",295,347,642,2,201,20108,2010802
201080204,"Misasa",183,217,400,2,201,20108,2010802
201080205,"Mpande",316,208,524,2,201,20108,2010802
201080206,"Nyabigugu",353,400,753,2,201,20108,2010802
201080207,"Nyarutovu",239,321,560,2,201,20108,2010802
201080208,"Ruyenzi",247,354,601,2,201,20108,2010802
201080209,"Rwimpundu",218,238,456,2,201,20108,2010802
201080301,"Bukinanyana",180,248,428,2,201,20108,2010803
201080302,"Kamabuye",144,165,309,2,201,20108,2010803
201080303,"Kimigunga",192,211,403,2,201,20108,2010803
201080304,"Ntebe",173,234,407,2,201,20108,2010803
201080305,"Nyakabungo",203,197,400,2,201,20108,2010803
201080306,"Nyamirama",192,255,447,2,201,20108,2010803
201080307,"Nyamirambo",218,207,425,2,201,20108,2010803
201080308,"Nyamizi",227,287,514,2,201,20108,2010803
201080309,"Nyarubuye",192,190,382,2,201,20108,2010803
201080310,"Rusasa",173,204,377,2,201,20108,2010803
201080311,"Samuduha",186,180,366,2,201,20108,2010803
201080401,"Gasharu",279,284,563,2,201,20108,2010804
201080402,"Kagarama",311,353,664,2,201,20108,2010804
201080403,"Kamabuye",230,244,474,2,201,20108,2010804
201080404,"Muhero",227,268,495,2,201,20108,2010804
201080405,"Munyiginya",209,218,427,2,201,20108,2010804
201080406,"Muyenzi",274,349,623,2,201,20108,2010804
201080407,"Nkombe",345,348,693,2,201,20108,2010804
201080408,"Rebero",269,303,572,2,201,20108,2010804
201080409,"Rukoma",211,233,444,2,201,20108,2010804
201080410,"Rusebeya",356,447,803,2,201,20108,2010804
201090101,"Gatare",278,285,563,2,201,20109,2010901
201090102,"Gihara",334,319,653,2,201,20109,2010901
201090103,"Gituntu",301,358,659,2,201,20109,2010901
201090104,"Kagarama",229,277,506,2,201,20109,2010901
201090105,"Kigohe",255,336,591,2,201,20109,2010901
201090106,"Mweya",230,255,485,2,201,20109,2010901
201090107,"Nyamugari",272,304,576,2,201,20109,2010901
201090108,"Uwarukara",268,316,584,2,201,20109,2010901
201090201,"Cyahafi",324,334,658,2,201,20109,2010902
201090202,"Gihimbi",254,314,568,2,201,20109,2010902
201090203,"Kabuye",303,329,632,2,201,20109,2010902
201090204,"Muhaga",276,345,621,2,201,20109,2010902
201090205,"Nyagatovu",281,324,605,2,201,20109,2010902
201090206,"Nyamabuye",234,241,475,2,201,20109,2010902
201090207,"Nyaruvumu",248,263,511,2,201,20109,2010902
201090301,"Gatoki",277,318,595,2,201,20109,2010903
201090302,"Mirehe",313,337,650,2,201,20109,2010903
201090303,"Murandaryi",328,365,693,2,201,20109,2010903
201090304,"Mwokora",201,223,424,2,201,20109,2010903
201090305,"Nyamitobo",216,214,430,2,201,20109,2010903
201090306,"Uwabushingwe",177,192,369,2,201,20109,2010903
201090307,"Uwagisozi",288,341,629,2,201,20109,2010903
201090308,"Uwimpura",207,257,464,2,201,20109,2010903
201090401,"Busenyeye",159,181,340,2,201,20109,2010904
201090402,"Bweru",315,347,662,2,201,20109,2010904
201090403,"Gasharu",282,336,618,2,201,20109,2010904
201090404,"Gasiza",209,228,437,2,201,20109,2010904
201090405,"Jarama",283,292,575,2,201,20109,2010904
201090406,"Mpaza",208,241,449,2,201,20109,2010904
201090407,"Murende",296,307,603,2,201,20109,2010904
201090408,"Mwezi",251,348,599,2,201,20109,2010904
201090409,"Rwankuba",223,261,484,2,201,20109,2010904
201090410,"Rwimbazi",211,215,426,2,201,20109,2010904
201090501,"Gashyenzi",298,332,630,2,201,20109,2010905
201090502,"Kami",186,212,398,2,201,20109,2010905
201090503,"Kigarama",394,364,758,2,201,20109,2010905
201090504,"Musongati",389,393,782,2,201,20109,2010905
201090505,"Nyamagana",337,371,708,2,201,20109,2010905
201090506,"Nyarutovu",352,403,755,2,201,20109,2010905
201090507,"Nyaruvumu",297,348,645,2,201,20109,2010905
201090508,"Rugarama",246,250,496,2,201,20109,2010905
201100101,"Bisambu",298,330,628,2,201,20110,2011001
201100102,"Gisake",211,260,471,2,201,20110,2011001
201100103,"Karehe",178,232,410,2,201,20110,2011001
201100104,"Nyamiyaga",225,273,498,2,201,20110,2011001
201100201,"Gakoni",224,285,509,2,201,20110,2011002
201100202,"Gasiza A",133,175,308,2,201,20110,2011002
201100203,"Gasiza B",126,160,286,2,201,20110,2011002
201100204,"Karambo A",141,171,312,2,201,20110,2011002
201100205,"Karambo B",115,173,288,2,201,20110,2011002
201100206,"Karusimbi",205,230,435,2,201,20110,2011002
201100207,"Rwamushumba",132,155,287,2,201,20110,2011002
201100301,"Kabisine",133,152,285,2,201,20110,2011003
201100302,"Kadusenyi",269,299,568,2,201,20110,2011003
201100303,"Karwiru",225,267,492,2,201,20110,2011003
201100304,"Nyamiseke",308,356,664,2,201,20110,2011003
201100401,"Kirwa",333,385,718,2,201,20110,2011004
201100402,"Nyabubare",399,397,796,2,201,20110,2011004
201100403,"Nyamivumu A",248,269,517,2,201,20110,2011004
201100404,"Nyamuvumu B",166,205,371,2,201,20110,2011004
201100501,"Cyarwa",280,374,654,2,201,20110,2011005
201100502,"Kamushi",361,407,768,2,201,20110,2011005
201100503,"Kamuvunyi A",156,197,353,2,201,20110,2011005
201100504,"Kamuvunyi B",247,314,561,2,201,20110,2011005
201100505,"Karambi",130,140,270,2,201,20110,2011005
201100506,"Kavumu A",176,182,358,2,201,20110,2011005
201100507,"Kavumu B",108,135,243,2,201,20110,2011005
201100601,"Kigarama",274,326,600,2,201,20110,2011006
201100602,"Murambi",269,320,589,2,201,20110,2011006
201100603,"Ndago",301,314,615,2,201,20110,2011006
201100604,"Rugarama  A",175,211,386,2,201,20110,2011006
201100605,"Rugarama B",170,187,357,2,201,20110,2011006
202010101,"Curusi",358,456,814,2,202,20201,2020101
202010102,"Cyendajuru",224,266,490,2,202,20201,2020101
202010103,"Cyimpuga",349,401,750,2,202,20201,2020101
202010104,"Katiro",210,227,437,2,202,20201,2020101
202010105,"Kigitega",234,257,491,2,202,20201,2020101
202010106,"Kinyana",178,200,378,2,202,20201,2020101
202010107,"Murambi",458,493,951,2,202,20201,2020101
202010108,"Musambi",352,385,737,2,202,20201,2020101
202010109,"Sanzu",248,267,515,2,202,20201,2020101
202010201,"Agasenyi",316,394,710,2,202,20201,2020102
202010202,"Akarukambira",303,363,666,2,202,20201,2020102
202010203,"Bibungo",312,330,642,2,202,20201,2020102
202010204,"Gasagara",252,273,525,2,202,20201,2020102
202010205,"Karehe",294,370,664,2,202,20201,2020102
202010206,"Mugusa",261,291,552,2,202,20201,2020102
202010207,"Remera",394,362,756,2,202,20201,2020102
202010208,"Umubezi",220,257,477,2,202,20201,2020102
202010301,"Gahabwa",273,404,677,2,202,20201,2020103
202010302,"Karubondo",279,361,640,2,202,20201,2020103
202010303,"Manyinya",290,330,620,2,202,20201,2020103
202010304,"Rugarama",375,300,675,2,202,20201,2020103
202010305,"Runyinya",441,441,882,2,202,20201,2020103
202010401,"Bukorota",203,304,507,2,202,20201,2020104
202010402,"Buremera",191,257,448,2,202,20201,2020104
202010403,"Kirivuga",292,318,610,2,202,20201,2020104
202010404,"Mbogo",305,383,688,2,202,20201,2020104
202010405,"Nyakabuye",348,409,757,2,202,20201,2020104
202010406,"Nyiramageni",209,245,454,2,202,20201,2020104
202010407,"Rwatano",205,233,438,2,202,20201,2020104
202010408,"Rwintare",322,396,718,2,202,20201,2020104
202020101,"Busave",131,133,264,2,202,20202,2020201
202020102,"Kigozi",214,225,439,2,202,20202,2020201
202020103,"Kivugiza",197,216,413,2,202,20202,2020201
202020104,"Kurugogwe",115,133,248,2,202,20202,2020201
202020105,"Nyamure",193,200,393,2,202,20202,2020201
202020106,"Nyundo",116,143,259,2,202,20202,2020201
202020107,"Ruhina",115,143,258,2,202,20202,2020201
202020108,"Kurutare",114,129,243,2,202,20202,2020201
202020109,"Rweza",173,221,394,2,202,20202,2020201
202020110,"Tamba",244,276,520,2,202,20202,2020201
202020111,"Zamwe",138,161,299,2,202,20202,2020201
202020201,"Hemba",184,194,378,2,202,20202,2020202
202020202,"Kabuga",257,290,547,2,202,20202,2020202
202020203,"Kanombe",181,226,407,2,202,20202,2020202
202020204,"Mutobo",205,214,419,2,202,20202,2020202
202020205,"Mwiba",191,227,418,2,202,20202,2020202
202020206,"Ndaro",233,272,505,2,202,20202,2020202
202020207,"Nyabisindu",166,209,375,2,202,20202,2020202
202020208,"Nyirakanywero",149,140,289,2,202,20202,2020202
202020209,"Rwikwavu",240,254,494,2,202,20202,2020202
202020210,"Ryarugaju",272,278,550,2,202,20202,2020202
202020301,"Banga",110,133,243,2,202,20202,2020203
202020302,"Gicaca",258,288,546,2,202,20202,2020203
202020303,"Kavumu",241,248,489,2,202,20202,2020203
202020304,"Kibindyi",138,167,305,2,202,20202,2020203
202020305,"Munyinya",156,178,334,2,202,20202,2020203
202020306,"Nkunamo",237,271,508,2,202,20202,2020203
202020307,"Nyakibungo",152,181,333,2,202,20202,2020203
202020308,"Nyarurama",163,194,357,2,202,20202,2020203
202020309,"Rebero",308,362,670,2,202,20202,2020203
202020310,"Rugarama",212,227,439,2,202,20202,2020203
202020311,"Rusasa",224,289,513,2,202,20202,2020203
202020401,"Cyamanyeri",125,167,292,2,202,20202,2020204
202020402,"Gikuyo",152,208,360,2,202,20202,2020204
202020403,"Gishya",235,289,524,2,202,20202,2020204
202020404,"Gitekateke",168,209,377,2,202,20202,2020204
202020405,"Kabungo",132,158,290,2,202,20202,2020204
202020406,"Kagoma",174,226,400,2,202,20202,2020204
202020407,"Kavumu",215,231,446,2,202,20202,2020204
202020408,"Kigarama",263,220,483,2,202,20202,2020204
202020409,"Muduha",160,236,396,2,202,20202,2020204
202020410,"Muyinza",249,313,562,2,202,20202,2020204
202020411,"Nyabyunyu",175,191,366,2,202,20202,2020204
202020412,"Rebero",211,220,431,2,202,20202,2020204
202020413,"Rugogwe",205,244,449,2,202,20202,2020204
202020414,"Rwanza",149,178,327,2,202,20202,2020204
202020415,"Rwegura",202,193,395,2,202,20202,2020204
202020416,"Sakara",250,304,554,2,202,20202,2020204
202030101,"Agacyamu",334,441,775,2,202,20203,2020301
202030102,"Agataba",278,397,675,2,202,20203,2020301
202030103,"Akabuga",274,336,610,2,202,20203,2020301
202030104,"Akayenzi",173,226,399,2,202,20203,2020301
202030105,"Gatare",322,396,718,2,202,20203,2020301
202030106,"Impinga",311,384,695,2,202,20203,2020301
202030107,"Rugarama",229,327,556,2,202,20203,2020301
202030108,"Ruhuha",345,396,741,2,202,20203,2020301
202030201,"Akakinka",217,291,508,2,202,20203,2020302
202030202,"Akambogo",246,342,588,2,202,20203,2020302
202030203,"Gitwa",341,450,791,2,202,20203,2020302
202030204,"Kimanama",255,342,597,2,202,20203,2020302
202030205,"Mbeho",234,299,533,2,202,20203,2020302
202030206,"Nyakibungo",303,411,714,2,202,20203,2020302
202030207,"Nyaruhengeri",237,291,528,2,202,20203,2020302
202030301,"Akayenzi",248,269,517,2,202,20203,2020303
202030302,"Gikore",301,332,633,2,202,20203,2020303
202030303,"Muhororo",220,295,515,2,202,20203,2020303
202030304,"Nyamure",211,246,457,2,202,20203,2020303
202030305,"Nyarunazi",358,407,765,2,202,20203,2020303
202030306,"Ruhangaye",335,431,766,2,202,20203,2020303
202030401,"Agatare",207,260,467,2,202,20203,2020304
202030402,"Akabagagi",176,238,414,2,202,20203,2020304
202030403,"Gisororo",232,274,506,2,202,20203,2020304
202030404,"Kaburanjwiri",184,223,407,2,202,20203,2020304
202030405,"Kaduha",238,314,552,2,202,20203,2020304
202030406,"Kamugani",156,212,368,2,202,20203,2020304
202030407,"Kigarama",182,245,427,2,202,20203,2020304
202030408,"Nyange",179,249,428,2,202,20203,2020304
202040101,"Buhoro",379,431,810,2,202,20204,2020401
202040102,"Burashi",320,435,755,2,202,20204,2020401
202040103,"Cyahafi",432,517,949,2,202,20204,2020401
202040104,"Duwani",252,315,567,2,202,20204,2020401
202040105,"Karambo",382,409,791,2,202,20204,2020401
202040106,"Kinteko",288,342,630,2,202,20204,2020401
202040107,"Kivumu",202,209,411,2,202,20204,2020401
202040108,"Mubuga",392,475,867,2,202,20204,2020401
202040109,"Murambi",286,335,621,2,202,20204,2020401
202040110,"Rwuya",234,308,542,2,202,20204,2020401
202040111,"Taba",162,222,384,2,202,20204,2020401
202040201,"Burashi",206,254,460,2,202,20204,2020402
202040202,"Gasagara",211,291,502,2,202,20204,2020402
202040203,"Kabakobwa",190,268,458,2,202,20204,2020402
202040204,"Kigarama",214,242,456,2,202,20204,2020402
202040205,"Mareba",298,453,751,2,202,20204,2020402
202040206,"Mbeho",196,260,456,2,202,20204,2020402
202040207,"Ruhuha",255,310,565,2,202,20204,2020402
202040208,"Shenyeri",313,427,740,2,202,20204,2020402
202040209,"Torero",195,258,453,2,202,20204,2020402
202040301,"Agahumiro",111,148,259,2,202,20204,2020403
202040302,"Agasharu",262,274,536,2,202,20204,2020403
202040303,"Akagarama",220,260,480,2,202,20204,2020403
202040304,"Akayohani",143,211,354,2,202,20204,2020403
202040305,"Akirasaniro",200,254,454,2,202,20204,2020403
202040306,"Impinga",291,381,672,2,202,20204,2020403
202040307,"Nyagasozi",123,146,269,2,202,20204,2020403
202040308,"Nyagisasa",210,258,468,2,202,20204,2020403
202040309,"Rwinzuki",223,278,501,2,202,20204,2020403
202040310,"Taba",128,172,300,2,202,20204,2020403
202040311,"Zihare",346,424,770,2,202,20204,2020403
202040401,"Agatongati",215,279,494,2,202,20204,2020404
202040402,"Akabuhuzu",284,328,612,2,202,20204,2020404
202040403,"Akamuzenga",248,350,598,2,202,20204,2020404
202040404,"Akarugaju",218,262,480,2,202,20204,2020404
202040405,"Impinga",333,366,699,2,202,20204,2020404
202040406,"Kabagoti",259,313,572,2,202,20204,2020404
202040407,"Karengera",218,272,490,2,202,20204,2020404
202040408,"Kigarama",272,284,556,2,202,20204,2020404
202040409,"Ntobo",443,539,982,2,202,20204,2020404
202040410,"Nyabununi",174,191,365,2,202,20204,2020404
202040411,"Rubazi",370,464,834,2,202,20204,2020404
202050101,"Agahehe",322,383,705,2,202,20205,2020501
202050102,"Akabacuzi",208,213,421,2,202,20205,2020501
202050103,"Kamutozo",168,175,343,2,202,20205,2020501
202050104,"Kamweko",145,174,319,2,202,20205,2020501
202050105,"Nyamabuye",233,256,489,2,202,20205,2020501
202050106,"Ruhuha",250,243,493,2,202,20205,2020501
202050107,"Taba",256,271,527,2,202,20205,2020501
202050201,"Agasharu",184,242,426,2,202,20205,2020502
202050202,"Agatare",175,220,395,2,202,20205,2020502
202050203,"Akamana",225,252,477,2,202,20205,2020502
202050204,"Gitozo",199,228,427,2,202,20205,2020502
202050205,"Janja",131,178,309,2,202,20205,2020502
202050206,"Kigarama",234,245,479,2,202,20205,2020502
202050207,"Taba",253,303,556,2,202,20205,2020502
202050301,"Akadogo",136,190,326,2,202,20205,2020503
202050302,"Akakijugujugu",184,215,399,2,202,20205,2020503
202050303,"Ikidashya",157,202,359,2,202,20205,2020503
202050304,"Ikijana",198,246,444,2,202,20205,2020503
202050305,"Nyamirama",191,209,400,2,202,20205,2020503
202050306,"Rugeragere",181,212,393,2,202,20205,2020503
202050401,"Akabahizi",227,279,506,2,202,20205,2020504
202050402,"Akimbaka",317,390,707,2,202,20205,2020504
202050403,"Impinga",250,265,515,2,202,20205,2020504
202050404,"Rutare",209,275,484,2,202,20205,2020504
202050405,"Rutaza",277,297,574,2,202,20205,2020504
202050406,"Shyombo",224,266,490,2,202,20205,2020504
202050407,"Umurangara",301,342,643,2,202,20205,2020504
202050408,"Uruyenzi",240,306,546,2,202,20205,2020504
202050501,"Akadogo",219,311,530,2,202,20205,2020505
202050502,"Akashyagara",199,261,460,2,202,20205,2020505
202050503,"Gaharanyonga",283,338,621,2,202,20205,2020505
202050504,"Gatongati",239,296,535,2,202,20205,2020505
202050505,"Murehe",226,232,458,2,202,20205,2020505
202050506,"Nyakabuye",233,258,491,2,202,20205,2020505
202050601,"Agasharu",225,283,508,2,202,20205,2020506
202050602,"Akajwiga",246,326,572,2,202,20205,2020506
202050603,"Akatera",258,306,564,2,202,20205,2020506
202050604,"Kigarama",204,230,434,2,202,20205,2020506
202050605,"Nyarukurazo",320,330,650,2,202,20205,2020506
202050606,"Nyarunyinya",242,307,549,2,202,20205,2020506
202060101,"Gakomeye",235,288,523,2,202,20206,2020601
202060102,"Gatare",347,351,698,2,202,20206,2020601
202060103,"Kinamba",199,236,435,2,202,20206,2020601
202060104,"Kivomo",335,388,723,2,202,20206,2020601
202060105,"Kizenga",242,275,517,2,202,20206,2020601
202060106,"Rebero",268,273,541,2,202,20206,2020601
202060107,"Rugenge",298,288,586,2,202,20206,2020601
202060108,"Rugwiza",245,287,532,2,202,20206,2020601
202060109,"Ruhuha",487,557,1044,2,202,20206,2020601
202060110,"Sokofi",254,224,478,2,202,20206,2020601
202060201,"Buye",343,369,712,2,202,20206,2020602
202060202,"Gahararo",395,461,856,2,202,20206,2020602
202060203,"Kabuga",415,480,895,2,202,20206,2020602
202060204,"Kirwa",326,413,739,2,202,20206,2020602
202060205,"Muhabura",322,343,665,2,202,20206,2020602
202060206,"Munopfu",349,426,775,2,202,20206,2020602
202060207,"Nunga",347,415,762,2,202,20206,2020602
202060208,"Nyarugenge",388,423,811,2,202,20206,2020602
202060301,"Buhima",284,335,619,2,202,20206,2020603
202060302,"Gakoma",253,343,596,2,202,20206,2020603
202060303,"Gatovu",320,363,683,2,202,20206,2020603
202060304,"Kamudogo",175,227,402,2,202,20206,2020603
202060305,"Karama",165,194,359,2,202,20206,2020603
202060306,"Kirase",171,172,343,2,202,20206,2020603
202060307,"Mashenyi",156,166,322,2,202,20206,2020603
202060308,"Nyarugenge",178,212,390,2,202,20206,2020603
202060309,"Rugunga",392,460,852,2,202,20206,2020603
202060401,"Butezi",266,305,571,2,202,20206,2020604
202060402,"Cadi",226,278,504,2,202,20206,2020604
202060403,"Cyarwa",250,306,556,2,202,20206,2020604
202060404,"Kabeza",203,245,448,2,202,20206,2020604
202060405,"Kibumba",288,379,667,2,202,20206,2020604
202060406,"Mutori",588,717,1305,2,202,20206,2020604
202060407,"Nyamirama",321,374,695,2,202,20206,2020604
202060408,"Ruhamagariro",371,389,760,2,202,20206,2020604
202060409,"Shyembe",322,365,687,2,202,20206,2020604
202060501,"Gatare",160,183,343,2,202,20206,2020605
202060502,"Gatoke",352,420,772,2,202,20206,2020605
202060503,"Kayenzi",170,193,363,2,202,20206,2020605
202060504,"Kigangazi",185,260,445,2,202,20206,2020605
202060505,"Murama",201,241,442,2,202,20206,2020605
202060506,"Murambi",192,232,424,2,202,20206,2020605
202060507,"Nyiramageni",285,328,613,2,202,20206,2020605
202060508,"Runazi",316,384,700,2,202,20206,2020605
202060509,"Rurama",163,190,353,2,202,20206,2020605
202060510,"Rusave",221,305,526,2,202,20206,2020605
202060511,"Rwimvubu",179,235,414,2,202,20206,2020605
202070101,"Byiza",258,272,530,2,202,20207,2020701
202070102,"Cyumba",196,216,412,2,202,20207,2020701
202070103,"Gitwa",181,202,383,2,202,20207,2020701
202070104,"Kabacuzi",223,257,480,2,202,20207,2020701
202070105,"Kamabango",191,240,431,2,202,20207,2020701
202070106,"Musatsi",209,258,467,2,202,20207,2020701
202070107,"Mutorerwa",231,280,511,2,202,20207,2020701
202070108,"Nyagatovu",197,197,394,2,202,20207,2020701
202070109,"Nyiraburiba",219,282,501,2,202,20207,2020701
202070110,"Rugantete",212,243,455,2,202,20207,2020701
202070111,"Rutare",139,195,334,2,202,20207,2020701
202070112,"Rwimisambi",191,233,424,2,202,20207,2020701
202070201,"Agasharu",203,234,437,2,202,20207,2020702
202070202,"Agatongati",122,152,274,2,202,20207,2020702
202070203,"Amajuri",132,168,300,2,202,20207,2020702
202070204,"Cyanamo",138,174,312,2,202,20207,2020702
202070205,"Gitisi",140,166,306,2,202,20207,2020702
202070206,"Rwamugoyi",117,146,263,2,202,20207,2020702
202070207,"Rwinkuba",157,179,336,2,202,20207,2020702
202070208,"Ubusenyi",205,226,431,2,202,20207,2020702
202070209,"Urusaro",143,150,293,2,202,20207,2020702
202070301,"Agakurwe",156,215,371,2,202,20207,2020703
202070302,"Agaseke",143,150,293,2,202,20207,2020703
202070303,"Akarambo",107,132,239,2,202,20207,2020703
202070304,"Butare",142,158,300,2,202,20207,2020703
202070305,"Kajyanama",189,190,379,2,202,20207,2020703
202070306,"Taba",190,244,434,2,202,20207,2020703
202070401,"Agasharu",152,191,343,2,202,20207,2020704
202070402,"Agatovu",280,333,613,2,202,20207,2020704
202070403,"Akarubumba",122,142,264,2,202,20207,2020704
202070404,"Akimirama",248,282,530,2,202,20207,2020704
202070405,"Buseruka",248,229,477,2,202,20207,2020704
202070406,"Gako",126,156,282,2,202,20207,2020704
202070407,"Impinga",265,321,586,2,202,20207,2020704
202070408,"Kabahongo",165,164,329,2,202,20207,2020704
202070409,"Kiberengeri",275,301,576,2,202,20207,2020704
202070410,"Kidaturwa",206,237,443,2,202,20207,2020704
202070411,"Kigina",245,268,513,2,202,20207,2020704
202070412,"Kiyogoro",236,317,553,2,202,20207,2020704
202070413,"Mbehe",202,196,398,2,202,20207,2020704
202070414,"Nyagatovu",307,316,623,2,202,20207,2020704
202070415,"Nyamagana",270,252,522,2,202,20207,2020704
202070416,"Ryarumenangiga",276,329,605,2,202,20207,2020704
202070417,"Umunazi",194,207,401,2,202,20207,2020704
202070501,"Akabacuzi",105,137,242,2,202,20207,2020705
202070502,"Bucaya",174,204,378,2,202,20207,2020705
202070503,"Buhiza",228,248,476,2,202,20207,2020705
202070504,"Duwane",275,310,585,2,202,20207,2020705
202070505,"Impinga",156,181,337,2,202,20207,2020705
202070506,"Isangano",260,312,572,2,202,20207,2020705
202070507,"Kanto I",111,152,263,2,202,20207,2020705
202070508,"Kanto Ii",91,130,221,2,202,20207,2020705
202070509,"Nyabigugu",285,300,585,2,202,20207,2020705
202070510,"Nyagafumberi",370,409,779,2,202,20207,2020705
202070511,"Nyakagezi",280,314,594,2,202,20207,2020705
202070512,"Nyamiheto  I",192,260,452,2,202,20207,2020705
202070513,"Nyamiheto  Ii",245,332,577,2,202,20207,2020705
202070514,"Rwinkuba",167,187,354,2,202,20207,2020705
202080101,"Banzankuru",321,381,702,2,202,20208,2020801
202080102,"Igitungwa",247,228,475,2,202,20208,2020801
202080103,"Nyabinyenga",274,321,595,2,202,20208,2020801
202080104,"Nyagatovu",171,201,372,2,202,20208,2020801
202080105,"Nyamirama",312,369,681,2,202,20208,2020801
202080106,"Nyarukeri",291,384,675,2,202,20208,2020801
202080107,"Nyesumo",224,264,488,2,202,20208,2020801
202080201,"Agakanka",229,277,506,2,202,20208,2020802
202080202,"Akarutsibuka",228,254,482,2,202,20208,2020802
202080203,"Akashyamba",227,331,558,2,202,20208,2020802
202080204,"Kabuga",219,289,508,2,202,20208,2020802
202080205,"Linda",252,273,525,2,202,20208,2020802
202080206,"Rwahambi",220,265,485,2,202,20208,2020802
202080207,"Udukoni",175,248,423,2,202,20208,2020802
202080301,"Agasharu",248,286,534,2,202,20208,2020803
202080302,"Akabugabo",252,365,617,2,202,20208,2020803
202080303,"Akagashuma",358,425,783,2,202,20208,2020803
202080304,"Mushongi",343,377,720,2,202,20208,2020803
202080305,"Rurenge",333,361,694,2,202,20208,2020803
202080401,"Agasharu",256,292,548,2,202,20208,2020804
202080402,"Akagarama",459,618,1077,2,202,20208,2020804
202080403,"Akarambo",229,347,576,2,202,20208,2020804
202080404,"Bishya",380,413,793,2,202,20208,2020804
202080405,"Impinga",233,305,538,2,202,20208,2020804
202080406,"Migina",415,505,920,2,202,20208,2020804
202080501,"Agakomansyo",262,281,543,2,202,20208,2020805
202080502,"Akanyamirama",216,291,507,2,202,20208,2020805
202080503,"Akarangabo",294,353,647,2,202,20208,2020805
202080504,"Akatara",221,259,480,2,202,20208,2020805
202080505,"Gitarama",203,230,433,2,202,20208,2020805
202080506,"Kabuye",257,292,549,2,202,20208,2020805
202080507,"Nyabisonga",287,309,596,2,202,20208,2020805
202080508,"Nyarusange",232,277,509,2,202,20208,2020805
202080509,"Umukungu",238,247,485,2,202,20208,2020805
202090101,"Agasharu",201,248,449,2,202,20209,2020901
202090102,"Akazenga",220,250,470,2,202,20209,2020901
202090103,"Gatunda",273,317,590,2,202,20209,2020901
202090104,"Joma",160,205,365,2,202,20209,2020901
202090105,"Kabati",300,324,624,2,202,20209,2020901
202090106,"Magi",177,221,398,2,202,20209,2020901
202090107,"Nyabikoni",280,316,596,2,202,20209,2020901
202090108,"Nyamabuye",321,377,698,2,202,20209,2020901
202090109,"Rebero",290,333,623,2,202,20209,2020901
202090110,"Ruko",260,322,582,2,202,20209,2020901
202090201,"Akagarama",220,246,466,2,202,20209,2020902
202090202,"Bukamba",184,240,424,2,202,20209,2020902
202090203,"Cyimana",202,209,411,2,202,20209,2020902
202090204,"Gitwa",207,221,428,2,202,20209,2020902
202090205,"Kigoyi",191,234,425,2,202,20209,2020902
202090206,"Mukiza",121,153,274,2,202,20209,2020902
202090207,"Nyabiryo",288,313,601,2,202,20209,2020902
202090208,"Nyakazana",280,343,623,2,202,20209,2020902
202090209,"Nyarutovu",295,337,632,2,202,20209,2020902
202090210,"Rusumba",306,369,675,2,202,20209,2020902
202090301,"Agatare",195,247,442,2,202,20209,2020903
202090302,"Akabuga",205,206,411,2,202,20209,2020903
202090303,"Akanage",275,304,579,2,202,20209,2020903
202090304,"Butare",308,303,611,2,202,20209,2020903
202090305,"Kamasiga",250,291,541,2,202,20209,2020903
202090306,"Makwaza",306,319,625,2,202,20209,2020903
202090307,"Mihigo",257,325,582,2,202,20209,2020903
202090308,"Mutondo",186,234,420,2,202,20209,2020903
202090309,"Nkurubuye",299,354,653,2,202,20209,2020903
202090310,"Nyabihama",229,280,509,2,202,20209,2020903
202090311,"Rurimbi",276,321,597,2,202,20209,2020903
202090312,"Rususa",463,475,938,2,202,20209,2020903
202090401,"Agakomeye",288,335,623,2,202,20209,2020904
202090402,"Agasharu",235,278,513,2,202,20209,2020904
202090403,"Akakarinda",229,259,488,2,202,20209,2020904
202090404,"Akamaranga",323,381,704,2,202,20209,2020904
202090405,"Akarugina",230,287,517,2,202,20209,2020904
202090406,"Akayenzi",387,366,753,2,202,20209,2020904
202090407,"Cyumusave",293,370,663,2,202,20209,2020904
202090408,"Impinga",352,401,753,2,202,20209,2020904
202090409,"Itaba",285,325,610,2,202,20209,2020904
202090410,"Mpungwe",320,354,674,2,202,20209,2020904
202090411,"Munyegera",226,261,487,2,202,20209,2020904
202090412,"Nyiranguri",229,255,484,2,202,20209,2020904
202100101,"Agatega",257,329,586,2,202,20210,2021001
202100102,"Akagarama",195,233,428,2,202,20210,2021001
202100103,"Bukinanyana",398,434,832,2,202,20210,2021001
202100104,"Gihinga",310,338,648,2,202,20210,2021001
202100105,"Karishyira",274,348,622,2,202,20210,2021001
202100106,"Kigoma",181,203,384,2,202,20210,2021001
202100107,"Mugejuru",201,256,457,2,202,20210,2021001
202100108,"Munyegera",265,287,552,2,202,20210,2021001
202100109,"Rugarama",311,313,624,2,202,20210,2021001
202100110,"Rukoni",280,373,653,2,202,20210,2021001
202100111,"Rwabuhanga",241,264,505,2,202,20210,2021001
202100112,"Rwatano",269,297,566,2,202,20210,2021001
202100201,"Cyayi",225,263,488,2,202,20210,2021002
202100202,"Gaseke",183,200,383,2,202,20210,2021002
202100203,"Gasura",153,176,329,2,202,20210,2021002
202100204,"Gitega",277,341,618,2,202,20210,2021002
202100205,"Kagunda",243,286,529,2,202,20210,2021002
202100206,"Kigarama",304,331,635,2,202,20210,2021002
202100207,"Mutarama",198,234,432,2,202,20210,2021002
202100208,"Nyabitare",214,226,440,2,202,20210,2021002
202100209,"Nyagasambu",183,221,404,2,202,20210,2021002
202100210,"Ryamugunga",287,343,630,2,202,20210,2021002
202100301,"Bugagiro",277,324,601,2,202,20210,2021003
202100302,"Buremera",200,249,449,2,202,20210,2021003
202100303,"Kabusenda",184,187,371,2,202,20210,2021003
202100304,"Kagunga",285,313,598,2,202,20210,2021003
202100305,"Karugumya",148,190,338,2,202,20210,2021003
202100306,"Kigarama",154,182,336,2,202,20210,2021003
202100307,"Murama",235,274,509,2,202,20210,2021003
202100308,"Nyesonga",179,187,366,2,202,20210,2021003
202100309,"Rugara",283,291,574,2,202,20210,2021003
202100310,"Rugarama",269,306,575,2,202,20210,2021003
202100401,"Akabanga",158,232,390,2,202,20210,2021004
202100402,"Kamabuye",172,186,358,2,202,20210,2021004
202100403,"Kamutabazi",134,164,298,2,202,20210,2021004
202100404,"Kibirizi",179,197,376,2,202,20210,2021004
202100405,"Murambi",220,247,467,2,202,20210,2021004
202100406,"Nyabiduha",169,160,329,2,202,20210,2021004
202100407,"Nyamiyaga",124,141,265,2,202,20210,2021004
202100408,"Ramba",157,182,339,2,202,20210,2021004
202100409,"Rurama",196,225,421,2,202,20210,2021004
202100410,"Rusenyi",260,283,543,2,202,20210,2021004
202110101,"Akiminazi",178,185,363,2,202,20211,2021101
202110102,"Gatobotobo",150,218,368,2,202,20211,2021101
202110103,"Kamahembe",178,257,435,2,202,20211,2021101
202110104,"Kantabana",230,301,531,2,202,20211,2021101
202110105,"Mirayi",282,363,645,2,202,20211,2021101
202110106,"Sabudari",282,330,612,2,202,20211,2021101
202110201,"Giseke",184,233,417,2,202,20211,2021102
202110202,"Nyaburondwe",217,257,474,2,202,20211,2021102
202110203,"Nyarubari",295,389,684,2,202,20211,2021102
202110204,"Ryabiyaga",222,336,558,2,202,20211,2021102
202110205,"Sagahungu",171,266,437,2,202,20211,2021102
202110206,"Urusenyi",301,394,695,2,202,20211,2021102
202110301,"Agasharu",138,157,295,2,202,20211,2021103
202110302,"Gahondo",119,227,346,2,202,20211,2021103
202110303,"Gitwa",371,388,759,2,202,20211,2021103
202110304,"Kigarama",348,401,749,2,202,20211,2021103
202110305,"Ndatemwa",427,397,824,2,202,20211,2021103
202110306,"Twarubona",291,356,647,2,202,20211,2021103
202110401,"Gisagara",630,521,1151,2,202,20211,2021104
202110402,"Kabuga",245,356,601,2,202,20211,2021104
202110403,"Kabuye",214,342,556,2,202,20211,2021104
202110404,"Ndora",206,323,529,2,202,20211,2021104
202110405,"Nyabitare",439,564,1003,2,202,20211,2021104
202110406,"Nyamigango",287,380,667,2,202,20211,2021104
202110407,"Nyarunazi",185,264,449,2,202,20211,2021104
202110408,"Rugara",371,563,934,2,202,20211,2021104
202110409,"Rutonde",267,309,576,2,202,20211,2021104
202110501,"Bugarama",334,489,823,2,202,20211,2021105
202110502,"Kidwange",369,453,822,2,202,20211,2021105
202110503,"Nkinda I",323,429,752,2,202,20211,2021105
202110504,"Nkinda Ii",256,335,591,2,202,20211,2021105
202110505,"Nyarunyinya",243,342,585,2,202,20211,2021105
202110506,"Nyarusange",253,278,531,2,202,20211,2021105
202120101,"Agatare",199,256,455,2,202,20212,2021201
202120102,"Akabakene",291,346,637,2,202,20212,2021201
202120103,"Akagarama",195,235,430,2,202,20212,2021201
202120104,"Amashya",206,248,454,2,202,20212,2021201
202120105,"Impinga Ii",240,270,510,2,202,20212,2021201
202120106,"Rama",271,322,593,2,202,20212,2021201
202120107,"Ruvugizo",223,258,481,2,202,20212,2021201
202120108,"Uruvumvuti",207,244,451,2,202,20212,2021201
202120201,"Akayange",244,281,525,2,202,20212,2021202
202120202,"Cyumba",294,318,612,2,202,20212,2021202
202120203,"Gatarinzira",292,350,642,2,202,20212,2021202
202120204,"Kigali",338,391,729,2,202,20212,2021202
202120205,"Rwamiko",344,375,719,2,202,20212,2021202
202120206,"Sare",291,267,558,2,202,20212,2021202
202120207,"Urugogwe",272,310,582,2,202,20212,2021202
202120208,"Urutoyi",318,329,647,2,202,20212,2021202
202120301,"Agahehe",258,321,579,2,202,20212,2021203
202120302,"Akamerwe",239,242,481,2,202,20212,2021203
202120303,"Akasemabondi",206,250,456,2,202,20212,2021203
202120304,"Amarambya",315,343,658,2,202,20212,2021203
202120305,"Gisunzu",114,123,237,2,202,20212,2021203
202120306,"Impinga I",155,186,341,2,202,20212,2021203
202120307,"Intuntu",259,282,541,2,202,20212,2021203
202120308,"Rugayantete",445,421,866,2,202,20212,2021203
202120309,"Rugomero",414,487,901,2,202,20212,2021203
202120401,"Akamabuye",214,195,409,2,202,20212,2021204
202120402,"Akarwishyura",202,247,449,2,202,20212,2021204
202120403,"Akinyana",230,238,468,2,202,20212,2021204
202120404,"Maheresho",240,254,494,2,202,20212,2021204
202120405,"Manyoni",244,292,536,2,202,20212,2021204
202120406,"Remera",279,296,575,2,202,20212,2021204
202120407,"Tundiro",295,310,605,2,202,20212,2021204
202120408,"Urukeri",223,272,495,2,202,20212,2021204
202130101,"Gasambu",282,326,608,2,202,20213,2021301
202130102,"Gashubi",266,310,576,2,202,20213,2021301
202130103,"Kampuro",312,386,698,2,202,20213,2021301
202130104,"Kaneke",219,257,476,2,202,20213,2021301
202130105,"Kavumu",367,437,804,2,202,20213,2021301
202130106,"Nyarigina",401,434,835,2,202,20213,2021301
202130107,"Rugarama",280,332,612,2,202,20213,2021301
202130201,"Akadurumba",322,346,668,2,202,20213,2021302
202130202,"Gakombe",275,424,699,2,202,20213,2021302
202130203,"Gitwa",233,308,541,2,202,20213,2021302
202130204,"Kabitoki",346,391,737,2,202,20213,2021302
202130205,"Kigwa",312,377,689,2,202,20213,2021302
202130206,"Nyarure",289,330,619,2,202,20213,2021302
202130207,"Rwoserezo",316,346,662,2,202,20213,2021302
202130208,"Zihare",276,319,595,2,202,20213,2021302
202130301,"Akarambo",341,377,718,2,202,20213,2021303
202130302,"Bazenga",230,259,489,2,202,20213,2021303
202130303,"Bitabire",218,248,466,2,202,20213,2021303
202130304,"Bwinyambo",271,325,596,2,202,20213,2021303
202130305,"Cyezuburo",309,338,647,2,202,20213,2021303
202130306,"Gahora",261,283,544,2,202,20213,2021303
202130307,"Kamudahunga",272,298,570,2,202,20213,2021303
202130308,"Kigarama",245,331,576,2,202,20213,2021303
202130309,"Kivumu",279,292,571,2,202,20213,2021303
202130310,"Nyabitare",205,223,428,2,202,20213,2021303
202130311,"Nyagacyamu",297,382,679,2,202,20213,2021303
202130312,"Ryamaguri",328,357,685,2,202,20213,2021303
202130401,"Gahora",335,360,695,2,202,20213,2021304
202130402,"Kagende",266,291,557,2,202,20213,2021304
202130403,"Kirehe",257,323,580,2,202,20213,2021304
202130404,"Kirira",256,298,554,2,202,20213,2021304
202130405,"Mpinga",386,412,798,2,202,20213,2021304
202130406,"Mukoni",235,284,519,2,202,20213,2021304
202130407,"Rugori",340,419,759,2,202,20213,2021304
202130408,"Ryakabuye",206,233,439,2,202,20213,2021304
202130409,"Ryamutabazi",302,332,634,2,202,20213,2021304
202130410,"Taba",264,265,529,2,202,20213,2021304
202130501,"Kinyonzwe",275,310,585,2,202,20213,2021305
202130502,"Musekera",317,359,676,2,202,20213,2021305
202130503,"Nyagasozi",209,230,439,2,202,20213,2021305
202130504,"Rugogwe",232,233,465,2,202,20213,2021305
202130505,"Rwanzana",189,229,418,2,202,20213,2021305
202130506,"Ryamurongo",195,250,445,2,202,20213,2021305
202130507,"Ryarubayi",213,212,425,2,202,20213,2021305
203010101,"Bukinanyana",404,478,882,2,203,20301,2030101
203010102,"Gisenyi",507,545,1052,2,203,20301,2030101
203010103,"Gitwe",552,572,1124,2,203,20301,2030101
203010104,"Kinyinya",385,462,847,2,203,20301,2030101
203010105,"Masiga",473,545,1018,2,203,20301,2030101
203010106,"Uwindava",413,439,852,2,203,20301,2030101
203010201,"Bitare",538,633,1171,2,203,20301,2030102
203010202,"Mutarama",542,553,1095,2,203,20301,2030102
203010203,"Mutobo",445,460,905,2,203,20301,2030102
203010204,"Nkanda",607,695,1302,2,203,20301,2030102
203010205,"Uwamakumba",356,357,713,2,203,20301,2030102
203010301,"Gisoro",321,326,647,2,203,20301,2030103
203010302,"Kabavomo",393,462,855,2,203,20301,2030103
203010303,"Ndatemwa",449,546,995,2,203,20301,2030103
203010304,"Nteko",444,497,941,2,203,20301,2030103
203010305,"Nyarukeri",333,318,651,2,203,20301,2030103
203010306,"Nyarusange",489,485,974,2,203,20301,2030103
203010401,"Bugina",388,406,794,2,203,20301,2030104
203010402,"Gabiro",431,468,899,2,203,20301,2030104
203010403,"Musebeya",317,325,642,2,203,20301,2030104
203010404,"Rango",328,346,674,2,203,20301,2030104
203010405,"Ryabusagara",551,482,1033,2,203,20301,2030104
203010406,"Shwima",341,391,732,2,203,20301,2030104
203010501,"Bukinga",356,375,731,2,203,20301,2030105
203010502,"Mirindi",388,399,787,2,203,20301,2030105
203010503,"Murambi",436,465,901,2,203,20301,2030105
203010504,"Runyami",528,584,1112,2,203,20301,2030105
203010505,"Rutabo",576,444,1020,2,203,20301,2030105
203010506,"Uwinteko",446,497,943,2,203,20301,2030105
203020101,"Agasharu",366,438,804,2,203,20302,2030201
203020102,"Coko",405,477,882,2,203,20302,2030201
203020103,"Gitara",374,378,752,2,203,20302,2030201
203020104,"Ruko",415,506,921,2,203,20302,2030201
203020201,"Cyahinda",245,316,561,2,203,20302,2030202
203020202,"Cyanwa",311,360,671,2,203,20302,2030202
203020203,"Kinyaga",321,345,666,2,203,20302,2030202
203020204,"Saburunduru",247,336,583,2,203,20302,2030202
203020205,"Urutega",272,278,550,2,203,20302,2030202
203020301,"Gasasa",326,370,696,2,203,20302,2030203
203020302,"Kavumu",108,228,336,2,203,20302,2030203
203020303,"Mugari",356,332,688,2,203,20302,2030203
203020304,"Ryamarembo",272,340,612,2,203,20302,2030203
203020401,"Busanza",398,414,812,2,203,20302,2030204
203020402,"Byanone",439,504,943,2,203,20302,2030204
203020403,"Gasharu",373,440,813,2,203,20302,2030204
203020404,"Kubitiro",410,432,842,2,203,20302,2030204
203020405,"Nyagatovu",358,419,777,2,203,20302,2030204
203020406,"Rebero",438,462,900,2,203,20302,2030204
203020501,"Kanyinya",521,594,1115,2,203,20302,2030205
203020502,"Kibumba",364,467,831,2,203,20302,2030205
203020503,"Ngobyi",443,454,897,2,203,20302,2030205
203020504,"Rubona",408,416,824,2,203,20302,2030205
203020505,"Rugarama",465,640,1105,2,203,20302,2030205
203020506,"Rutobwe",448,484,932,2,203,20302,2030205
203030101,"Nyagishayo",318,373,691,2,203,20303,2030301
203030102,"Rurembo",266,338,604,2,203,20303,2030301
203030103,"Viro",327,375,702,2,203,20303,2030301
203030201,"Agateko",438,478,916,2,203,20303,2030302
203030202,"Akajonge",337,372,709,2,203,20303,2030302
203030203,"Sinayi",581,607,1188,2,203,20303,2030302
203030301,"Kinazi",268,326,594,2,203,20303,2030303
203030302,"Migina",391,487,878,2,203,20303,2030303
203030303,"Rwimbogo",404,472,876,2,203,20303,2030303
203030401,"Banga",364,441,805,2,203,20303,2030304
203030402,"Kibayi",288,376,664,2,203,20303,2030304
203030403,"Mpanda",312,370,682,2,203,20303,2030304
203030404,"Munege",302,433,735,2,203,20303,2030304
203030501,"Mubuga",423,515,938,2,203,20303,2030305
203030502,"Nyarusovu",409,475,884,2,203,20303,2030305
203030503,"Nyarwumba",389,434,823,2,203,20303,2030305
203030504,"Umurambi",427,526,953,2,203,20303,2030305
203030505,"Uwintobo",505,553,1058,2,203,20303,2030305
203030601,"Agateko",472,532,1004,2,203,20303,2030306
203030602,"Kigona",388,474,862,2,203,20303,2030306
203030603,"Mpatswe",249,280,529,2,203,20303,2030306
203030604,"Nkomero",267,326,593,2,203,20303,2030306
203040101,"Businde",167,168,335,2,203,20304,2030401
203040102,"Cyanyirankora",279,335,614,2,203,20304,2030401
203040103,"Gakuta",535,520,1055,2,203,20304,2030401
203040104,"Ruganza",554,580,1134,2,203,20304,2030401
203040201,"Gasezo",539,631,1170,2,203,20304,2030402
203040202,"Kintama",481,559,1040,2,203,20304,2030402
203040203,"Kintare",484,492,976,2,203,20304,2030402
203040204,"Uwamizirikano",673,737,1410,2,203,20304,2030402
203040301,"Kabeza",325,330,655,2,203,20304,2030403
203040302,"Kabingo",281,286,567,2,203,20304,2030403
203040303,"Kimina",338,360,698,2,203,20304,2030403
203040304,"Uwisaga",535,563,1098,2,203,20304,2030403
203040401,"Kavumu",356,385,741,2,203,20304,2030404
203040402,"Kivu",311,354,665,2,203,20304,2030404
203040403,"Murambi",204,213,417,2,203,20304,2030404
203040404,"Rubumburi",323,297,620,2,203,20304,2030404
203040405,"Rusuzumiro",395,454,849,2,203,20304,2030404
203040501,"Kivumu",275,282,557,2,203,20304,2030405
203040502,"Misundwe",284,314,598,2,203,20304,2030405
203040503,"Nyarwotsi",402,446,848,2,203,20304,2030405
203040504,"Rugerero",527,548,1075,2,203,20304,2030405
203050101,"Mataba",359,420,779,2,203,20305,2030501
203050102,"Rimbanya",434,475,909,2,203,20305,2030501
203050103,"Ruhunga",310,362,672,2,203,20305,2030501
203050201,"Mata",410,443,853,2,203,20305,2030502
203050202,"Murambi",318,332,650,2,203,20305,2030502
203050203,"Nyamyumba",351,429,780,2,203,20305,2030502
203050204,"Runono",490,581,1071,2,203,20305,2030502
203050301,"Nyacyondo",364,398,762,2,203,20305,2030503
203050302,"Rwinanka",293,327,620,2,203,20305,2030503
203050303,"Tububuru",216,230,446,2,203,20305,2030503
203050401,"Cyafurwe",286,318,604,2,203,20305,2030504
203050402,"Gasasa",467,595,1062,2,203,20305,2030504
203050403,"Ramba",432,533,965,2,203,20305,2030504
203050501,"Matyazo",221,265,486,2,203,20305,2030505
203050502,"Rwamiko",264,326,590,2,203,20305,2030505
203050503,"Taba",312,295,607,2,203,20305,2030505
203060101,"Gashinge",331,357,688,2,203,20306,2030601
203060102,"Mubazi",441,547,988,2,203,20306,2030601
203060103,"Muganza",375,426,801,2,203,20306,2030601
203060104,"Ngara",313,382,695,2,203,20306,2030601
203060105,"Nyabirondo",252,272,524,2,203,20306,2030601
203060106,"Rambyanyana",486,528,1014,2,203,20306,2030601
203060201,"Kanazi",283,317,600,2,203,20306,2030602
203060202,"Karanka",409,404,813,2,203,20306,2030602
203060203,"Nyagisenyi",285,221,506,2,203,20306,2030602
203060204,"Remera",376,420,796,2,203,20306,2030602
203060205,"Rwishywa",296,356,652,2,203,20306,2030602
203060206,"Uwinzira",321,434,755,2,203,20306,2030602
203060301,"Bigugu",739,745,1484,2,203,20306,2030603
203060302,"Cyurukore",345,395,740,2,203,20306,2030603
203060303,"Gituntu",280,343,623,2,203,20306,2030603
203060304,"Kigwene",357,443,800,2,203,20306,2030603
203060305,"Mazimeru",338,378,716,2,203,20306,2030603
203060306,"Murambi",386,386,772,2,203,20306,2030603
203060307,"Tangabo",533,582,1115,2,203,20306,2030603
203060401,"Bitaba",268,270,538,2,203,20306,2030604
203060402,"Migendo",286,304,590,2,203,20306,2030604
203060403,"Mukongoro",391,428,819,2,203,20306,2030604
203060404,"Murambya",406,471,877,2,203,20306,2030604
203060405,"Mutovu",420,447,867,2,203,20306,2030604
203060406,"Sekera",245,263,508,2,203,20306,2030604
203070101,"Gacumu",289,330,619,2,203,20307,2030701
203070102,"Gahango",177,210,387,2,203,20307,2030701
203070103,"Gasare",223,276,499,2,203,20307,2030701
203070104,"Giheta",248,281,529,2,203,20307,2030701
203070105,"Mashya",440,503,943,2,203,20307,2030701
203070201,"Agatare",357,447,804,2,203,20307,2030702
203070202,"Akarehe",618,310,928,2,203,20307,2030702
203070203,"Gisizi",291,341,632,2,203,20307,2030702
203070204,"Gitega",251,326,577,2,203,20307,2030702
203070205,"Uwumuko",264,317,581,2,203,20307,2030702
203070301,"Akagera",302,347,649,2,203,20307,2030703
203070302,"Mushwati",160,223,383,2,203,20307,2030703
203070303,"Ndago",257,278,535,2,203,20307,2030703
203070304,"Rubona",144,168,312,2,203,20307,2030703
203070305,"Ruseke",200,263,463,2,203,20307,2030703
203070306,"Rushubi",190,185,375,2,203,20307,2030703
203070401,"Kabirizi",183,217,400,2,203,20307,2030704
203070402,"Ntwari",161,211,372,2,203,20307,2030704
203070403,"Nyambaragasa",147,151,298,2,203,20307,2030704
203070404,"Rwinanka",320,371,691,2,203,20307,2030704
203070405,"Umurambi",120,144,264,2,203,20307,2030704
203070501,"Kamana",244,312,556,2,203,20307,2030705
203070502,"Kimena",172,201,373,2,203,20307,2030705
203070503,"Muhororo",369,384,753,2,203,20307,2030705
203070504,"Munanira",187,204,391,2,203,20307,2030705
203070505,"Nyarure",251,267,518,2,203,20307,2030705
203070506,"Sheke",302,331,633,2,203,20307,2030705
203080101,"Bitare",267,284,551,2,203,20308,2030801
203080102,"Gashiru",375,415,790,2,203,20308,2030801
203080103,"Sheke",309,372,681,2,203,20308,2030801
203080201,"Cyamutumba",285,398,683,2,203,20308,2030802
203080202,"Cyaratsi",332,409,741,2,203,20308,2030802
203080203,"Mukuge",620,661,1281,2,203,20308,2030802
203080301,"Kaganda",600,720,1320,2,203,20308,2030803
203080302,"Mbogo",532,589,1121,2,203,20308,2030803
203080303,"Nyarugano",709,841,1550,2,203,20308,2030803
203080304,"Runyami",708,858,1566,2,203,20308,2030803
203080401,"Kinteko",491,623,1114,2,203,20308,2030804
203080402,"Mubuga",365,447,812,2,203,20308,2030804
203080403,"Nyamirama",492,644,1136,2,203,20308,2030804
203080501,"Gisozi",570,659,1229,2,203,20308,2030805
203080502,"Kibingo",125,152,277,2,203,20308,2030805
203080503,"Mpinga",308,418,726,2,203,20308,2030805
203080504,"Nyanza",257,362,619,2,203,20308,2030805
203080601,"Buhunga",509,587,1096,2,203,20308,2030806
203080602,"Kirwa",387,465,852,2,203,20308,2030806
203080603,"Musumba",383,466,849,2,203,20308,2030806
203080604,"Yaramba",498,552,1050,2,203,20308,2030806
203090101,"Akanyaru",314,316,630,2,203,20309,2030901
203090102,"Gasha",421,450,871,2,203,20309,2030901
203090103,"Mutakwa",344,369,713,2,203,20309,2030901
203090104,"Nteko",322,361,683,2,203,20309,2030901
203090105,"Ruli",266,333,599,2,203,20309,2030901
203090106,"Urugeyo",338,378,716,2,203,20309,2030901
203090201,"Gituramigina",282,326,608,2,203,20309,2030902
203090202,"Kirehe",340,350,690,2,203,20309,2030902
203090203,"Kiriro",316,365,681,2,203,20309,2030902
203090204,"Nyarukeri",330,372,702,2,203,20309,2030902
203090301,"Akagano",281,295,576,2,203,20309,2030903
203090302,"Gacumbi",231,274,505,2,203,20309,2030903
203090303,"Maraba",337,338,675,2,203,20309,2030903
203090304,"Munini",320,371,691,2,203,20309,2030903
203090305,"Mwumba",223,237,460,2,203,20309,2030903
203090306,"Nyagahinga",251,307,558,2,203,20309,2030903
203090401,"Gihishabwenge",315,330,645,2,203,20309,2030904
203090402,"Kigarama",241,282,523,2,203,20309,2030904
203090403,"Mugobe",272,292,564,2,203,20309,2030904
203090404,"Mujahu",249,278,527,2,203,20309,2030904
203090405,"Ururambo",388,427,815,2,203,20309,2030904
203090501,"Akabuye",271,308,579,2,203,20309,2030905
203090502,"Bihembe",440,460,900,2,203,20309,2030905
203090503,"Nyagasozi",374,401,775,2,203,20309,2030905
203090504,"Rushubi",373,408,781,2,203,20309,2030905
203090505,"Ryakanyamiganda",286,287,573,2,203,20309,2030905
203090601,"Agasaka",285,305,590,2,203,20309,2030906
203090602,"Agatovu",268,285,553,2,203,20309,2030906
203090603,"Akarambo",268,301,569,2,203,20309,2030906
203090604,"Nyamirama",265,296,561,2,203,20309,2030906
203090605,"Ryarugarama",279,284,563,2,203,20309,2030906
203090606,"Shyoko",261,318,579,2,203,20309,2030906
203100101,"Bihembe",426,492,918,2,203,20310,2031001
203100102,"Bugina",379,433,812,2,203,20310,2031001
203100103,"Gihemvu",309,339,648,2,203,20310,2031001
203100104,"Rugarama",346,357,703,2,203,20310,2031001
203100201,"Kabere",393,485,878,2,203,20310,2031002
203100202,"Nyarunazi",577,664,1241,2,203,20310,2031002
203100203,"Uwurusugi",452,494,946,2,203,20310,2031002
203100301,"Mishungero",586,612,1198,2,203,20310,2031003
203100302,"Muyira",397,441,838,2,203,20310,2031003
203100303,"Ngarama",334,387,721,2,203,20310,2031003
203100304,"Rubindi",410,474,884,2,203,20310,2031003
203100305,"Uwaruhigi",487,535,1022,2,203,20310,2031003
203100401,"Murambi",282,345,627,2,203,20310,2031004
203100402,"Mutobwe",384,401,785,2,203,20310,2031004
203100403,"Nyabimata",375,415,790,2,203,20310,2031004
203100404,"Rwerere",271,285,556,2,203,20310,2031004
203100501,"Agasugi",487,586,1073,2,203,20310,2031005
203100502,"Cyumuzi",489,556,1045,2,203,20310,2031005
203100503,"Ndaro",323,393,716,2,203,20310,2031005
203100504,"Ruhinga",313,389,702,2,203,20310,2031005
203110101,"Bugarama",284,315,599,2,203,20311,2031101
203110102,"Maraba",414,512,926,2,203,20311,2031101
203110103,"Nkima",356,373,729,2,203,20311,2031101
203110104,"Rushunguriro",476,547,1023,2,203,20311,2031101
203110201,"Agatovu",465,491,956,2,203,20311,2031102
203110202,"Bwerankori",395,458,853,2,203,20311,2031102
203110203,"Muhombo",388,422,810,2,203,20311,2031102
203110204,"Mwoya",425,444,869,2,203,20311,2031102
203110205,"Nkomero",395,434,829,2,203,20311,2031102
203110206,"Nyagashubi",378,374,752,2,203,20311,2031102
203110301,"Bihembe",489,541,1030,2,203,20311,2031103
203110302,"Kaduha",396,424,820,2,203,20311,2031103
203110303,"Nkakwa",324,366,690,2,203,20311,2031103
203110304,"Nyarubuye",361,394,755,2,203,20311,2031103
203110305,"Rarire",306,342,648,2,203,20311,2031103
203110306,"Rubuga",257,325,582,2,203,20311,2031103
203110401,"Muriza",434,527,961,2,203,20311,2031104
203110402,"Nyagishayo",401,402,803,2,203,20311,2031104
203110403,"Nyamiyaga",476,482,958,2,203,20311,2031104
203110404,"Ryabidandi",484,476,960,2,203,20311,2031104
203110405,"Uwimfizi",381,414,795,2,203,20311,2031104
203120101,"Gahotora",496,552,1048,2,203,20312,2031201
203120102,"Kibyibushye",377,412,789,2,203,20312,2031201
203120103,"Nyacyonga",274,347,621,2,203,20312,2031201
203120104,"Ruganza",287,303,590,2,203,20312,2031201
203120105,"Rusagara",453,483,936,2,203,20312,2031201
203120106,"Ryanyaruja",369,448,817,2,203,20312,2031201
203120201,"Busenyi",390,429,819,2,203,20312,2031202
203120202,"Gambiriro",368,405,773,2,203,20312,2031202
203120203,"Mukaka",396,472,868,2,203,20312,2031202
203120204,"Murambi",267,301,568,2,203,20312,2031202
203120205,"Nshenyi",304,383,687,2,203,20312,2031202
203120206,"Uwigisura",466,437,903,2,203,20312,2031202
203120301,"Cyivugiza",278,321,599,2,203,20312,2031203
203120302,"Gitwa",406,505,911,2,203,20312,2031203
203120303,"Kirwa",472,540,1012,2,203,20312,2031203
203120304,"Mutumba",297,294,591,2,203,20312,2031203
203120305,"Uwinyana",276,310,586,2,203,20312,2031203
203120401,"Rukarakara",423,484,907,2,203,20312,2031204
203120402,"Ruvuru",354,391,745,2,203,20312,2031204
203120403,"Ruyenzi",446,492,938,2,203,20312,2031204
203120404,"Tambananga",341,427,768,2,203,20312,2031204
203120405,"Zirambi",430,501,931,2,203,20312,2031204
203120501,"Gakaranka",366,399,765,2,203,20312,2031205
203120502,"Mubuga",452,513,965,2,203,20312,2031205
203120503,"Rugote",341,343,684,2,203,20312,2031205
203120504,"Uwimbogo",259,316,575,2,203,20312,2031205
203120505,"Yanza",383,407,790,2,203,20312,2031205
203130101,"Bukoro",506,613,1119,2,203,20313,2031301
203130102,"Kageyo",299,362,661,2,203,20313,2031301
203130103,"Kansi",288,307,595,2,203,20313,2031301
203130104,"Nyamirambo",303,338,641,2,203,20313,2031301
203130105,"Ryamuhumbi",274,296,570,2,203,20313,2031301
203130201,"Giseke",384,393,777,2,203,20313,2031302
203130202,"Kabari",245,281,526,2,203,20313,2031302
203130203,"Kidogo",289,349,638,2,203,20313,2031302
203130204,"Matyazo",417,446,863,2,203,20313,2031302
203130205,"Tugogo",373,423,796,2,203,20313,2031302
203130301,"Gisorora",361,406,767,2,203,20313,2031303
203130302,"Kinyonyo",227,253,480,2,203,20313,2031303
203130303,"Nyarugano",253,272,525,2,203,20313,2031303
203130304,"Uruyange",410,453,863,2,203,20313,2031303
203130401,"Rugogwe",410,459,869,2,203,20313,2031304
203130402,"Rugusa",425,477,902,2,203,20313,2031304
203130403,"Titi",341,385,726,2,203,20313,2031304
203130501,"Bugizi",343,401,744,2,203,20313,2031305
203130502,"Busasamana",385,439,824,2,203,20313,2031305
203130503,"Karambi",361,423,784,2,203,20313,2031305
203130504,"Ruramba",668,721,1389,2,203,20313,2031305
203140101,"Bunge",243,257,500,2,203,20314,2031401
203140102,"Jali",342,380,722,2,203,20314,2031401
203140103,"Nyanzoga",274,335,609,2,203,20314,2031401
203140104,"Toraniro",540,646,1186,2,203,20314,2031401
203140201,"Cyuna",431,501,932,2,203,20314,2031402
203140202,"Kiramutse",498,616,1114,2,203,20314,2031402
203140203,"Remera",429,503,932,2,203,20314,2031402
203140204,"Uwamuhizi",354,429,783,2,203,20314,2031402
203140301,"Jali",406,457,863,2,203,20314,2031403
203140302,"Kibu",311,345,656,2,203,20314,2031403
203140303,"Munanira",351,418,769,2,203,20314,2031403
203140304,"Rwabujagi",320,384,704,2,203,20314,2031403
203140401,"Gihango",203,223,426,2,203,20314,2031404
203140402,"Kabuye",409,542,951,2,203,20314,2031404
203140403,"Miko",313,397,710,2,203,20314,2031404
203140404,"Rasaniro",609,678,1287,2,203,20314,2031404
203140501,"Akabacura",566,608,1174,2,203,20314,2031405
203140502,"Gasave",335,384,719,2,203,20314,2031405
203140503,"Karimba",354,370,724,2,203,20314,2031405
203140504,"Ntanda",590,756,1346,2,203,20314,2031405
203140505,"Nyamugari",467,560,1027,2,203,20314,2031405
203140601,"Kabacuzi",441,539,980,2,203,20314,2031406
203140602,"Kamusindi",287,365,652,2,203,20314,2031406
203140603,"Kavumu",242,266,508,2,203,20314,2031406
203140604,"Runyinya",304,341,645,2,203,20314,2031406
204010101,"Byimana",294,387,681,2,204,20401,2040101
204010102,"Kamabuye",292,373,665,2,204,20401,2040101
204010103,"Karambo",264,343,607,2,204,20401,2040101
204010104,"Kigarama",328,360,688,2,204,20401,2040101
204010201,"Akagahaya",282,327,609,2,204,20401,2040102
204010202,"Busoro",255,296,551,2,204,20401,2040102
204010203,"Gasyankingi",376,374,750,2,204,20401,2040102
204010204,"Gishamvu",232,286,518,2,204,20401,2040102
204010205,"Mirambi",249,205,454,2,204,20401,2040102
204010206,"Nyagatama",212,292,504,2,204,20401,2040102
204010301,"Agakombe",140,168,308,2,204,20401,2040103
204010302,"Agasekebuye",244,271,515,2,204,20401,2040103
204010303,"Gitwa",197,271,468,2,204,20401,2040103
204010304,"Impinga",179,240,419,2,204,20401,2040103
204010305,"Kadahokwa",236,270,506,2,204,20401,2040103
204010306,"Kidahire",263,315,578,2,204,20401,2040103
204010307,"Kiduha",172,184,356,2,204,20401,2040103
204010401,"Akabere",108,118,226,2,204,20401,2040104
204010402,"Cyambwe",224,268,492,2,204,20401,2040104
204010403,"Kabeza",182,199,381,2,204,20401,2040104
204010404,"Karubare",243,288,531,2,204,20401,2040104
204010405,"Kinyovi",166,210,376,2,204,20401,2040104
204010406,"Rebero",178,196,374,2,204,20401,2040104
204010407,"Rusasa",170,204,374,2,204,20401,2040104
204010408,"Umunyinya",135,174,309,2,204,20401,2040104
204020101,"Agacyamu",116,152,268,2,204,20402,2040201
204020102,"Agasharu",158,179,337,2,204,20402,2040201
204020103,"Akagarama",129,143,272,2,204,20402,2040201
204020104,"Karuzi",125,154,279,2,204,20402,2040201
204020105,"Kigarama",118,118,236,2,204,20402,2040201
204020106,"Munini",132,167,299,2,204,20402,2040201
204020107,"Nkamatira",88,104,192,2,204,20402,2040201
204020108,"Nyarutovu",109,123,232,2,204,20402,2040201
204020109,"Nyarwumba",175,231,406,2,204,20402,2040201
204020110,"Rugerero",173,200,373,2,204,20402,2040201
204020111,"Rwankoni",133,169,302,2,204,20402,2040201
204020112,"Rwaza",196,274,470,2,204,20402,2040201
204020113,"Shuni",214,251,465,2,204,20402,2040201
204020201,"Gatongati",138,180,318,2,204,20402,2040202
204020202,"Kamutima",175,209,384,2,204,20402,2040202
204020203,"Karuhinda",234,288,522,2,204,20402,2040202
204020204,"Kigarama",330,397,727,2,204,20402,2040202
204020205,"Kinyana",281,356,637,2,204,20402,2040202
204020206,"Kinyinya",173,209,382,2,204,20402,2040202
204020207,"Mbuba",109,127,236,2,204,20402,2040202
204020208,"Munanira",187,247,434,2,204,20402,2040202
204020209,"Nyarunazi",220,231,451,2,204,20402,2040202
204020210,"Rugarama",176,200,376,2,204,20402,2040202
204020301,"Agacyamu",292,338,630,2,204,20402,2040203
204020302,"Agahenerezo",469,450,919,2,204,20402,2040203
204020303,"Agakombe",126,141,267,2,204,20402,2040203
204020304,"Agasharu",314,357,671,2,204,20402,2040203
204020305,"Gitwa",357,415,772,2,204,20402,2040203
204020306,"Kanazi",233,268,501,2,204,20402,2040203
204020307,"Kaseramba",239,304,543,2,204,20402,2040203
204020308,"Kubutare",254,264,518,2,204,20402,2040203
204020309,"Magonde",303,189,492,2,204,20402,2040203
204020310,"Nyagasambu",209,237,446,2,204,20402,2040203
204020311,"Nyanza",230,273,503,2,204,20402,2040203
204020312,"Rugarama",121,176,297,2,204,20402,2040203
204020313,"Sabaderi",185,240,425,2,204,20402,2040203
204020401,"Gako",165,181,346,2,204,20402,2040204
204020402,"Gasongati",140,161,301,2,204,20402,2040204
204020403,"Gikombe",205,223,428,2,204,20402,2040204
204020404,"Kabagendera",185,181,366,2,204,20402,2040204
204020405,"Karambo",296,310,606,2,204,20402,2040204
204020406,"Karuhayi",202,291,493,2,204,20402,2040204
204020407,"Kigarama",156,206,362,2,204,20402,2040204
204020408,"Ngobagoba",182,211,393,2,204,20402,2040204
204020409,"Rwezamenyo",238,296,534,2,204,20402,2040204
204030101,"Kibingo",351,378,729,2,204,20403,2040301
204030102,"Mataba",402,455,857,2,204,20403,2040301
204030103,"Mitsinda",275,324,599,2,204,20403,2040301
204030104,"Nyamapfunda",314,410,724,2,204,20403,2040301
204030105,"Nyamikaba",247,277,524,2,204,20403,2040301
204030201,"Agatenderi",163,211,374,2,204,20403,2040302
204030202,"Akarehe",225,262,487,2,204,20403,2040302
204030203,"Ikigarama",202,233,435,2,204,20403,2040302
204030204,"Kinani",196,216,412,2,204,20403,2040302
204030205,"Rwezamenyo",221,236,457,2,204,20403,2040302
204030301,"Akarambo",246,304,550,2,204,20403,2040303
204030302,"Mavumba",237,316,553,2,204,20403,2040303
204030303,"Mukongoro",219,262,481,2,204,20403,2040303
204030304,"Nyarusange",277,314,591,2,204,20403,2040303
204030305,"Sangano",502,622,1124,2,204,20403,2040303
204030306,"Umuyange",292,350,642,2,204,20403,2040303
204030307,"Uwarugondo",278,358,636,2,204,20403,2040303
204030401,"Agasharu",296,382,678,2,204,20403,2040304
204030402,"Agatovu",171,222,393,2,204,20403,2040304
204030403,"Mukimba",301,329,630,2,204,20403,2040304
204030404,"Nkoto",181,216,397,2,204,20403,2040304
204030405,"Nyesonga",344,376,720,2,204,20403,2040304
204030406,"Zaga",202,230,432,2,204,20403,2040304
204030501,"Butare",115,134,249,2,204,20403,2040305
204030502,"Cyetete",254,323,577,2,204,20403,2040305
204030503,"Kaburemera",223,240,463,2,204,20403,2040305
204030504,"Rugege",216,261,477,2,204,20403,2040305
204030505,"Uwimpundu",151,153,304,2,204,20403,2040305
204040101,"Birambo",141,161,302,2,204,20404,2040401
204040102,"Gihanda",196,215,411,2,204,20404,2040401
204040103,"Gishihe",182,214,396,2,204,20404,2040401
204040104,"Kababaji",180,220,400,2,204,20404,2040401
204040105,"Kabingo",88,118,206,2,204,20404,2040401
204040106,"Kamyuga",207,204,411,2,204,20404,2040401
204040107,"Karambi",247,309,556,2,204,20404,2040401
204040108,"Kavumu",192,246,438,2,204,20404,2040401
204040201,"Bande",213,218,431,2,204,20404,2040402
204040202,"Buremera",207,241,448,2,204,20404,2040402
204040203,"Kamihuro",172,154,326,2,204,20404,2040402
204040204,"Karuhimbana",224,271,495,2,204,20404,2040402
204040205,"Kinyata",139,161,300,2,204,20404,2040402
204040206,"Mahwa",136,164,300,2,204,20404,2040402
204040207,"Mbogo",184,224,408,2,204,20404,2040402
204040208,"Sekera",166,226,392,2,204,20404,2040402
204040301,"Kabingo",216,252,468,2,204,20404,2040403
204040302,"Kagina",236,251,487,2,204,20404,2040403
204040303,"Kanyamugira",156,156,312,2,204,20404,2040403
204040304,"Nyarunazi",119,117,236,2,204,20404,2040403
204040305,"Ruhungu",232,255,487,2,204,20404,2040403
204040306,"Rwabuye",224,243,467,2,204,20404,2040403
204040307,"Sanzu",280,321,601,2,204,20404,2040403
204040401,"Gasura",302,346,648,2,204,20404,2040404
204040402,"Gituntu",233,256,489,2,204,20404,2040404
204040403,"Gitwa",304,389,693,2,204,20404,2040404
204040404,"Kagarama",313,345,658,2,204,20404,2040404
204040405,"Kigarama",132,174,306,2,204,20404,2040404
204040406,"Nyarunyinya",259,275,534,2,204,20404,2040404
204040407,"Rebo",338,344,682,2,204,20404,2040404
204040501,"Gatovu",138,180,318,2,204,20404,2040405
204040502,"Kabacuzi",93,114,207,2,204,20404,2040405
204040503,"Kabakobwa",157,198,355,2,204,20404,2040405
204040504,"Nyagasozi",87,112,199,2,204,20404,2040405
204040505,"Nyarurembo",143,186,329,2,204,20404,2040405
204040506,"Rusenyi",162,165,327,2,204,20404,2040405
204040601,"Kabugabo",162,184,346,2,204,20404,2040406
204040602,"Kabumba",102,126,228,2,204,20404,2040406
204040603,"Karambi",95,133,228,2,204,20404,2040406
204040604,"Mubuga",174,187,361,2,204,20404,2040406
204040605,"Nkenke",124,140,264,2,204,20404,2040406
204040606,"Nyanzamura",148,150,298,2,204,20404,2040406
204040607,"Rugarama",184,202,386,2,204,20404,2040406
204040608,"Shaba",161,176,337,2,204,20404,2040406
204040701,"Birembo",203,268,471,2,204,20404,2040407
204040702,"Birinjo",169,209,378,2,204,20404,2040407
204040703,"Gasharu",104,122,226,2,204,20404,2040407
204040704,"Kabumba",134,140,274,2,204,20404,2040407
204040705,"Kakarusho",130,149,279,2,204,20404,2040407
204040706,"Kanyirapfundo",143,156,299,2,204,20404,2040407
204040707,"Nyagahinga",149,172,321,2,204,20404,2040407
204040708,"Ruhinga",206,204,410,2,204,20404,2040407
204040709,"Ryaruhimbya",118,146,264,2,204,20404,2040407
204040801,"Agasharu",148,160,308,2,204,20404,2040408
204040802,"Akaderege",163,188,351,2,204,20404,2040408
204040803,"Gaseke",146,145,291,2,204,20404,2040408
204040804,"Kabicuki",126,171,297,2,204,20404,2040408
204040805,"Ntuntu",185,203,388,2,204,20404,2040408
204040806,"Nyamirama",170,215,385,2,204,20404,2040408
204040807,"Serugenzi",148,172,320,2,204,20404,2040408
204050101,"Buremera",411,454,865,2,204,20405,2040501
204050102,"Gakoni",352,407,759,2,204,20405,2040501
204050103,"Nyarurama",358,408,766,2,204,20405,2040501
204050104,"Rwerinka",386,464,850,2,204,20405,2040501
204050201,"Cyegera",381,500,881,2,204,20405,2040502
204050202,"Gasaka",335,372,707,2,204,20405,2040502
204050203,"Gihana",254,292,546,2,204,20405,2040502
204050204,"Rugarama",368,422,790,2,204,20405,2040502
204050205,"Sogwe",368,445,813,2,204,20405,2040502
204050301,"Hanika",243,337,580,2,204,20405,2040503
204050302,"Karambo",260,292,552,2,204,20405,2040503
204050303,"Kinazi",225,227,452,2,204,20405,2040503
204050304,"Muti",318,366,684,2,204,20405,2040503
204050305,"Nyarugunga",256,290,546,2,204,20405,2040503
204050306,"Nyarusange",228,282,510,2,204,20405,2040503
204050307,"Rubona",264,343,607,2,204,20405,2040503
204050308,"Ruvugizo",269,333,602,2,204,20405,2040503
204050401,"Kibiraro",340,360,700,2,204,20405,2040504
204050402,"Mujyejuru",307,351,658,2,204,20405,2040504
204050403,"Munyu",306,331,637,2,204,20405,2040504
204050404,"Remera",525,555,1080,2,204,20405,2040504
204050405,"Rwambariro",420,515,935,2,204,20405,2040504
204050501,"Butare",354,419,773,2,204,20405,2040505
204050502,"Gahondo",203,234,437,2,204,20405,2040505
204050503,"Giseke",562,654,1216,2,204,20405,2040505
204050504,"Kigarama",205,253,458,2,204,20405,2040505
204050505,"Mukuzanyana",393,466,859,2,204,20405,2040505
204050506,"Nyabisindu",454,598,1052,2,204,20405,2040505
204060101,"Buremera",396,446,842,2,204,20406,2040601
204060102,"Gasarabuye",343,360,703,2,204,20406,2040601
204060103,"Kinazi",359,395,754,2,204,20406,2040601
204060104,"Nkorwe",405,447,852,2,204,20406,2040601
204060201,"Gitabure",302,345,647,2,204,20406,2040602
204060202,"Gitwa",420,441,861,2,204,20406,2040602
204060203,"Kinombe",346,345,691,2,204,20406,2040602
204060204,"Taba",351,354,705,2,204,20406,2040602
204060301,"Gasharu",360,394,754,2,204,20406,2040603
204060302,"Murama",282,339,621,2,204,20406,2040603
204060303,"Nyamvumba",291,301,592,2,204,20406,2040603
204060304,"Nyarusange",303,339,642,2,204,20406,2040603
204060305,"Rukeri",409,527,936,2,204,20406,2040603
204060401,"Bwegera",305,330,635,2,204,20406,2040604
204060402,"Gikomero",359,429,788,2,204,20406,2040604
204060403,"Kabirombe",324,358,682,2,204,20406,2040604
204060404,"Kayeye",337,373,710,2,204,20406,2040604
204060501,"Gasororo",344,392,736,2,204,20406,2040605
204060502,"Gatyazo",352,389,741,2,204,20406,2040605
204060503,"Kabirizi",263,275,538,2,204,20406,2040605
204060504,"Mpinga",265,302,567,2,204,20406,2040605
204060505,"Nyamiyaga",248,284,532,2,204,20406,2040605
204060506,"Nyantende",364,478,842,2,204,20406,2040605
204060507,"Rutontwe",313,343,656,2,204,20406,2040605
204060508,"Shyinga",287,340,627,2,204,20406,2040605
204060601,"Gisagara",401,444,845,2,204,20406,2040606
204060602,"Kagoma",396,435,831,2,204,20406,2040606
204060603,"Karambi",388,440,828,2,204,20406,2040606
204060604,"Karambo",448,516,964,2,204,20406,2040606
204060605,"Kigarama",297,364,661,2,204,20406,2040606
204060606,"Kizi",493,527,1020,2,204,20406,2040606
204070101,"Agasharu",292,325,617,2,204,20407,2040701
204070102,"Akanyinya",292,362,654,2,204,20407,2040701
204070103,"Bigangara",287,355,642,2,204,20407,2040701
204070104,"Kanyaruhinda",287,368,655,2,204,20407,2040701
204070105,"Mpinga",232,291,523,2,204,20407,2040701
204070106,"Rubona",291,334,625,2,204,20407,2040701
204070107,"Rwabuye",417,448,865,2,204,20407,2040701
204070201,"Gakombe",332,375,707,2,204,20407,2040702
204070202,"Gasharu",254,356,610,2,204,20407,2040702
204070203,"Gicubuka",281,389,670,2,204,20407,2040702
204070204,"Mpinga",379,422,801,2,204,20407,2040702
204070205,"Ndobogo",271,346,617,2,204,20407,2040702
204070206,"Rwezamenyo",406,449,855,2,204,20407,2040702
204070301,"Kagera",239,301,540,2,204,20407,2040703
204070302,"Kigusa",300,357,657,2,204,20407,2040703
204070303,"Kimuna",358,376,734,2,204,20407,2040703
204070304,"Kinyana",224,289,513,2,204,20407,2040703
204070305,"Rugarama",256,323,579,2,204,20407,2040703
204070306,"Ruryango",268,304,572,2,204,20407,2040703
204070401,"Bumbogo",214,267,481,2,204,20407,2040704
204070402,"Cyayove",306,364,670,2,204,20407,2040704
204070403,"Gitwa",275,364,639,2,204,20407,2040704
204070404,"Kaburuba",241,315,556,2,204,20407,2040704
204070405,"Murambi",459,496,955,2,204,20407,2040704
204070406,"Taba",236,304,540,2,204,20407,2040704
204070501,"Gahanga",134,158,292,2,204,20407,2040705
204070502,"Kabakono",245,278,523,2,204,20407,2040705
204070503,"Kamunyinya",194,268,462,2,204,20407,2040705
204070504,"Kanzeyi",160,214,374,2,204,20407,2040705
204070505,"Kibiraro",207,215,422,2,204,20407,2040705
204070506,"Kigarama",212,279,491,2,204,20407,2040705
204070507,"Mpinga",229,258,487,2,204,20407,2040705
204070508,"Ngeri",283,334,617,2,204,20407,2040705
204070509,"Nyabisindu",219,247,466,2,204,20407,2040705
204070510,"Nyamirundi",229,233,462,2,204,20407,2040705
204070601,"Buhoro",281,325,606,2,204,20407,2040706
204070602,"Gitwa",259,323,582,2,204,20407,2040706
204070603,"Kibirizi",235,273,508,2,204,20407,2040706
204070604,"Kingoma",226,267,493,2,204,20407,2040706
204070605,"Ruhuha",301,335,636,2,204,20407,2040706
204070701,"Cyahafi",332,389,721,2,204,20407,2040707
204070702,"Gashikiri",235,283,518,2,204,20407,2040707
204070703,"Kagarama",247,270,517,2,204,20407,2040707
204070704,"Kavumu",316,341,657,2,204,20407,2040707
204070705,"Kigwene",278,328,606,2,204,20407,2040707
204070706,"Rupango",271,274,545,2,204,20407,2040707
204080101,"Bweramana",306,370,676,2,204,20408,2040801
204080102,"Cyiri",265,293,558,2,204,20408,2040801
204080103,"Gahanga",118,155,273,2,204,20408,2040801
204080104,"Gasunzwe",205,260,465,2,204,20408,2040801
204080105,"Kigarama",207,259,466,2,204,20408,2040801
204080106,"Kizenga",198,214,412,2,204,20408,2040801
204080107,"Nyagakingi",179,254,433,2,204,20408,2040801
204080108,"Sata",282,329,611,2,204,20408,2040801
204080109,"Shingangabo",159,212,371,2,204,20408,2040801
204080110,"Taba",289,370,659,2,204,20408,2040801
204080201,"Akagarama",175,197,372,2,204,20408,2040802
204080202,"Akayenzi",102,152,254,2,204,20408,2040802
204080203,"Akogo",169,185,354,2,204,20408,2040802
204080204,"Amasanganzira",107,147,254,2,204,20408,2040802
204080205,"Kabeza",310,348,658,2,204,20408,2040802
204080206,"Kabutora",219,282,501,2,204,20408,2040802
204080207,"Mpinga",250,310,560,2,204,20408,2040802
204080208,"Nyagasambu",92,102,194,2,204,20408,2040802
204080209,"Remera",301,341,642,2,204,20408,2040802
204080210,"Rujumbura",177,228,405,2,204,20408,2040802
204080211,"Rusenyi",102,126,228,2,204,20408,2040802
204080212,"Taba",273,311,584,2,204,20408,2040802
204080301,"Akabuga",148,186,334,2,204,20408,2040803
204080302,"Akamahinda",199,306,505,2,204,20408,2040803
204080303,"Gakombe",106,186,292,2,204,20408,2040803
204080304,"Nyagisenyi",263,325,588,2,204,20408,2040803
204080305,"Nyarusambu",236,311,547,2,204,20408,2040803
204080401,"Agakera",192,249,441,2,204,20408,2040804
204080402,"Agakombe",298,349,647,2,204,20408,2040804
204080403,"Gaseke",378,464,842,2,204,20408,2040804
204080404,"Kabahora",332,400,732,2,204,20408,2040804
204080405,"Mpazi",218,214,432,2,204,20408,2040804
204080406,"Nyamata",241,302,543,2,204,20408,2040804
204080407,"Rwinuma",265,372,637,2,204,20408,2040804
204090101,"Akabuye",462,331,793,2,204,20409,2040901
204090102,"Bukinanyana",363,217,580,2,204,20409,2040901
204090103,"Buye",242,293,535,2,204,20409,2040901
204090104,"Gasoro",185,190,375,2,204,20409,2040901
204090106,"Kabutare",689,530,1219,2,204,20409,2040901
204090107,"Karubanda",10178,1165,11343,2,204,20409,2040901
204090108,"Mamba",496,177,673,2,204,20409,2040901
204090109,"Rusenyi",4283,1403,5686,2,204,20409,2040901
204090110,"Taba",574,463,1037,2,204,20409,2040901
204090201,"Gatoki",191,235,426,2,204,20409,2040902
204090202,"Kaguhu",155,175,330,2,204,20409,2040902
204090203,"Karambi",126,163,289,2,204,20409,2040902
204090204,"Nyabubare",186,188,374,2,204,20409,2040902
204090205,"Nyagapfizi",171,203,374,2,204,20409,2040902
204090206,"Rugarama",165,176,341,2,204,20409,2040902
204090207,"Runga",223,263,486,2,204,20409,2040902
204090301,"Gafurwe",296,349,645,2,204,20409,2040903
204090302,"Kabeza",396,406,802,2,204,20409,2040903
204090303,"Kamucuzi",297,340,637,2,204,20409,2040903
204090304,"Nyabitare",282,318,600,2,204,20409,2040903
204090305,"Rurenda",298,377,675,2,204,20409,2040903
204090306,"Rusisiro",308,343,651,2,204,20409,2040903
204090307,"Ruvuzo",284,314,598,2,204,20409,2040903
204090401,"Ngoma  V",311,326,637,2,204,20409,2040904
204090402,"Ngoma I",409,444,853,2,204,20409,2040904
204090403,"Ngoma III",276,273,549,2,204,20409,2040904
204090404,"Ngoma IV",292,302,594,2,204,20409,2040904
204090405,"Ngoma VI",234,230,464,2,204,20409,2040904
204090406,"Ngoma II",347,335,682,2,204,20409,2040904
204100101,"Kamuhoza",238,276,514,2,204,20410,2041001
204100102,"Kibyagira",211,229,440,2,204,20410,2041001
204100103,"Nyabijyo",178,199,377,2,204,20410,2041001
204100104,"Nyagatovu",231,272,503,2,204,20410,2041001
204100105,"Umuyange",292,344,636,2,204,20410,2041001
204100201,"Dutare",361,387,748,2,204,20410,2041002
204100202,"Karambo",295,283,578,2,204,20410,2041002
204100203,"Kigoma",246,261,507,2,204,20410,2041002
204100204,"Kiyanza",235,310,545,2,204,20410,2041002
204100205,"Murama",363,409,772,2,204,20410,2041002
204100301,"Gakoni",341,380,721,2,204,20410,2041003
204100302,"Kampongo",326,366,692,2,204,20410,2041003
204100303,"Nyakigezi",323,383,706,2,204,20410,2041003
204100304,"Rukubiro",379,465,844,2,204,20410,2041003
204100305,"Umuyinza",384,471,855,2,204,20410,2041003
204100401,"Bwankusi",354,447,801,2,204,20410,2041004
204100402,"Gashikiri",221,282,503,2,204,20410,2041004
204100403,"Gitwa",201,253,454,2,204,20410,2041004
204100404,"Karambo",297,322,619,2,204,20410,2041004
204100405,"Rwamara",285,362,647,2,204,20410,2041004
204100501,"Agasharu",261,329,590,2,204,20410,2041005
204100502,"Kinziramuhindo",237,304,541,2,204,20410,2041005
204100503,"Nyakabingo",194,232,426,2,204,20410,2041005
204100504,"Shyara",269,283,552,2,204,20410,2041005
204100505,"Taba",232,255,487,2,204,20410,2041005
204100601,"Agasharu",259,269,528,2,204,20410,2041006
204100602,"Akanyana",419,391,810,2,204,20410,2041006
204100603,"Umurambi",223,254,477,2,204,20410,2041006
204100701,"Igerero",276,229,505,2,204,20410,2041007
204100702,"Kigarama",167,202,369,2,204,20410,2041007
204100703,"Mbagabaga",276,278,554,2,204,20410,2041007
204100704,"Muginga",168,182,350,2,204,20410,2041007
204100705,"Rugarama",181,185,366,2,204,20410,2041007
204100706,"Rwamabare",191,210,401,2,204,20410,2041007
204110101,"Gasaka",157,187,344,2,204,20411,2041101
204110102,"Gasharu",202,202,404,2,204,20411,2041101
204110103,"Impinga",214,201,415,2,204,20411,2041101
204110104,"Kanyirankuba",311,345,656,2,204,20411,2041101
204110105,"Karubona",228,263,491,2,204,20411,2041101
204110106,"Kinkanga",223,230,453,2,204,20411,2041101
204110107,"Mucunda",245,281,526,2,204,20411,2041101
204110108,"Rugarama",332,323,655,2,204,20411,2041101
204110201,"Kabuga",258,319,577,2,204,20411,2041102
204110202,"Kigarama",190,249,439,2,204,20411,2041102
204110203,"Kigari",256,261,517,2,204,20411,2041102
204110204,"Mubuga",233,306,539,2,204,20411,2041102
204110205,"Ruvugizo",233,271,504,2,204,20411,2041102
204110301,"Gakomeye",227,264,491,2,204,20411,2041103
204110302,"Kagasa",256,290,546,2,204,20411,2041103
204110303,"Kavumu",156,168,324,2,204,20411,2041103
204110304,"Kigarama",358,378,736,2,204,20411,2041103
204110305,"Ndyome",188,249,437,2,204,20411,2041103
204110306,"Nyakabuye",302,333,635,2,204,20411,2041103
204110307,"Nyarutovu",157,218,375,2,204,20411,2041103
204110308,"Rubanga",295,363,658,2,204,20411,2041103
204110401,"Kamabuye",270,292,562,2,204,20411,2041104
204110402,"Kimigo",216,241,457,2,204,20411,2041104
204110403,"Murambi",266,279,545,2,204,20411,2041104
204110404,"Nyabusunzu",283,310,593,2,204,20411,2041104
204110405,"Rushikiri",185,250,435,2,204,20411,2041104
204110406,"Rwamuganda",148,138,286,2,204,20411,2041104
204110501,"Agasharu",316,359,675,2,204,20411,2041105
204110502,"Impinga",196,232,428,2,204,20411,2041105
204110503,"Nyagasozi",227,300,527,2,204,20411,2041105
204110504,"Nyamuko",262,304,566,2,204,20411,2041105
204110505,"Nyarucyamu",127,152,279,2,204,20411,2041105
204110506,"Nyarugenge",391,426,817,2,204,20411,2041105
204110507,"Rubona",94,102,196,2,204,20411,2041105
204110508,"Rugarama",183,238,421,2,204,20411,2041105
204110509,"Tumba",272,306,578,2,204,20411,2041105
204110510,"Umuremera",277,294,571,2,204,20411,2041105
204110601,"Gicubuka",217,263,480,2,204,20411,2041106
204110602,"Kabeza",121,136,257,2,204,20411,2041106
204110603,"Kibiraro",218,244,462,2,204,20411,2041106
204110604,"Mubuga",266,304,570,2,204,20411,2041106
204110605,"Murambi",176,182,358,2,204,20411,2041106
204120101,"Amarongi",279,348,627,2,204,20412,2041201
204120102,"Gatwaro",167,184,351,2,204,20412,2041201
204120103,"Nyakabuye",190,220,410,2,204,20412,2041201
204120104,"Rumana",129,147,276,2,204,20412,2041201
204120201,"Gakomeye",370,417,787,2,204,20412,2041202
204120202,"Kamwambi",346,386,732,2,204,20412,2041202
204120203,"Karambo",213,243,456,2,204,20412,2041202
204120204,"Remera",209,240,449,2,204,20412,2041202
204120205,"Rurembo",296,342,638,2,204,20412,2041202
204120301,"Murehe",123,170,293,2,204,20412,2041203
204120302,"Nyabisindu",128,155,283,2,204,20412,2041203
204120303,"Nyamivumu",136,155,291,2,204,20412,2041203
204120304,"Nyarunyinya",146,131,277,2,204,20412,2041203
204120401,"Birambo",232,269,501,2,204,20412,2041204
204120402,"Cyarera",323,412,735,2,204,20412,2041204
204120403,"Murango",271,348,619,2,204,20412,2041204
204120404,"Rugerero",321,380,701,2,204,20412,2041204
204120501,"Bweramana",277,290,567,2,204,20412,2041205
204120502,"Kigarama",312,330,642,2,204,20412,2041205
204120503,"Munanira",281,294,575,2,204,20412,2041205
204120504,"Nyagacyamu",246,304,550,2,204,20412,2041205
204120505,"Nyamabuye",260,302,562,2,204,20412,2041205
204120601,"Gasharu",316,345,661,2,204,20412,2041206
204120602,"Kibara",329,375,704,2,204,20412,2041206
204120603,"Kigarama",269,307,576,2,204,20412,2041206
204120604,"Murambi",219,242,461,2,204,20412,2041206
204120605,"Mwezi",304,339,643,2,204,20412,2041206
204120606,"Nyabujengwe",258,296,554,2,204,20412,2041206
204120607,"Rugarama",314,335,649,2,204,20412,2041206
204120701,"Karama",178,246,424,2,204,20412,2041207
204120702,"Karugumya",316,379,695,2,204,20412,2041207
204120703,"Kiboga",186,208,394,2,204,20412,2041207
204120704,"Kigarama",172,194,366,2,204,20412,2041207
204120705,"Rugarama",230,259,489,2,204,20412,2041207
204130101,"Bisambu",237,261,498,2,204,20413,2041301
204130102,"Cyendajuru",209,236,445,2,204,20413,2041301
204130103,"Kigarama",177,233,410,2,204,20413,2041301
204130104,"Matyazo",302,315,617,2,204,20413,2041301
204130105,"Rugarama",351,373,724,2,204,20413,2041301
204130106,"Ruhinga",177,185,362,2,204,20413,2041301
204130107,"Rwatsi",325,400,725,2,204,20413,2041301
204130201,"Bambiro",281,303,584,2,204,20413,2041302
204130202,"Gasharu",351,393,744,2,204,20413,2041302
204130203,"Kigarama",271,305,576,2,204,20413,2041302
204130204,"Kirarambogo",242,287,529,2,204,20413,2041302
204130205,"Nyabisindu",374,419,793,2,204,20413,2041302
204130301,"Bwiza",251,265,516,2,204,20413,2041303
204130302,"Gihinga",331,397,728,2,204,20413,2041303
204130303,"Kigarama",290,380,670,2,204,20413,2041303
204130304,"Maliza",276,311,587,2,204,20413,2041303
204130305,"Muranda",238,310,548,2,204,20413,2041303
204130306,"Ndago",304,350,654,2,204,20413,2041303
204130307,"Ntobwe",247,276,523,2,204,20413,2041303
204130308,"Rusuma",220,317,537,2,204,20413,2041303
204130309,"Umurera",342,384,726,2,204,20413,2041303
204130401,"Kigarama",214,272,486,2,204,20413,2041304
204130402,"Mugobore",259,339,598,2,204,20413,2041304
204130403,"Nyagasozi",212,236,448,2,204,20413,2041304
204130404,"Nyamirama",245,254,499,2,204,20413,2041304
204130405,"Nyamiyaga",260,326,586,2,204,20413,2041304
204130406,"Nyarurembo",179,192,371,2,204,20413,2041304
204130407,"Rugarama",185,236,421,2,204,20413,2041304
204130408,"Ryasebiganza",232,295,527,2,204,20413,2041304
204130501,"Igonde",215,246,461,2,204,20413,2041305
204130502,"Kabakobwa",222,276,498,2,204,20413,2041305
204130503,"Kanyiramana",182,179,361,2,204,20413,2041305
204130504,"Karebero",178,239,417,2,204,20413,2041305
204130505,"Kinyambo",183,191,374,2,204,20413,2041305
204130506,"Ngororero",180,226,406,2,204,20413,2041305
204130507,"Nyarukurazo",240,262,502,2,204,20413,2041305
204130508,"Remera",252,267,519,2,204,20413,2041305
204130509,"Shunga",211,231,442,2,204,20413,2041305
204130510,"Umuyange",179,202,381,2,204,20413,2041305
204140101,"Agahora",200,261,461,2,204,20414,2041401
204140102,"Agasengasenge",310,332,642,2,204,20414,2041401
204140103,"Agasharu",356,418,774,2,204,20414,2041401
204140104,"Agateme",300,297,597,2,204,20414,2041401
204140105,"Icyiri",210,301,511,2,204,20414,2041401
204140106,"Kabeza",273,316,589,2,204,20414,2041401
204140107,"Kigarama",280,302,582,2,204,20414,2041401
204140108,"Mukoni",521,554,1075,2,204,20414,2041401
204140109,"Taba",187,244,431,2,204,20414,2041401
204140201,"Abizerwa",341,387,728,2,204,20414,2041402
204140202,"Akamuhoza",379,438,817,2,204,20414,2041402
204140203,"Amahoro",420,492,912,2,204,20414,2041402
204140204,"Ubumwe",356,439,795,2,204,20414,2041402
204140205,"Ubwiyunge",281,335,616,2,204,20414,2041402
204140301,"Agasenyi",150,141,291,2,204,20414,2041403
204140302,"Berwa",395,409,804,2,204,20414,2041403
204140303,"Nyarurembo",595,565,1160,2,204,20414,2041403
204140304,"Rebero",718,756,1474,2,204,20414,2041403
204140305,"Rimba",379,354,733,2,204,20414,2041403
204140401,"Agasharu",199,292,491,2,204,20414,2041404
204140402,"Akabuga",292,368,660,2,204,20414,2041404
204140403,"Akarugiranka",324,352,676,2,204,20414,2041404
204140404,"Kigarama",467,588,1055,2,204,20414,2041404
204140405,"Musange",344,452,796,2,204,20414,2041404
204140406,"Runyinya",255,311,566,2,204,20414,2041404
204140407,"Rwanyanza",159,184,343,2,204,20414,2041404
204140501,"Akabeza",207,255,462,2,204,20414,2041405
204140502,"Akakanyamanza",228,291,519,2,204,20414,2041405
204140503,"Byimana",325,385,710,2,204,20414,2041405
204140504,"Impuhwe",248,238,486,2,204,20414,2041405
204140505,"Kigarama",351,392,743,2,204,20414,2041405
204140506,"Ntangarugero",285,342,627,2,204,20414,2041405
204140507,"Urugwiro",288,290,578,2,204,20414,2041405
205010101,"Bushigishigi",282,334,616,2,205,20501,2050101
205010102,"Giharayumbu",232,302,534,2,205,20501,2050101
205010103,"Mugote",377,408,785,2,205,20501,2050101
205010104,"Rusekera",244,325,569,2,205,20501,2050101
205010201,"Bishyiga",262,306,568,2,205,20501,2050102
205010202,"Buhoro",231,294,525,2,205,20501,2050102
205010203,"Gakangaga",300,313,613,2,205,20501,2050102
205010204,"Gihumo",333,398,731,2,205,20501,2050102
205010205,"Rukeri",297,338,635,2,205,20501,2050102
205010301,"Bitaba",186,223,409,2,205,20501,2050103
205010302,"Gifurwe",225,250,475,2,205,20501,2050103
205010303,"Nganzo",358,376,734,2,205,20501,2050103
205010304,"Nyamaberi",213,235,448,2,205,20501,2050103
205010305,"Ruronzi",175,215,390,2,205,20501,2050103
205010306,"Uwankiriye",187,197,384,2,205,20501,2050103
205010401,"Gikungu",363,380,743,2,205,20501,2050104
205010402,"Gishwati",421,460,881,2,205,20501,2050104
205010403,"Kagano",358,396,754,2,205,20501,2050104
205010404,"Kinaba",398,374,772,2,205,20501,2050104
205010405,"Minaga",413,410,823,2,205,20501,2050104
205010406,"Mujerenge",388,360,748,2,205,20501,2050104
205010407,"Tantamara",377,411,788,2,205,20501,2050104
205010408,"Uwinzira",249,284,533,2,205,20501,2050104
205010501,"Cyinyonza",232,293,525,2,205,20501,2050105
205010502,"Gitovu",337,346,683,2,205,20501,2050105
205010503,"Magumira",269,336,605,2,205,20501,2050105
205010504,"Matsinda",282,322,604,2,205,20501,2050105
205010505,"Munini",309,325,634,2,205,20501,2050105
205010506,"Rukwandu",282,322,604,2,205,20501,2050105
205010507,"Uwinzovu",321,376,697,2,205,20501,2050105
205010601,"Buruhukiro",335,403,738,2,205,20501,2050106
205010602,"Kibuburo",214,248,462,2,205,20501,2050106
205010603,"Mpanga",254,269,523,2,205,20501,2050106
205010604,"Nkamba",361,428,789,2,205,20501,2050106
205010605,"Ruseke",243,248,491,2,205,20501,2050106
205020101,"Butare",207,222,429,2,205,20502,2050201
205020102,"Gaseke",149,178,327,2,205,20502,2050201
205020103,"Gasharu",223,266,489,2,205,20502,2050201
205020104,"Gitega",230,290,520,2,205,20502,2050201
205020105,"Kigarama",160,188,348,2,205,20502,2050201
205020106,"Miko",192,175,367,2,205,20502,2050201
205020107,"Munyereri",261,279,540,2,205,20502,2050201
205020108,"Musasa",175,202,377,2,205,20502,2050201
205020109,"Rusarasi",196,224,420,2,205,20502,2050201
205020110,"Rwingoma",180,216,396,2,205,20502,2050201
205020201,"Birambo",169,169,338,2,205,20502,2050202
205020202,"Karaba",221,281,502,2,205,20502,2050202
205020203,"Karama",268,279,547,2,205,20502,2050202
205020204,"Mugamba",233,281,514,2,205,20502,2050202
205020205,"Munyinya",290,324,614,2,205,20502,2050202
205020206,"Nyamisave",141,156,297,2,205,20502,2050202
205020207,"Nyanza",529,537,1066,2,205,20502,2050202
205020208,"Rwamagana",253,259,512,2,205,20502,2050202
205020301,"Gatare",142,170,312,2,205,20502,2050203
205020302,"Gatentwe",217,263,480,2,205,20502,2050203
205020303,"Gikomero",215,206,421,2,205,20502,2050203
205020304,"Gishike",148,190,338,2,205,20502,2050203
205020305,"Kagarama",190,234,424,2,205,20502,2050203
205020306,"Kaviri",203,216,419,2,205,20502,2050203
205020307,"Nyarucyamu",254,259,513,2,205,20502,2050203
205020401,"Kabarera",213,249,462,2,205,20502,2050204
205020402,"Kamuhirwa",212,219,431,2,205,20502,2050204
205020403,"Kavumu",194,235,429,2,205,20502,2050204
205020404,"Kinga",345,341,686,2,205,20502,2050204
205020405,"Murama",178,217,395,2,205,20502,2050204
205020406,"Nyamirambo",297,317,614,2,205,20502,2050204
205020501,"Buhiga",302,349,651,2,205,20502,2050205
205020502,"Kibingo",380,440,820,2,205,20502,2050205
205020503,"Mirama",275,349,624,2,205,20502,2050205
205020504,"Mugombwa",295,323,618,2,205,20502,2050205
205020505,"Nyabisindu",261,291,552,2,205,20502,2050205
205020506,"Rugaragara",282,339,621,2,205,20502,2050205
205020601,"Bigazi",257,316,573,2,205,20502,2050206
205020602,"Gafuhisha",285,340,625,2,205,20502,2050206
205020603,"Kagarama",175,205,380,2,205,20502,2050206
205020604,"Karuvenya",194,213,407,2,205,20502,2050206
205020605,"Mbeho",236,298,534,2,205,20502,2050206
205020606,"Mugari",280,329,609,2,205,20502,2050206
205020607,"Nyamirama",113,126,239,2,205,20502,2050206
205020608,"Rusenyi",235,232,467,2,205,20502,2050206
205030101,"Gakoma",397,413,810,2,205,20503,2050301
205030102,"Gitaba",320,369,689,2,205,20503,2050301
205030103,"Munombe",844,869,1713,2,205,20503,2050301
205030104,"Nyentanga",379,449,828,2,205,20503,2050301
205030201,"Karambi",417,473,890,2,205,20503,2050302
205030202,"Kibanda",269,296,565,2,205,20503,2050302
205030203,"Kitazigurwa",512,538,1050,2,205,20503,2050302
205030204,"Munyege",582,584,1166,2,205,20503,2050302
205030205,"Ngiryi",252,282,534,2,205,20503,2050302
205030206,"Sumba",796,1074,1870,2,205,20503,2050302
205030301,"Dusego",160,185,345,2,205,20503,2050303
205030302,"Gasharu",207,259,466,2,205,20503,2050303
205030303,"Nyabivumu",167,222,389,2,205,20503,2050303
205030304,"Raro",251,288,539,2,205,20503,2050303
205030401,"Kabacuzi",907,883,1790,2,205,20503,2050304
205030402,"Kabajogo",588,543,1131,2,205,20503,2050304
205030403,"Karama",380,417,797,2,205,20503,2050304
205030404,"Kigarama",329,379,708,2,205,20503,2050304
205030405,"Nyamugari",4509,1021,5530,2,205,20503,2050304
205030406,"Nyarusange",624,606,1230,2,205,20503,2050304
205030501,"Gasaka",347,394,741,2,205,20503,2050305
205030502,"Gitantu",368,435,803,2,205,20503,2050305
205030503,"Kadoma",325,376,701,2,205,20503,2050305
205030504,"Nzega",266,304,570,2,205,20503,2050305
205030601,"Gitwa",397,430,827,2,205,20503,2050306
205030602,"Kabeza",265,337,602,2,205,20503,2050306
205030603,"Murambi",235,257,492,2,205,20503,2050306
205030604,"Muriro",277,304,581,2,205,20503,2050306
205030605,"Nyamifumba",305,339,644,2,205,20503,2050306
205040101,"Karambo",323,405,728,2,205,20504,2050401
205040102,"Karumbi",244,341,585,2,205,20504,2050401
205040103,"Muhingo",396,439,835,2,205,20504,2050401
205040104,"Twiya",298,282,580,2,205,20504,2050401
205040201,"Gashasha",339,274,613,2,205,20504,2050402
205040202,"Kiyovu",467,489,956,2,205,20504,2050402
205040203,"Murembo",155,194,349,2,205,20504,2050402
205040204,"Rwamakara",491,522,1013,2,205,20504,2050402
205040205,"Uwisuri",383,398,781,2,205,20504,2050402
205040301,"Gikungu",254,262,516,2,205,20504,2050403
205040302,"Kagano",250,265,515,2,205,20504,2050403
205040303,"Kageyo",228,279,507,2,205,20504,2050403
205040304,"Nyakabuye",260,320,580,2,205,20504,2050403
205040305,"Rukereko",301,380,681,2,205,20504,2050403
205040401,"Gasharu",229,226,455,2,205,20504,2050404
205040402,"Gituntu",231,233,464,2,205,20504,2050404
205040403,"Kamamara",216,267,483,2,205,20504,2050404
205040404,"Masangano",231,271,502,2,205,20504,2050404
205040405,"Runaba",193,242,435,2,205,20504,2050404
205040406,"Rwangambibi",311,354,665,2,205,20504,2050404
205040501,"Baziro",439,514,953,2,205,20504,2050405
205040502,"Bimba",233,295,528,2,205,20504,2050405
205040503,"Kagusa",217,233,450,2,205,20504,2050405
205040504,"Ruhanga",273,361,634,2,205,20504,2050405
205040505,"Rushyarara",238,287,525,2,205,20504,2050405
205050101,"Bamba",333,215,548,2,205,20505,2050501
205050102,"Biziguro",220,283,503,2,205,20505,2050501
205050103,"Gahama",219,253,472,2,205,20505,2050501
205050104,"Gataba",223,254,477,2,205,20505,2050501
205050105,"Gitega",180,214,394,2,205,20505,2050501
205050106,"Joma",169,192,361,2,205,20505,2050501
205050107,"Kabuga",186,215,401,2,205,20505,2050501
205050108,"Kamonyi",313,273,586,2,205,20505,2050501
205050109,"Karehe",346,324,670,2,205,20505,2050501
205050110,"Kavumu",287,283,570,2,205,20505,2050501
205050201,"Kasemanyana",244,300,544,2,205,20505,2050502
205050202,"Kibiraro",214,257,471,2,205,20505,2050502
205050203,"Nyaruryango",302,333,635,2,205,20505,2050502
205050204,"Rebero",318,405,723,2,205,20505,2050502
205050301,"Burengo",234,280,514,2,205,20505,2050503
205050302,"Gasovu",241,264,505,2,205,20505,2050503
205050303,"Gatoki",303,351,654,2,205,20505,2050503
205050304,"Kirwa",184,270,454,2,205,20505,2050503
205050305,"Munini",179,224,403,2,205,20505,2050503
205050306,"Nganzo",256,333,589,2,205,20505,2050503
205050307,"Nyakirambi",291,345,636,2,205,20505,2050503
205050308,"Ruganda",260,282,542,2,205,20505,2050503
205050401,"Gitabage",199,247,446,2,205,20505,2050504
205050402,"Kabaziro",258,307,565,2,205,20505,2050504
205050403,"Kanyege",255,296,551,2,205,20505,2050504
205050404,"Kasemazi",262,326,588,2,205,20505,2050504
205050405,"Kirehe",220,261,481,2,205,20505,2050504
205050406,"Kivumu",298,350,648,2,205,20505,2050504
205050407,"Muduha",239,243,482,2,205,20505,2050504
205050408,"Mukongoro",216,226,442,2,205,20505,2050504
205050501,"Cyugaro",289,315,604,2,205,20505,2050505
205050502,"Gashiru",131,156,287,2,205,20505,2050505
205050503,"Nkomero",221,292,513,2,205,20505,2050505
205050504,"Nyakabingo",317,342,659,2,205,20505,2050505
205050505,"Ruhuha",225,218,443,2,205,20505,2050505
205050506,"Rukeri",207,223,430,2,205,20505,2050505
205060101,"Gitwa",371,438,809,2,205,20506,2050601
205060102,"Kamiro",352,425,777,2,205,20506,2050601
205060103,"Kigarama",263,294,557,2,205,20506,2050601
205060201,"Kinyovu",330,388,718,2,205,20506,2050602
205060202,"Ntaruka",423,473,896,2,205,20506,2050602
205060203,"Rweru",248,276,524,2,205,20506,2050602
205060204,"Sovu",222,216,438,2,205,20506,2050602
205060301,"Gasharu",280,319,599,2,205,20506,2050603
205060302,"Kigarama",330,401,731,2,205,20506,2050603
205060303,"Ryanyirataba",208,239,447,2,205,20506,2050603
205060401,"Gakomeye",224,330,554,2,205,20506,2050604
205060402,"Kagarama",227,259,486,2,205,20506,2050604
205060403,"Kinyana",185,229,414,2,205,20506,2050604
205060501,"Bande",240,299,539,2,205,20506,2050605
205060502,"Nyarusange",175,204,379,2,205,20506,2050605
205060503,"Nyarusiza",286,328,614,2,205,20506,2050605
205060504,"Rutuna",263,301,564,2,205,20506,2050605
205060601,"Bahina",197,217,414,2,205,20506,2050606
205060602,"Baro",265,295,560,2,205,20506,2050606
205060603,"Kigarama",240,311,551,2,205,20506,2050606
205060604,"Muhembe",428,415,843,2,205,20506,2050606
205070101,"Kabarera",185,188,373,2,205,20507,2050701
205070102,"Kamina",280,273,553,2,205,20507,2050701
205070103,"Karandura",244,267,511,2,205,20507,2050701
205070104,"Kivumu",266,284,550,2,205,20507,2050701
205070105,"Munazi",210,226,436,2,205,20507,2050701
205070106,"Nyabusozi",242,246,488,2,205,20507,2050701
205070201,"Kasebuturanyi",342,369,711,2,205,20507,2050702
205070202,"Kirwa",261,300,561,2,205,20507,2050702
205070203,"Muyange",321,393,714,2,205,20507,2050702
205070204,"Nyakibyeyi",269,298,567,2,205,20507,2050702
205070205,"Uwinyana",243,279,522,2,205,20507,2050702
205070301,"Gasharu",239,265,504,2,205,20507,2050703
205070302,"Muduha",339,391,730,2,205,20507,2050703
205070303,"Muganza",347,393,740,2,205,20507,2050703
205070304,"Nyabubare",386,415,801,2,205,20507,2050703
205070305,"Rukamiro",420,472,892,2,205,20507,2050703
205070401,"Gisoro",186,216,402,2,205,20507,2050704
205070402,"Gitwa",172,197,369,2,205,20507,2050704
205070403,"Kavumu",326,363,689,2,205,20507,2050704
205070404,"Nyamirama",200,257,457,2,205,20507,2050704
205070405,"Nyirakiraro",247,279,526,2,205,20507,2050704
205070501,"Cyamashya",286,302,588,2,205,20507,2050705
205070502,"Gakoma",477,540,1017,2,205,20507,2050705
205070503,"Kabuga",394,425,819,2,205,20507,2050705
205070504,"Munombe",154,173,327,2,205,20507,2050705
205070505,"Nyagishubi",311,363,674,2,205,20507,2050705
205070506,"Ruhurura",318,362,680,2,205,20507,2050705
205070601,"Birembo",201,238,439,2,205,20507,2050706
205070602,"Gatovu",302,318,620,2,205,20507,2050706
205070603,"Karumbi",395,434,829,2,205,20507,2050706
205070604,"Kigarama",209,231,440,2,205,20507,2050706
205070605,"Mugote",339,371,710,2,205,20507,2050706
205070606,"Uwamataba",343,378,721,2,205,20507,2050706
205080101,"Munyinya",336,359,695,2,205,20508,2050801
205080102,"Murambi",193,211,404,2,205,20508,2050801
205080103,"Murwa",247,255,502,2,205,20508,2050801
205080104,"Nyagatovu",199,199,398,2,205,20508,2050801
205080105,"Nyamirama",240,273,513,2,205,20508,2050801
205080201,"Cyeru",269,304,573,2,205,20508,2050802
205080202,"Gikomero",158,239,397,2,205,20508,2050802
205080203,"Munini",228,268,496,2,205,20508,2050802
205080204,"Nkurubuye",311,345,656,2,205,20508,2050802
205080205,"Nyarubuye",220,285,505,2,205,20508,2050802
205080206,"Rambya",217,265,482,2,205,20508,2050802
205080301,"Gatandaganya",239,270,509,2,205,20508,2050803
205080302,"Kabere",225,263,488,2,205,20508,2050803
205080303,"Kanyege",179,232,411,2,205,20508,2050803
205080304,"Kirwa",252,283,535,2,205,20508,2050803
205080305,"Rwezamenyo",299,370,669,2,205,20508,2050803
205080306,"Ryingarura",164,179,343,2,205,20508,2050803
205080401,"Dusenyi",246,297,543,2,205,20508,2050804
205080402,"Karambo",204,202,406,2,205,20508,2050804
205080403,"Kinyana",128,153,281,2,205,20508,2050804
205080404,"Murambi",207,222,429,2,205,20508,2050804
205080405,"Nyakizu",270,317,587,2,205,20508,2050804
205080406,"Zigati",210,224,434,2,205,20508,2050804
205090101,"Bususuruke",446,482,928,2,205,20509,2050901
205090102,"Kintobo",662,635,1297,2,205,20509,2050901
205090103,"Turonzi",312,320,632,2,205,20509,2050901
205090104,"Uwabumenyi",326,387,713,2,205,20509,2050901
205090105,"Uwarwubatsi",284,335,619,2,205,20509,2050901
205090106,"Uwintyabire",398,442,840,2,205,20509,2050901
205090201,"Gahande",454,477,931,2,205,20509,2050902
205090202,"Gasasa",434,464,898,2,205,20509,2050902
205090203,"Mujuga",257,318,575,2,205,20509,2050902
205090204,"Mukaka",363,417,780,2,205,20509,2050902
205090205,"Rwufe",411,465,876,2,205,20509,2050902
205090206,"Uwanyakanyeri",411,405,816,2,205,20509,2050902
205090207,"Uwinka",380,446,826,2,205,20509,2050902
205090301,"Gahira",219,263,482,2,205,20509,2050903
205090302,"Gatare",267,288,555,2,205,20509,2050903
205090303,"Karambi",378,403,781,2,205,20509,2050903
205090304,"Uwicurangiro",214,226,440,2,205,20509,2050903
205090305,"Uwurunazi",227,275,502,2,205,20509,2050903
205090401,"Bitaba",345,377,722,2,205,20509,2050904
205090402,"Gakoko",447,517,964,2,205,20509,2050904
205090403,"Muganza",383,417,800,2,205,20509,2050904
205090404,"Muyange",481,548,1029,2,205,20509,2050904
205090405,"Uwakagoro",319,364,683,2,205,20509,2050904
205090406,"Uwinka",380,413,793,2,205,20509,2050904
205090501,"Gisarenda",488,607,1095,2,205,20509,2050905
205090502,"Kigari",398,465,863,2,205,20509,2050905
205090503,"Rubuye",386,427,813,2,205,20509,2050905
205090504,"Ruhanga",372,393,765,2,205,20509,2050905
205090505,"Uwimisigati",441,478,919,2,205,20509,2050905
205090506,"Uwurunazi",329,352,681,2,205,20509,2050905
205100101,"Karambi",283,338,621,2,205,20510,2051001
205100102,"Kibumba",292,334,626,2,205,20510,2051001
205100103,"Kigarama",216,218,434,2,205,20510,2051001
205100104,"Muhororo",197,231,428,2,205,20510,2051001
205100201,"Gatwa",305,326,631,2,205,20510,2051002
205100202,"Kabere",217,246,463,2,205,20510,2051002
205100203,"Kabuga",255,290,545,2,205,20510,2051002
205100204,"Muduha",172,188,360,2,205,20510,2051002
205100205,"Nyamirama",212,220,432,2,205,20510,2051002
205100301,"Gaseke",388,397,785,2,205,20510,2051003
205100302,"Kabeza",170,201,371,2,205,20510,2051003
205100303,"Kivomo",244,293,537,2,205,20510,2051003
205100304,"Maheresho",588,579,1167,2,205,20510,2051003
205100305,"Munanira",252,257,509,2,205,20510,2051003
205100401,"Butare",323,387,710,2,205,20510,2051004
205100402,"Gasharu",335,308,643,2,205,20510,2051004
205100403,"Gisiza",176,206,382,2,205,20510,2051004
205100404,"Gituntu",161,191,352,2,205,20510,2051004
205100405,"Nyagishumbu",220,261,481,2,205,20510,2051004
205100406,"Ruseke",238,263,501,2,205,20510,2051004
205110101,"Gakomeye",456,448,904,2,205,20511,2051101
205110102,"Gitondorero",393,439,832,2,205,20511,2051101
205110103,"Gituntu",377,391,768,2,205,20511,2051101
205110104,"Karambi",238,257,495,2,205,20511,2051101
205110105,"Maso",260,297,557,2,205,20511,2051101
205110201,"Kabuhoro",305,368,673,2,205,20511,2051102
205110202,"Kirenzi I",186,231,417,2,205,20511,2051102
205110203,"Krenzi Ii",150,135,285,2,205,20511,2051102
205110204,"Nyakibingo",198,209,407,2,205,20511,2051102
205110205,"Rutabo",257,275,532,2,205,20511,2051102
205110206,"Ryamigabo",226,261,487,2,205,20511,2051102
205110301,"Cyibande",145,164,309,2,205,20511,2051103
205110302,"Gitarama",265,282,547,2,205,20511,2051103
205110303,"Kabuye",220,287,507,2,205,20511,2051103
205110304,"Karambi",175,212,387,2,205,20511,2051103
205110305,"Kinzira",180,227,407,2,205,20511,2051103
205110306,"Runyinya",233,215,448,2,205,20511,2051103
205110401,"Kigarama",352,391,743,2,205,20511,2051104
205110402,"Nziranziza",319,359,678,2,205,20511,2051104
205110403,"Rugarama I",275,288,563,2,205,20511,2051104
205110404,"Rugarama Ii",342,352,694,2,205,20511,2051104
205110405,"Ruhanga",333,340,673,2,205,20511,2051104
205110501,"Cyabute",204,236,440,2,205,20511,2051105
205110502,"Gasiza",141,144,285,2,205,20511,2051105
205110503,"Matyazo",258,296,554,2,205,20511,2051105
205110504,"Rwamiko",228,233,461,2,205,20511,2051105
205110505,"Turyango",299,314,613,2,205,20511,2051105
205110601,"Gisovu",246,243,489,2,205,20511,2051106
205110602,"Kanyegenyege",253,343,596,2,205,20511,2051106
205110603,"Nyarusazi",256,288,544,2,205,20511,2051106
205110604,"Ruhamira A",176,216,392,2,205,20511,2051106
205110605,"Ruhamira B",195,245,440,2,205,20511,2051106
205120101,"Gasura",261,261,522,2,205,20512,2051201
205120102,"Kabingo",200,280,480,2,205,20512,2051201
205120103,"Murambi",245,258,503,2,205,20512,2051201
205120104,"Nyabivumu",193,246,439,2,205,20512,2051201
205120105,"Nyakabuye",221,237,458,2,205,20512,2051201
205120201,"Cyabagomba",227,265,492,2,205,20512,2051202
205120202,"Kabakannyi",404,407,811,2,205,20512,2051202
205120203,"Kavumu",286,345,631,2,205,20512,2051202
205120204,"Kayogoro",316,381,697,2,205,20512,2051202
205120205,"Nyakibungo",310,332,642,2,205,20512,2051202
205120206,"Nyakirambi",281,284,565,2,205,20512,2051202
205120301,"Cyabasana",216,232,448,2,205,20512,2051203
205120302,"Cyaruvunge",276,289,565,2,205,20512,2051203
205120303,"Gituntu",169,223,392,2,205,20512,2051203
205120304,"Muhororo",199,243,442,2,205,20512,2051203
205120305,"Mutakara",277,279,556,2,205,20512,2051203
205120306,"Mutuntu",225,235,460,2,205,20512,2051203
205120307,"Nyagihima",278,283,561,2,205,20512,2051203
205120401,"Gasagara",282,322,604,2,205,20512,2051204
205120402,"Kibumba",236,307,543,2,205,20512,2051204
205120403,"Mubuga",246,279,525,2,205,20512,2051204
205120404,"Nyakabuye",261,292,553,2,205,20512,2051204
205120405,"Rutuntu",280,348,628,2,205,20512,2051204
205120501,"Karama",292,317,609,2,205,20512,2051205
205120502,"Munini",240,311,551,2,205,20512,2051205
205120503,"Murehe",256,318,574,2,205,20512,2051205
205120504,"Rwankango",260,300,560,2,205,20512,2051205
205120505,"Rwina",310,338,648,2,205,20512,2051205
205120601,"Dusenyi",199,275,474,2,205,20512,2051206
205120602,"Kibaga",206,261,467,2,205,20512,2051206
205120603,"Remera",227,262,489,2,205,20512,2051206
205120604,"Ruhuga",264,248,512,2,205,20512,2051206
205120605,"Uwabarashi",218,193,411,2,205,20512,2051206
205130101,"Bisereganya",245,256,501,2,205,20513,2051301
205130102,"Gatovu",245,297,542,2,205,20513,2051301
205130103,"Gitovu",242,276,518,2,205,20513,2051301
205130104,"Kanyiranzoga",192,222,414,2,205,20513,2051301
205130105,"Nyarubande",165,189,354,2,205,20513,2051301
205130106,"Ryanyakayaga",182,200,382,2,205,20513,2051301
205130201,"Cyabwimba",137,173,310,2,205,20513,2051302
205130202,"Cyarwa",196,196,392,2,205,20513,2051302
205130203,"Gatiti",247,270,517,2,205,20513,2051302
205130204,"Giheta",161,194,355,2,205,20513,2051302
205130205,"Kabere",195,229,424,2,205,20513,2051302
205130206,"Mujyejuru",159,188,347,2,205,20513,2051302
205130207,"Nyarurambi",137,200,337,2,205,20513,2051302
205130208,"Rwabigeyo",156,180,336,2,205,20513,2051302
205130301,"Bugarama",221,234,455,2,205,20513,2051303
205130302,"Busanza",231,263,494,2,205,20513,2051303
205130303,"Gisiza",173,195,368,2,205,20513,2051303
205130304,"Kibandirwa",265,309,574,2,205,20513,2051303
205130305,"Rugano",229,249,478,2,205,20513,2051303
205130306,"Rukungu",300,341,641,2,205,20513,2051303
205130401,"Bigugu",197,220,417,2,205,20513,2051304
205130402,"Bitaba",319,329,648,2,205,20513,2051304
205130403,"Gacundura",319,319,638,2,205,20513,2051304
205130404,"Gakereko",208,274,482,2,205,20513,2051304
205130405,"Ndogondwe",173,197,370,2,205,20513,2051304
205130406,"Ruganza",267,319,586,2,205,20513,2051304
205130407,"Rukaranka",216,258,474,2,205,20513,2051304
205130501,"Karambo",150,165,315,2,205,20513,2051305
205130502,"Ngoma",104,267,371,2,205,20513,2051305
205130503,"Rebero",221,278,499,2,205,20513,2051305
205130504,"Shaki",233,265,498,2,205,20513,2051305
205130505,"Uwimituza",254,323,577,2,205,20513,2051305
205130601,"Masinde",254,341,595,2,205,20513,2051306
205130602,"Mugano",268,290,558,2,205,20513,2051306
205130603,"Nkomero",316,391,707,2,205,20513,2051306
205130604,"Nyaruhura",280,317,597,2,205,20513,2051306
205130605,"Rubumburi",311,358,669,2,205,20513,2051306
205130606,"Rugazi",268,318,586,2,205,20513,2051306
205140101,"Gorwe",241,251,492,2,205,20514,2051401
205140102,"Kagorwe",208,240,448,2,205,20514,2051401
205140103,"Kizanganya",203,251,454,2,205,20514,2051401
205140104,"Mugunda",172,207,379,2,205,20514,2051401
205140105,"Murambi",243,308,551,2,205,20514,2051401
205140106,"Ngoma",226,224,450,2,205,20514,2051401
205140107,"Nyakibande",206,262,468,2,205,20514,2051401
205140108,"Remera",233,249,482,2,205,20514,2051401
205140109,"Rusoyo",185,272,457,2,205,20514,2051401
205140110,"Rwamiko",239,294,533,2,205,20514,2051401
205140201,"Cyobe",186,242,428,2,205,20514,2051402
205140202,"Gaseke",233,257,490,2,205,20514,2051402
205140203,"Gitikirema",223,236,459,2,205,20514,2051402
205140204,"Nyagisumo",219,249,468,2,205,20514,2051402
205140205,"Nyakabingo",319,333,652,2,205,20514,2051402
205140206,"Nyakirambi",174,199,373,2,205,20514,2051402
205140207,"Nyarushike",272,321,593,2,205,20514,2051402
205140208,"Rutoyi",239,253,492,2,205,20514,2051402
205140301,"Bweramana",296,339,635,2,205,20514,2051403
205140302,"Gashwati",340,364,704,2,205,20514,2051403
205140303,"Muhembe",282,313,595,2,205,20514,2051403
205140304,"Muko",147,177,324,2,205,20514,2051403
205140305,"Mushubi",596,501,1097,2,205,20514,2051403
205140306,"Rucunda",351,404,755,2,205,20514,2051403
205140307,"Ruhinga",132,167,299,2,205,20514,2051403
205150101,"Bitandara",329,355,684,2,205,20515,2051501
205150102,"Buhanzi",213,249,462,2,205,20515,2051501
205150103,"Munanira",196,219,415,2,205,20515,2051501
205150104,"Muyange",178,255,433,2,205,20515,2051501
205150105,"Rugeyo",257,287,544,2,205,20515,2051501
205150201,"Gatorove",145,174,319,2,205,20515,2051502
205150202,"Gihunga",300,343,643,2,205,20515,2051502
205150203,"Kimbogo",147,173,320,2,205,20515,2051502
205150204,"Musaraba",171,194,365,2,205,20515,2051502
205150205,"Rusoyo",155,202,357,2,205,20515,2051502
205150206,"Rutare",191,209,400,2,205,20515,2051502
205150207,"Rwimpiri",163,215,378,2,205,20515,2051502
205150301,"Cyurwufe",174,201,375,2,205,20515,2051503
205150302,"Gihwahwa",163,195,358,2,205,20515,2051503
205150303,"Kavumu",147,179,326,2,205,20515,2051503
205150304,"Kivumu",193,255,448,2,205,20515,2051503
205150305,"Mutengeri",155,190,345,2,205,20515,2051503
205150306,"Tubuye",276,298,574,2,205,20515,2051503
205150401,"Banda",395,427,822,2,205,20515,2051504
205150402,"Kagano",268,321,589,2,205,20515,2051504
205150403,"Mugari",353,365,718,2,205,20515,2051504
205150404,"Mutarama",305,358,663,2,205,20515,2051504
205150405,"Ruhinga",405,391,796,2,205,20515,2051504
205150501,"Bisharara",180,233,413,2,205,20515,2051505
205150502,"Bucyero",235,229,464,2,205,20515,2051505
205150503,"Marambo",188,223,411,2,205,20515,2051505
205150504,"Nyaruhombo",108,132,240,2,205,20515,2051505
205150505,"Nyarwungo",170,208,378,2,205,20515,2051505
205150506,"Rangi",249,271,520,2,205,20515,2051505
205150507,"Rutoyi",315,349,664,2,205,20515,2051505
205150601,"Gakomeye",148,169,317,2,205,20515,2051506
205150602,"Gishenge",205,220,425,2,205,20515,2051506
205150603,"Karukoma",216,283,499,2,205,20515,2051506
205150604,"Kibuga",216,232,448,2,205,20515,2051506
205150605,"Twiya",220,267,487,2,205,20515,2051506
205160101,"Gisanze",247,292,539,2,205,20516,2051601
205160102,"Gitovu",330,398,728,2,205,20516,2051601
205160103,"Kanserege",255,278,533,2,205,20516,2051601
205160104,"Kirwa",176,245,421,2,205,20516,2051601
205160105,"Nyabwoma",191,211,402,2,205,20516,2051601
205160106,"Rwufe",177,195,372,2,205,20516,2051601
205160107,"Ryarubondo",287,318,605,2,205,20516,2051601
205160201,"Kagarama",537,633,1170,2,205,20516,2051602
205160202,"Kiminazi",264,254,518,2,205,20516,2051602
205160203,"Kivuruga",287,321,608,2,205,20516,2051602
205160204,"Murangara",377,387,764,2,205,20516,2051602
205160205,"Muse",253,281,534,2,205,20516,2051602
205160206,"Mwufe",157,190,347,2,205,20516,2051602
205160207,"Uwinkomo",160,182,342,2,205,20516,2051602
205160301,"Gasenge",220,257,477,2,205,20516,2051603
205160302,"Kigusa",321,363,684,2,205,20516,2051603
205160303,"Kimina",317,368,685,2,205,20516,2051603
205160304,"Muhati",226,237,463,2,205,20516,2051603
205160305,"Ruziba",170,190,360,2,205,20516,2051603
205160401,"Akanyirandori",245,303,548,2,205,20516,2051604
205160402,"Bivumu",258,283,541,2,205,20516,2051604
205160403,"Buremera",302,329,631,2,205,20516,2051604
205160404,"Cyimicanga",311,311,622,2,205,20516,2051604
205160405,"Ruganza",260,242,502,2,205,20516,2051604
205160501,"Biraro",221,253,474,2,205,20516,2051605
205160502,"Bireka",256,302,558,2,205,20516,2051605
205160503,"Gahembe",186,197,383,2,205,20516,2051605
205160504,"Kibwije",251,282,533,2,205,20516,2051605
205160505,"Mubezi",220,235,455,2,205,20516,2051605
205160506,"Muhumo",283,302,585,2,205,20516,2051605
205160507,"Rugeti",225,282,507,2,205,20516,2051605
205160508,"Rukereko",182,199,381,2,205,20516,2051605
205160509,"Uwumugeti",178,196,374,2,205,20516,2051605
205160510,"Vumwe",203,244,447,2,205,20516,2051605
205160601,"Gakoma",291,353,644,2,205,20516,2051606
205160602,"Maryohe",183,271,454,2,205,20516,2051606
205160603,"Ngororero",226,239,465,2,205,20516,2051606
205160604,"Nkomero",173,213,386,2,205,20516,2051606
205160605,"Nyarugeti",176,223,399,2,205,20516,2051606
205160606,"Rukoko",275,274,549,2,205,20516,2051606
205160607,"Uwinyana",155,177,332,2,205,20516,2051606
205170101,"Bigumira",260,267,527,2,205,20517,2051701
205170102,"Cyumuganza",268,289,557,2,205,20517,2051701
205170103,"Gakoko",370,408,778,2,205,20517,2051701
205170104,"Magumira",186,368,554,2,205,20517,2051701
205170201,"Bunyunyu",416,315,731,2,205,20517,2051702
205170202,"Gahira",366,380,746,2,205,20517,2051702
205170203,"Gititi",144,339,483,2,205,20517,2051702
205170204,"Kibugazi",320,371,691,2,205,20517,2051702
205170205,"Kunyu",318,364,682,2,205,20517,2051702
205170206,"Rugeyo",320,373,693,2,205,20517,2051702
205170207,"Uwinkingi",300,362,662,2,205,20517,2051702
205170301,"Bishya",395,452,847,2,205,20517,2051703
205170302,"Cyumuganza",222,250,472,2,205,20517,2051703
205170303,"Kabuga",292,292,584,2,205,20517,2051703
205170304,"Kabusekuru",249,238,487,2,205,20517,2051703
205170305,"Kagano",305,328,633,2,205,20517,2051703
205170306,"Sabake",309,371,680,2,205,20517,2051703
205170307,"Sekera",399,442,841,2,205,20517,2051703
205170401,"Gicaca",253,322,575,2,205,20517,2051704
205170402,"Karambo",362,402,764,2,205,20517,2051704
205170403,"Nsinduka",326,343,669,2,205,20517,2051704
205170404,"Rushubi",266,282,548,2,205,20517,2051704
205170405,"Uwanjyogoro",268,341,609,2,205,20517,2051704
205170501,"Bitaba",287,321,608,2,205,20517,2051705
205170502,"Gahango",272,299,571,2,205,20517,2051705
205170503,"Kanyampongo",270,255,525,2,205,20517,2051705
205170504,"Kimina",277,345,622,2,205,20517,2051705
205170505,"Munyege",783,559,1342,2,205,20517,2051705
205170506,"Nyarurambi",350,364,714,2,205,20517,2051705
205170601,"Mabende",221,286,507,2,205,20517,2051706
205170602,"Munini",335,345,680,2,205,20517,2051706
205170603,"Mwishogwe",263,261,524,2,205,20517,2051706
205170604,"Nyamugari",268,273,541,2,205,20517,2051706
205170605,"Rugeti",258,292,550,2,205,20517,2051706
205170606,"Subukiniro",321,376,697,2,205,20517,2051706
206010101,"Bugufi",339,406,745,2,206,20601,2060101
206010102,"Gakongoro",211,197,408,2,206,20601,2060101
206010103,"Gikarabiro",264,282,546,2,206,20601,2060101
206010104,"Kabere",333,399,732,2,206,20601,2060101
206010105,"Kamatungo",149,193,342,2,206,20601,2060101
206010106,"Kavumu",171,224,395,2,206,20601,2060101
206010107,"Mpunu",113,141,254,2,206,20601,2060101
206010108,"Munini",327,352,679,2,206,20601,2060101
206010109,"Nyakidahe",190,238,428,2,206,20601,2060101
206010110,"Nyarubuye",225,252,477,2,206,20601,2060101
206010111,"Rutarabana",175,183,358,2,206,20601,2060101
206010201,"Kabugusu",354,376,730,2,206,20601,2060102
206010202,"Nyamaraba",312,332,644,2,206,20601,2060102
206010203,"Nyarugenge",268,273,541,2,206,20601,2060102
206010204,"Nyarunyinya",239,273,512,2,206,20601,2060102
206010205,"Ruvugizo",342,366,708,2,206,20601,2060102
206010301,"Duwane",205,260,465,2,206,20601,2060103
206010302,"Gasharu",223,273,496,2,206,20601,2060103
206010303,"Gisagara",186,230,416,2,206,20601,2060103
206010304,"Kamirishyo",138,137,275,2,206,20601,2060103
206010305,"Karambo",879,920,1799,2,206,20601,2060103
206010306,"Karima",200,202,402,2,206,20601,2060103
206010307,"Karutsindo",234,220,454,2,206,20601,2060103
206010308,"Kigarama",367,341,708,2,206,20601,2060103
206010309,"Kivomo",341,400,741,2,206,20601,2060103
206010310,"Rusororo",521,335,856,2,206,20601,2060103
206010311,"Rwavuningoma",173,230,403,2,206,20601,2060103
206010312,"Rwingwe",245,258,503,2,206,20601,2060103
206010401,"Birambo",132,139,271,2,206,20601,2060104
206010402,"Bugari",231,224,455,2,206,20601,2060104
206010403,"Gasharu",122,134,256,2,206,20601,2060104
206010404,"Kabega",142,136,278,2,206,20601,2060104
206010405,"Kirambo",147,167,314,2,206,20601,2060104
206010406,"Masambu",225,244,469,2,206,20601,2060104
206010407,"Mataba",132,156,288,2,206,20601,2060104
206010408,"Munyinya",144,155,299,2,206,20601,2060104
206010409,"Ntosho",140,210,350,2,206,20601,2060104
206010410,"Nyagasozi",138,159,297,2,206,20601,2060104
206010411,"Nyakabanda",129,140,269,2,206,20601,2060104
206010412,"Nyamuko",134,141,275,2,206,20601,2060104
206010413,"Rugogwe",109,124,233,2,206,20601,2060104
206010501,"Karambi",233,264,497,2,206,20601,2060105
206010502,"Kumunyinya",200,239,439,2,206,20601,2060105
206010503,"Mubuga",177,246,423,2,206,20601,2060105
206010504,"Mukingi",231,245,476,2,206,20601,2060105
206010505,"Nyagakombe",190,200,390,2,206,20601,2060105
206010506,"Nyagitongwe",299,335,634,2,206,20601,2060105
206010507,"Nyarubuye",262,268,530,2,206,20601,2060105
206010508,"Nyarutovu",250,284,534,2,206,20601,2060105
206010509,"Rugarama",312,288,600,2,206,20601,2060105
206010510,"Rugogwe",220,227,447,2,206,20601,2060105
206010511,"Rwinyana",153,186,339,2,206,20601,2060105
206010512,"Samba",212,223,435,2,206,20601,2060105
206020101,"Gahama",141,149,290,2,206,20602,2060201
206020102,"Gakomeye",165,173,338,2,206,20602,2060201
206020103,"Gakurazo",597,484,1081,2,206,20602,2060201
206020104,"Gasharu",215,267,482,2,206,20602,2060201
206020105,"Gasiza",199,239,438,2,206,20602,2060201
206020106,"Gitanga",178,196,374,2,206,20602,2060201
206020107,"Kabusheshe",156,190,346,2,206,20602,2060201
206020108,"Kinama",174,206,380,2,206,20602,2060201
206020109,"Mayebe",204,217,421,2,206,20602,2060201
206020110,"Nyakabungo",151,170,321,2,206,20602,2060201
206020111,"Nyarusange",122,142,264,2,206,20602,2060201
206020112,"Rugerero",223,240,463,2,206,20602,2060201
206020201,"Gahengeri",224,255,479,2,206,20602,2060202
206020202,"Gatoki",269,315,584,2,206,20602,2060202
206020203,"Kamonyi",304,359,663,2,206,20602,2060202
206020204,"Kirengeri",563,419,982,2,206,20602,2060202
206020205,"Masaka",215,234,449,2,206,20602,2060202
206020206,"Nyabizenga",286,313,599,2,206,20602,2060202
206020207,"Nyamirambo",193,259,452,2,206,20602,2060202
206020208,"Rusororo",235,239,474,2,206,20602,2060202
206020301,"Akabere",218,288,506,2,206,20602,2060203
206020302,"Kavumu",218,258,476,2,206,20602,2060203
206020303,"Muhororo",232,291,523,2,206,20602,2060203
206020304,"Mujyejuru",201,215,416,2,206,20602,2060203
206020305,"Mutobo",232,242,474,2,206,20602,2060203
206020306,"Nyabisindu",207,227,434,2,206,20602,2060203
206020307,"Nyagisozi",250,258,508,2,206,20602,2060203
206020401,"Bisika",228,275,503,2,206,20602,2060204
206020402,"Gatwa",217,259,476,2,206,20602,2060204
206020403,"Gitega",180,239,419,2,206,20602,2060204
206020404,"Kanyarira",265,286,551,2,206,20602,2060204
206020405,"Karenge",246,290,536,2,206,20602,2060204
206020406,"Kibande",247,276,523,2,206,20602,2060204
206020407,"Mpanda",198,209,407,2,206,20602,2060204
206020408,"Nyaburondwe",237,267,504,2,206,20602,2060204
206020409,"Nyagahinga",289,315,604,2,206,20602,2060204
206020501,"Bukomero",615,412,1027,2,206,20602,2060205
206020502,"Karama",238,323,561,2,206,20602,2060205
206020503,"Karenge",297,320,617,2,206,20602,2060205
206020504,"Kigarama",169,201,370,2,206,20602,2060205
206020505,"Mbuye",179,204,383,2,206,20602,2060205
206020506,"Nyamiseke",139,207,346,2,206,20602,2060205
206020507,"Nyarunyinya",339,389,728,2,206,20602,2060205
206020508,"Remera",224,268,492,2,206,20602,2060205
206020509,"Rukuro",181,219,400,2,206,20602,2060205
206020510,"Rutembo",163,165,328,2,206,20602,2060205
206020601,"Bugarura",367,461,828,2,206,20602,2060206
206020602,"Gihinga",139,167,306,2,206,20602,2060206
206020603,"Kageyo",283,353,636,2,206,20602,2060206
206020604,"Kamurenzi",290,368,658,2,206,20602,2060206
206020605,"Kavumu",195,228,423,2,206,20602,2060206
206020606,"Mucubi",333,393,726,2,206,20602,2060206
206020607,"Ngando",234,259,493,2,206,20602,2060206
206020608,"Ntenyo",307,327,634,2,206,20602,2060206
206020609,"Nyabisindu",360,408,768,2,206,20602,2060206
206020610,"Rukiriza",258,298,556,2,206,20602,2060206
206020701,"Gasasa",116,146,262,2,206,20602,2060207
206020702,"Gatobotobo",309,381,690,2,206,20602,2060207
206020703,"Kizibaziba",270,308,578,2,206,20602,2060207
206020704,"Muhororo",274,287,561,2,206,20602,2060207
206020705,"Ndago",192,213,405,2,206,20602,2060207
206020706,"Nyarubumbiro",293,303,596,2,206,20602,2060207
206020707,"Nyarutovu",157,178,335,2,206,20602,2060207
206030101,"Bihembe",247,250,497,2,206,20603,2060301
206030102,"Bwama",137,168,305,2,206,20603,2060301
206030103,"Kanyinya",156,195,351,2,206,20603,2060301
206030104,"Kirwa",127,157,284,2,206,20603,2060301
206030105,"Misambagiro",157,178,335,2,206,20603,2060301
206030106,"Nyagatovu",190,213,403,2,206,20603,2060301
206030107,"Rusisiro",146,157,303,2,206,20603,2060301
206030201,"Bugaramantare",334,333,667,2,206,20603,2060302
206030202,"Karambi",270,325,595,2,206,20603,2060302
206030203,"Karurara",228,301,529,2,206,20603,2060302
206030204,"Kashyamba",914,573,1487,2,206,20603,2060302
206030205,"Mbuye",327,359,686,2,206,20603,2060302
206030206,"Muhoza",316,352,668,2,206,20603,2060302
206030207,"Rambyanyana",291,330,621,2,206,20603,2060302
206030301,"Byimana",183,198,381,2,206,20603,2060303
206030302,"Kagitare",208,231,439,2,206,20603,2060303
206030303,"Kavumu",210,237,447,2,206,20603,2060303
206030304,"Munanira",161,161,322,2,206,20603,2060303
206030305,"Muremera",250,280,530,2,206,20603,2060303
206030306,"Musekera",280,340,620,2,206,20603,2060303
206030307,"Nyabyunyu",184,202,386,2,206,20603,2060303
206030308,"Remera",154,184,338,2,206,20603,2060303
206030309,"Ruyogoro",195,239,434,2,206,20603,2060303
206030401,"Birambo",200,249,449,2,206,20603,2060304
206030402,"Kabacuzi",261,326,587,2,206,20603,2060304
206030403,"Kamuhirwa",287,361,648,2,206,20603,2060304
206030404,"Muhororo",265,315,580,2,206,20603,2060304
206030405,"Nyarusange",277,310,587,2,206,20603,2060304
206030406,"Ruhare",251,293,544,2,206,20603,2060304
206030407,"Rwankuba",279,274,553,2,206,20603,2060304
206030501,"Bugaramantare",172,193,365,2,206,20603,2060305
206030502,"Mayebe",126,181,307,2,206,20603,2060305
206030503,"Nyabivumu",220,228,448,2,206,20603,2060305
206030504,"Remera",147,211,358,2,206,20603,2060305
206030505,"Rwesero",213,251,464,2,206,20603,2060305
206030506,"Serugeme",285,342,627,2,206,20603,2060305
206030601,"Cyunyu",130,165,295,2,206,20603,2060306
206030602,"Gasharu",194,212,406,2,206,20603,2060306
206030603,"Gitwa",210,228,438,2,206,20603,2060306
206030604,"Kabakamba",168,170,338,2,206,20603,2060306
206030605,"Kanyinya",213,245,458,2,206,20603,2060306
206030606,"Kavumu",180,164,344,2,206,20603,2060306
206030607,"Kiyanja",156,213,369,2,206,20603,2060306
206030608,"Nyabitare",156,167,323,2,206,20603,2060306
206030609,"Nyagisenyi",180,214,394,2,206,20603,2060306
206030610,"Nyarushishi",205,228,433,2,206,20603,2060306
206030611,"Rusebeya",210,247,457,2,206,20603,2060306
206040101,"Burima",601,662,1263,2,206,20604,2060401
206040102,"Mirambi",627,489,1116,2,206,20604,2060401
206040103,"Nyagahama",423,449,872,2,206,20604,2060401
206040104,"Nyamiyaga",354,416,770,2,206,20604,2060401
206040105,"Nyarugenge",499,523,1022,2,206,20604,2060401
206040106,"Nyaruteja",427,467,894,2,206,20604,2060401
206040201,"Gisari",204,237,441,2,206,20604,2060402
206040202,"Kabeza",295,325,620,2,206,20604,2060402
206040203,"Kaduha",233,289,522,2,206,20604,2060402
206040204,"Kakirenzi",634,664,1298,2,206,20604,2060402
206040205,"Kamuraza",266,317,583,2,206,20604,2060402
206040206,"Kanaba",381,391,772,2,206,20604,2060402
206040207,"Kibanda",232,247,479,2,206,20604,2060402
206040208,"Matara",428,454,882,2,206,20604,2060402
206040209,"Nyabusunzu",306,374,680,2,206,20604,2060402
206040210,"Nyiranduga",243,323,566,2,206,20604,2060402
206040211,"Remera",286,321,607,2,206,20604,2060402
206040301,"Gasiza",261,295,556,2,206,20604,2060403
206040302,"Impara",332,326,658,2,206,20604,2060403
206040303,"Kabuga",237,218,455,2,206,20604,2060403
206040304,"Kacyiru",389,455,844,2,206,20604,2060403
206040305,"Kamabuye",202,188,390,2,206,20604,2060403
206040306,"Karama",273,310,583,2,206,20604,2060403
206040307,"Kareshya",179,203,382,2,206,20604,2060403
206040308,"Karuhuga",206,252,458,2,206,20604,2060403
206040309,"Marche -commun",253,253,506,2,206,20604,2060403
206040310,"Mpemba",253,305,558,2,206,20604,2060403
206040311,"Nyabinyenga",225,258,483,2,206,20604,2060403
206040312,"Nyabisindu",315,341,656,2,206,20604,2060403
206040313,"Nyiraruhinga",304,323,627,2,206,20604,2060403
206040314,"Rebero",258,329,587,2,206,20604,2060403
206040315,"Ruhuha",323,367,690,2,206,20604,2060403
206040401,"Buhanika",362,458,820,2,206,20604,2060404
206040402,"Gafumba",213,258,471,2,206,20604,2060404
206040403,"Gako",316,389,705,2,206,20604,2060404
206040404,"Gashike",283,365,648,2,206,20604,2060404
206040405,"Kagazi",377,369,746,2,206,20604,2060404
206040406,"Kigarama",313,314,627,2,206,20604,2060404
206040407,"Rubona",470,563,1033,2,206,20604,2060404
206040408,"Susa",378,522,900,2,206,20604,2060404
206040501,"Bugiranteko",474,480,954,2,206,20604,2060405
206040502,"Gatonde",308,331,639,2,206,20604,2060405
206040503,"Gitwa",460,486,946,2,206,20604,2060405
206040504,"Kanka",396,484,880,2,206,20604,2060405
206040505,"Mukoma",453,484,937,2,206,20604,2060405
206040506,"Nyarugunga",292,294,586,2,206,20604,2060405
206040507,"Nyarunazi",364,397,761,2,206,20604,2060405
206040508,"Nyirarubayi",353,384,737,2,206,20604,2060405
206040509,"Runzenze",295,328,623,2,206,20604,2060405
206040510,"Rutabo",423,493,916,2,206,20604,2060405
206050101,"Bugarura",338,347,685,2,206,20605,2060501
206050102,"Gahororo",282,327,609,2,206,20605,2060501
206050103,"Gihororo",279,320,599,2,206,20605,2060501
206050104,"Kabadende",287,313,600,2,206,20605,2060501
206050105,"Nyabivumu",347,374,721,2,206,20605,2060501
206050106,"Nyagisenyi",344,372,716,2,206,20605,2060501
206050201,"Kabasanzu",268,313,581,2,206,20605,2060502
206050202,"Muremure",280,324,604,2,206,20605,2060502
206050203,"Nyagatovu",332,343,675,2,206,20605,2060502
206050204,"Nyamagana",248,307,555,2,206,20605,2060502
206050205,"Nyarugunga",329,317,646,2,206,20605,2060502
206050206,"Nyarusange",205,221,426,2,206,20605,2060502
206050207,"Remera",279,346,625,2,206,20605,2060502
206050208,"Rubona",250,293,543,2,206,20605,2060502
206050209,"Rugarama",161,204,365,2,206,20605,2060502
206050301,"Gasharu",184,207,391,2,206,20605,2060503
206050302,"Kabareshya",174,194,368,2,206,20605,2060503
206050303,"Muyange",232,291,523,2,206,20605,2060503
206050304,"Nyarubuye",302,301,603,2,206,20605,2060503
206050305,"Rukeri",219,215,434,2,206,20605,2060503
206050306,"Sunzu",324,379,703,2,206,20605,2060503
206050307,"Wimana",245,271,516,2,206,20605,2060503
206050401,"Gasiza",284,357,641,2,206,20605,2060504
206050402,"Muyunzwe",307,311,618,2,206,20605,2060504
206050403,"Nyamirambo",255,264,519,2,206,20605,2060504
206050404,"Nyarubumbiro",253,368,621,2,206,20605,2060504
206050405,"Nyarutovu",249,318,567,2,206,20605,2060504
206050406,"Ruhuha",251,309,560,2,206,20605,2060504
206050501,"Buhanda",363,390,753,2,206,20605,2060505
206050502,"Bweramana",226,246,472,2,206,20605,2060505
206050503,"Gashirabwoba",333,418,751,2,206,20605,2060505
206050504,"Kibirizi",339,391,730,2,206,20605,2060505
206050505,"Rusizi",279,353,632,2,206,20605,2060505
206050506,"Shamba",265,330,595,2,206,20605,2060505
206050601,"Dusenyi",302,346,648,2,206,20605,2060506
206050602,"Kabacuzi",265,303,568,2,206,20605,2060506
206050603,"Kabirizi",277,325,602,2,206,20605,2060506
206050604,"Kabuga",249,256,505,2,206,20605,2060506
206050605,"Munini",226,264,490,2,206,20605,2060506
206050606,"Murinzi",124,149,273,2,206,20605,2060506
206060101,"Kabungo",332,302,634,2,206,20606,2060601
206060102,"Murambi",274,285,559,2,206,20606,2060601
206060103,"Nyamikoni",289,336,625,2,206,20606,2060601
206060104,"Rwamiko",285,325,610,2,206,20606,2060601
206060105,"Wimana",271,315,586,2,206,20606,2060601
206060201,"Bienvenue",349,376,725,2,206,20606,2060602
206060202,"Gisanga",319,327,646,2,206,20606,2060602
206060203,"Gishari",305,370,675,2,206,20606,2060602
206060204,"Karama",222,274,496,2,206,20606,2060602
206060205,"Kavumu",321,348,669,2,206,20606,2060602
206060206,"Nyarugenge",219,264,483,2,206,20606,2060602
206060207,"Sabudari",217,254,471,2,206,20606,2060602
206060208,"Sahara",225,254,479,2,206,20606,2060602
206060301,"Kabuga",282,329,611,2,206,20606,2060603
206060302,"Kinyinya",188,222,410,2,206,20606,2060603
206060303,"Kirwa",232,252,484,2,206,20606,2060603
206060304,"Mpungwe",204,236,440,2,206,20606,2060603
206060305,"Musenyi",351,386,737,2,206,20606,2060603
206060306,"Nyabisindu",250,281,531,2,206,20606,2060603
206060307,"Nyakabanda",244,255,499,2,206,20606,2060603
206060308,"Nyamutarama",191,210,401,2,206,20606,2060603
206060309,"Rugarama",236,264,500,2,206,20606,2060603
206060310,"Rwinkuba",261,279,540,2,206,20606,2060603
206060401,"Bereshi",248,283,531,2,206,20606,2060604
206060402,"Biraro",291,344,635,2,206,20606,2060604
206060403,"Bunyeshywa",256,253,509,2,206,20606,2060604
206060404,"Kangoma",204,222,426,2,206,20606,2060604
206060405,"Kivumu",255,291,546,2,206,20606,2060604
206060406,"Kizibere",519,626,1145,2,206,20606,2060604
206060407,"Mayunzwe",317,377,694,2,206,20606,2060604
206060408,"Nyamiyaga",316,332,648,2,206,20606,2060604
206060409,"Rebero",227,251,478,2,206,20606,2060604
206060410,"Ruhuha",235,261,496,2,206,20606,2060604
206060501,"Buremera",350,376,726,2,206,20606,2060605
206060502,"Cyeru",288,293,581,2,206,20606,2060605
206060503,"Cyobe",327,353,680,2,206,20606,2060605
206060504,"Kamurema",311,337,648,2,206,20606,2060605
206060505,"Kanyinya",264,322,586,2,206,20606,2060605
206060506,"Kinyambo",196,231,427,2,206,20606,2060605
206060507,"Ruyenzi",305,338,643,2,206,20606,2060605
206060508,"Rwimposha",265,286,551,2,206,20606,2060605
206060601,"Cyanika",219,261,480,2,206,20606,2060606
206060602,"Gafunzo",461,485,946,2,206,20606,2060606
206060603,"Gasanganya",180,271,451,2,206,20606,2060606
206060604,"Gatare",243,257,500,2,206,20606,2060606
206060605,"Giticyuma",255,264,519,2,206,20606,2060606
206060606,"Ipate",346,342,688,2,206,20606,2060606
206060607,"Kabuga",243,304,547,2,206,20606,2060606
206060608,"Karama",289,303,592,2,206,20606,2060606
206060609,"Karusizi",182,197,379,2,206,20606,2060606
206060610,"Kavumu",279,336,615,2,206,20606,2060606
206060611,"Kidoma",333,350,683,2,206,20606,2060606
206060612,"Mataba",218,253,471,2,206,20606,2060606
206060613,"Vunga",216,264,480,2,206,20606,2060606
206060701,"Bereshi",192,229,421,2,206,20606,2060607
206060702,"Jari",237,288,525,2,206,20606,2060607
206060703,"Kigabiro",473,542,1015,2,206,20606,2060607
206060704,"Nyakarekare",468,548,1016,2,206,20606,2060607
206060705,"Nyaruyonga",306,362,668,2,206,20606,2060607
206060706,"Rubona",245,286,531,2,206,20606,2060607
206060707,"Ruyenzi",147,166,313,2,206,20606,2060607
206060708,"Vugiza",186,222,408,2,206,20606,2060607
206070101,"Kagarama",207,198,405,2,206,20607,2060701
206070102,"Kajevuba",358,336,694,2,206,20607,2060701
206070103,"Kimburu",235,227,462,2,206,20607,2060701
206070104,"Nyamigina",250,276,526,2,206,20607,2060701
206070105,"Nyamugari",223,272,495,2,206,20607,2060701
206070106,"Ruhamagariro",320,337,657,2,206,20607,2060701
206070107,"Rutagara",208,190,398,2,206,20607,2060701
206070201,"Kanzu",211,242,453,2,206,20607,2060702
206070202,"Mabanza",165,187,352,2,206,20607,2060702
206070203,"Nyakabuye",201,192,393,2,206,20607,2060702
206070204,"Nyakizu",268,272,540,2,206,20607,2060702
206070205,"Rubona",230,241,471,2,206,20607,2060702
206070301,"Bugaramantare",280,342,622,2,206,20607,2060703
206070302,"Gakomeye",202,206,408,2,206,20607,2060703
206070303,"Gitwa",266,264,530,2,206,20607,2060703
206070304,"Nyarusange",238,265,503,2,206,20607,2060703
206070401,"Gisiza",183,197,380,2,206,20607,2060704
206070402,"Gitaraga",172,183,355,2,206,20607,2060704
206070403,"Kabacuzi",179,191,370,2,206,20607,2060704
206070404,"Kaburinga",229,267,496,2,206,20607,2060704
206070405,"Kamuganga",207,194,401,2,206,20607,2060704
206070406,"Kamuzimanganya",188,219,407,2,206,20607,2060704
206070407,"Kivumu",198,221,419,2,206,20607,2060704
206070501,"Buhoro",256,284,540,2,206,20607,2060705
206070502,"Dusego",174,188,362,2,206,20607,2060705
206070503,"Gasyogogo",225,241,466,2,206,20607,2060705
206070504,"Karambo",297,364,661,2,206,20607,2060705
206070601,"Bunyankungu",426,444,870,2,206,20607,2060706
206070602,"Gashiru",266,330,596,2,206,20607,2060706
206070603,"Kabiha",202,194,396,2,206,20607,2060706
206070604,"Kakarima",201,202,403,2,206,20607,2060706
206070605,"Mbunduye",248,262,510,2,206,20607,2060706
206070606,"Murambi",231,268,499,2,206,20607,2060706
206070607,"Nyabisindu",179,211,390,2,206,20607,2060706
206070701,"Kiganira",282,324,606,2,206,20607,2060707
206070702,"Ntongwe",323,338,661,2,206,20607,2060707
206070703,"Nyarutovu",178,204,382,2,206,20607,2060707
206070704,"Nyaruvumu",166,181,347,2,206,20607,2060707
206070705,"Rukeri",279,313,592,2,206,20607,2060707
206070706,"Ryakabunga",291,325,616,2,206,20607,2060707
206070801,"Buhigiro",183,231,414,2,206,20607,2060708
206070802,"Gaseke",348,313,661,2,206,20607,2060708
206070803,"Gasharu",250,312,562,2,206,20607,2060708
206070804,"Rugasari",177,199,376,2,206,20607,2060708
206070805,"Ruhondo",320,345,665,2,206,20607,2060708
206080101,"Cyimana",386,452,838,2,206,20608,2060801
206080102,"Gikoma",360,405,765,2,206,20608,2060801
206080103,"Kamakara",342,394,736,2,206,20608,2060801
206080104,"Kantwari",299,314,613,2,206,20608,2060801
206080105,"Nyabuhuzu",313,374,687,2,206,20608,2060801
206080106,"Nyabyugi",297,387,684,2,206,20608,2060801
206080107,"Nyamahwa",296,374,670,2,206,20608,2060801
206080201,"Kavumu",308,374,682,2,206,20608,2060802
206080202,"Kibatsi",291,338,629,2,206,20608,2060802
206080203,"Marimba",351,378,729,2,206,20608,2060802
206080204,"Ruko",375,403,778,2,206,20608,2060802
206080301,"Kanyete",301,339,640,2,206,20608,2060803
206080302,"Kirwa",318,414,732,2,206,20608,2060803
206080303,"Ntungamo",293,344,637,2,206,20608,2060803
206080304,"Nyagatovu",284,301,585,2,206,20608,2060803
206080305,"Nyamigende",233,277,510,2,206,20608,2060803
206080401,"Cyeru",256,266,522,2,206,20608,2060804
206080402,"Gasuna",314,314,628,2,206,20608,2060804
206080403,"Kaburanjwiri",259,296,555,2,206,20608,2060804
206080404,"Nyabigunzu",238,263,501,2,206,20608,2060804
206080405,"Nyabitare",289,305,594,2,206,20608,2060804
206080406,"Nyacyonga",270,312,582,2,206,20608,2060804
206080407,"Ruko",335,369,704,2,206,20608,2060804
206080501,"Karama",316,357,673,2,206,20608,2060805
206080502,"Nyamirama",290,317,607,2,206,20608,2060805
206080503,"Nyarusange",292,290,582,2,206,20608,2060805
206080601,"Byimana",273,367,640,2,206,20608,2060806
206080602,"Gacuriro",266,354,620,2,206,20608,2060806
206080603,"Kamaraba",186,229,415,2,206,20608,2060806
206080604,"Karama",235,255,490,2,206,20608,2060806
206080605,"Kigabiro",313,324,637,2,206,20608,2060806
206080606,"Kintore",254,307,561,2,206,20608,2060806
206080607,"Mutima",475,555,1030,2,206,20608,2060806
206080608,"Nyamirama",229,250,479,2,206,20608,2060806
206080701,"Gahunga",179,220,399,2,206,20608,2060807
206080702,"Gikoni",212,243,455,2,206,20608,2060807
206080703,"Kamaraba",214,253,467,2,206,20608,2060807
206080704,"Karama",197,249,446,2,206,20608,2060807
206080705,"Mukoni",148,180,328,2,206,20608,2060807
206080706,"Munini",256,305,561,2,206,20608,2060807
206080707,"Nyamirambo",220,250,470,2,206,20608,2060807
206080708,"Nyarugenge",189,224,413,2,206,20608,2060807
206080709,"Nyarwahi",236,242,478,2,206,20608,2060807
206080710,"Ruhuha",184,227,411,2,206,20608,2060807
206080711,"Rwakajuju",146,206,352,2,206,20608,2060807
206080712,"Rwintama",309,346,655,2,206,20608,2060807
206090101,"Buhoro",265,299,564,2,206,20609,2060901
206090102,"Gako",165,164,329,2,206,20609,2060901
206090103,"Kabeza",221,240,461,2,206,20609,2060901
206090104,"Kantama",269,303,572,2,206,20609,2060901
206090105,"Karambo",270,265,535,2,206,20609,2060901
206090106,"Muhororo I",233,250,483,2,206,20609,2060901
206090107,"Muhororo Ii",202,226,428,2,206,20609,2060901
206090108,"Ntinyinshi",233,257,490,2,206,20609,2060901
206090109,"Nyagasozi",162,198,360,2,206,20609,2060901
206090110,"Nyangandika",235,307,542,2,206,20609,2060901
206090111,"Nyarutovu I",165,161,326,2,206,20609,2060901
206090112,"Rwinkuba",240,248,488,2,206,20609,2060901
206090201,"Bugarura",198,243,441,2,206,20609,2060902
206090202,"Busego",267,292,559,2,206,20609,2060902
206090203,"Gacoko",253,238,491,2,206,20609,2060902
206090204,"Gishegesha",189,224,413,2,206,20609,2060902
206090205,"Kabega",218,224,442,2,206,20609,2060902
206090206,"Kamugaru",202,235,437,2,206,20609,2060902
206090207,"Kamugaza",213,260,473,2,206,20609,2060902
206090208,"Karehe",220,261,481,2,206,20609,2060902
206090209,"Kasemahundo",170,207,377,2,206,20609,2060902
206090210,"Kavumu",205,231,436,2,206,20609,2060902
206090211,"Kigabiro",199,229,428,2,206,20609,2060902
206090212,"Kigarama",205,233,438,2,206,20609,2060902
206090213,"Murehe",214,224,438,2,206,20609,2060902
206090214,"Nyabibugu",196,224,420,2,206,20609,2060902
206090215,"Nyabisindu",240,242,482,2,206,20609,2060902
206090216,"Remera",203,239,442,2,206,20609,2060902
206090217,"Rubazi",196,229,425,2,206,20609,2060902
206090218,"Rusebeya",179,202,381,2,206,20609,2060902
206090219,"Rwankuba",211,241,452,2,206,20609,2060902
206090301,"Gatengeri",220,247,467,2,206,20609,2060903
206090302,"Gikumba",266,277,543,2,206,20609,2060903
206090303,"Karama",172,189,361,2,206,20609,2060903
206090304,"Murambi",181,246,427,2,206,20609,2060903
206090305,"Nangurugomo",194,192,386,2,206,20609,2060903
206090306,"Nyarusange",195,218,413,2,206,20609,2060903
206090307,"Rebero",260,255,515,2,206,20609,2060903
206090308,"Rubiha",137,139,276,2,206,20609,2060903
206090309,"Rurembo",164,231,395,2,206,20609,2060903
206090310,"Ryabonyinka",158,152,310,2,206,20609,2060903
206090311,"Wimana",199,242,441,2,206,20609,2060903
206090401,"Bisambu",205,224,429,2,206,20609,2060904
206090402,"Bugari",139,184,323,2,206,20609,2060904
206090403,"Bwiza",165,175,340,2,206,20609,2060904
206090404,"Cyeshero",257,268,525,2,206,20609,2060904
206090405,"Gahama",133,145,278,2,206,20609,2060904
206090406,"Gaseke",136,161,297,2,206,20609,2060904
206090407,"Gataka",225,216,441,2,206,20609,2060904
206090408,"Gitwa",143,169,312,2,206,20609,2060904
206090409,"Kabaja",162,178,340,2,206,20609,2060904
206090410,"Kaburanjwiri",141,182,323,2,206,20609,2060904
206090411,"Kanazi",230,249,479,2,206,20609,2060904
206090412,"Kibingo",524,547,1071,2,206,20609,2060904
206090413,"Kigaga",158,187,345,2,206,20609,2060904
206090414,"Kirima",143,170,313,2,206,20609,2060904
206090415,"Kiruhura",91,121,212,2,206,20609,2060904
206090416,"Munini",306,260,566,2,206,20609,2060904
206090417,"Muremera",161,199,360,2,206,20609,2060904
206090418,"Nyabinyenga",213,186,399,2,206,20609,2060904
206090419,"Nyinya",192,198,390,2,206,20609,2060904
206090420,"Ruhuha",193,217,410,2,206,20609,2060904
206090421,"Rwezamenyo",152,173,325,2,206,20609,2060904
206090501,"Cana",133,145,278,2,206,20609,2060905
206090502,"Gaseke",104,133,237,2,206,20609,2060905
206090503,"Jokoma",163,189,352,2,206,20609,2060905
206090504,"Kabere",126,135,261,2,206,20609,2060905
206090505,"Kamabare",174,193,367,2,206,20609,2060905
206090506,"Kinama",108,141,249,2,206,20609,2060905
206090507,"Kinkene",180,192,372,2,206,20609,2060905
206090508,"Musamo",143,148,291,2,206,20609,2060905
206090509,"Mwali",170,179,349,2,206,20609,2060905
206090510,"Rwinkuba",196,215,411,2,206,20609,2060905
206090511,"Rwinyege",149,134,283,2,206,20609,2060905
206090512,"Ryanyiranda",159,165,324,2,206,20609,2060905
206090513,"Wimana",134,158,292,2,206,20609,2060905
206090601,"Bumbogo",269,289,558,2,206,20609,2060906
206090602,"Butare I",184,252,436,2,206,20609,2060906
206090603,"Butare Ii",196,238,434,2,206,20609,2060906
206090604,"Bwangacumu",272,293,565,2,206,20609,2060906
206090605,"Gataka",356,469,825,2,206,20609,2060906
206090606,"Gatengezi",296,318,614,2,206,20609,2060906
206090607,"Gutamba",175,163,338,2,206,20609,2060906
206090608,"Kamabano",258,275,533,2,206,20609,2060906
206090609,"Kigabiro",271,303,574,2,206,20609,2060906
206090610,"Kigimbu",191,218,409,2,206,20609,2060906
206090611,"Kinama",242,293,535,2,206,20609,2060906
206090612,"Mabera",293,316,609,2,206,20609,2060906
206090613,"Mujyejuru I",658,678,1336,2,206,20609,2060906
206090614,"Mujyejuru Ii",244,189,433,2,206,20609,2060906
206090615,"Murinzi",265,288,553,2,206,20609,2060906
206090616,"Ngurukizi",395,325,720,2,206,20609,2060906
206090617,"Ntungamo",200,215,415,2,206,20609,2060906
206090618,"Nyabihanga",244,267,511,2,206,20609,2060906
206090619,"Nyagasozi",238,263,501,2,206,20609,2060906
206090620,"Nyamagana",302,294,596,2,206,20609,2060906
206090621,"Nyamugari",177,182,359,2,206,20609,2060906
206090622,"Nyarusange I",225,250,475,2,206,20609,2060906
206090623,"Nyarusange Ii",238,241,479,2,206,20609,2060906
206090624,"Ruhango",387,366,753,2,206,20609,2060906
206090625,"Ruhuha",278,254,532,2,206,20609,2060906
206090701,"Bihome",305,287,592,2,206,20609,2060907
206090702,"Bugarama",206,235,441,2,206,20609,2060907
206090703,"Bunyogombe",218,241,459,2,206,20609,2060907
206090704,"Bushenyi",281,254,535,2,206,20609,2060907
206090705,"Gasharu",177,201,378,2,206,20609,2060907
206090706,"Gatebe",173,182,355,2,206,20609,2060907
206090707,"Kabambati",187,213,400,2,206,20609,2060907
206090708,"Kangoga",184,207,391,2,206,20609,2060907
206090709,"Kavumu",233,277,510,2,206,20609,2060907
206090710,"Kibiraro",181,205,386,2,206,20609,2060907
206090711,"Muyange",195,246,441,2,206,20609,2060907
206090712,"Mwezi",205,241,446,2,206,20609,2060907
206090713,"Nyabisindu",189,189,378,2,206,20609,2060907
206090714,"Ruhango",249,244,493,2,206,20609,2060907
206090715,"Rwinkuba",216,243,459,2,206,20609,2060907
206090716,"Rwoga",212,264,476,2,206,20609,2060907
206090801,"Buterana",200,190,390,2,206,20609,2060908
206090802,"Mubuga",318,307,625,2,206,20609,2060908
206090803,"Nyamugari I",256,297,553,2,206,20609,2060908
206090804,"Nyamugari Ii",215,208,423,2,206,20609,2060908
206090805,"Nyundo",359,353,712,2,206,20609,2060908
206090806,"Ruduha I",211,248,459,2,206,20609,2060908
206090807,"Ruduha Ii",308,311,619,2,206,20609,2060908
206090808,"Rugarama",181,219,400,2,206,20609,2060908
206090809,"Rugondo",180,219,399,2,206,20609,2060908
206090810,"Tambwe",262,288,550,2,206,20609,2060908
207010101,"Gatare",218,249,467,2,207,20701,2070101
207010102,"Karama",439,506,945,2,207,20701,2070101
207010103,"Kuwimana",378,434,812,2,207,20701,2070101
207010104,"Munini",320,362,682,2,207,20701,2070101
207010105,"Nyabisindu",384,427,811,2,207,20701,2070101
207010201,"Cyanika",297,406,703,2,207,20701,2070102
207010202,"Kajeje",536,626,1162,2,207,20701,2070102
207010203,"Mataba",464,505,969,2,207,20701,2070102
207010204,"Mbirizi",547,613,1160,2,207,20701,2070102
207010205,"Nyagatovu",473,528,1001,2,207,20701,2070102
207010206,"Rwinkuba",402,432,834,2,207,20701,2070102
207010301,"Buruba",376,458,834,2,207,20701,2070103
207010302,"Busozi",302,303,605,2,207,20701,2070103
207010303,"Bwirika",343,384,727,2,207,20701,2070103
207010304,"Bwiza",413,466,879,2,207,20701,2070103
207010305,"Kamonyi",314,381,695,2,207,20701,2070103
207010306,"Musengo",411,490,901,2,207,20701,2070103
207010307,"Takwe",355,440,795,2,207,20701,2070103
207010401,"Binunga",463,517,980,2,207,20701,2070104
207010402,"Kanyanza",367,394,761,2,207,20701,2070104
207010403,"Kigaga",431,470,901,2,207,20701,2070104
207010404,"Nyagatovu",305,388,693,2,207,20701,2070104
207010405,"Rwamugoroba",429,532,961,2,207,20701,2070104
207010501,"Bishike",530,550,1080,2,207,20701,2070105
207010502,"Bucyeye",492,592,1084,2,207,20701,2070105
207010503,"Buhoro",359,401,760,2,207,20701,2070105
207010504,"Gasovu",416,482,898,2,207,20701,2070105
207010505,"Gatete",288,304,592,2,207,20701,2070105
207010506,"Rusave",472,480,952,2,207,20701,2070105
207010601,"Gitondwe",315,384,699,2,207,20701,2070106
207010602,"Karehe",333,444,777,2,207,20701,2070106
207010603,"Kibumba",435,491,926,2,207,20701,2070106
207010604,"Nyarubuye",410,503,913,2,207,20701,2070106
207010605,"Rubimba",449,518,967,2,207,20701,2070106
207020101,"Gahembe",346,408,754,2,207,20702,2070201
207020102,"Gahinga",415,456,871,2,207,20702,2070201
207020103,"Kabayaza",307,332,639,2,207,20702,2070201
207020104,"Kirambo",232,282,514,2,207,20702,2070201
207020105,"Musasa",319,393,712,2,207,20702,2070201
207020201,"Buyoga",328,464,792,2,207,20702,2070202
207020202,"Gihinga",565,614,1179,2,207,20702,2070202
207020203,"Karambo",413,422,835,2,207,20702,2070202
207020204,"Nyirabwayi",362,410,772,2,207,20702,2070202
207020301,"Kabuga",504,605,1109,2,207,20702,2070203
207020302,"Peru",470,540,1010,2,207,20702,2070203
207020401,"Gasave",238,250,488,2,207,20702,2070204
207020402,"Gasiza",273,368,641,2,207,20702,2070204
207020403,"Kabuga",198,226,424,2,207,20702,2070204
207020404,"Rebero",337,346,683,2,207,20702,2070204
207020405,"Rukoma",217,230,447,2,207,20702,2070204
207020501,"Gasharu",294,344,638,2,207,20702,2070205
207020502,"Kamiranzogera",269,307,576,2,207,20702,2070205
207020503,"Kanka",335,396,731,2,207,20702,2070205
207020504,"Kibaya",431,456,887,2,207,20702,2070205
207020601,"Kabuga",457,493,950,2,207,20702,2070206
207020602,"Karambo",423,495,918,2,207,20702,2070206
207020603,"Mpanga",261,338,599,2,207,20702,2070206
207020604,"Nzovi",179,195,374,2,207,20702,2070206
207020701,"Cyambari",339,395,734,2,207,20702,2070207
207020702,"Gitwa",310,350,660,2,207,20702,2070207
207020703,"Nkegete",181,222,403,2,207,20702,2070207
207020704,"Nyarunyinya",228,282,510,2,207,20702,2070207
207020705,"Peru",272,338,610,2,207,20702,2070207
207020801,"Gakondokondo",333,407,740,2,207,20702,2070208
207020802,"Gitwa",374,398,772,2,207,20702,2070208
207020803,"Jandari",438,509,947,2,207,20702,2070208
207020804,"Kinyoni",203,242,445,2,207,20702,2070208
207020805,"Mucyamo",359,429,788,2,207,20702,2070208
207030101,"Buhoro",247,225,472,2,207,20703,2070301
207030102,"Kirehe",218,237,455,2,207,20703,2070301
207030103,"Murandi",193,195,388,2,207,20703,2070301
207030104,"Musezero",256,295,551,2,207,20703,2070301
207030105,"Remera",262,303,565,2,207,20703,2070301
207030106,"Rwesero",215,244,459,2,207,20703,2070301
207030201,"Cyuzu",616,597,1213,2,207,20703,2070302
207030202,"Kaziba",606,720,1326,2,207,20703,2070302
207030203,"Muhororo",202,225,427,2,207,20703,2070302
207030204,"Musambagiro",461,513,974,2,207,20703,2070302
207030205,"Musarara",570,710,1280,2,207,20703,2070302
207030206,"Nkondo",1108,954,2062,2,207,20703,2070302
207030301,"Bukiro",285,324,609,2,207,20703,2070303
207030302,"Kimisange",398,416,814,2,207,20703,2070303
207030303,"Murambi",230,276,506,2,207,20703,2070303
207030304,"Nzarwa",192,232,424,2,207,20703,2070303
207030305,"Rubona",382,455,837,2,207,20703,2070303
207030306,"Ruminantege",288,276,564,2,207,20703,2070303
207030401,"Jarama",400,486,886,2,207,20703,2070304
207030402,"Matoshya",240,268,508,2,207,20703,2070304
207030403,"Mubuga",288,323,611,2,207,20703,2070304
207030404,"Nyarubuye",321,364,685,2,207,20703,2070304
207030405,"Nyaruvumu",258,307,565,2,207,20703,2070304
207030501,"Butare",229,279,508,2,207,20703,2070305
207030502,"Gakurwe",313,338,651,2,207,20703,2070305
207030503,"Mucyamo",154,172,326,2,207,20703,2070305
207030504,"Mugali",209,226,435,2,207,20703,2070305
207030505,"Murehe",246,277,523,2,207,20703,2070305
207030601,"Kinogi",177,227,404,2,207,20703,2070306
207030602,"Musekera",203,231,434,2,207,20703,2070306
207030603,"Mushubaguriko",233,292,525,2,207,20703,2070306
207030604,"Mwumba",205,226,431,2,207,20703,2070306
207030605,"Nyamugali",171,212,383,2,207,20703,2070306
207040101,"Karambi",300,362,662,2,207,20704,2070401
207040102,"Muduha",234,268,502,2,207,20704,2070401
207040103,"Musenyi",261,273,534,2,207,20704,2070401
207040104,"Ruramba",318,334,652,2,207,20704,2070401
207040201,"Mataba",412,452,864,2,207,20704,2070402
207040202,"Rwezamenyo",501,495,996,2,207,20704,2070402
207040203,"Sovu",382,411,793,2,207,20704,2070402
207040301,"Cyakabiri",868,835,1703,2,207,20704,2070403
207040302,"Kagahina",674,820,1494,2,207,20704,2070403
207040303,"Kagitaba",391,447,838,2,207,20704,2070403
207040304,"Nyanza",702,646,1348,2,207,20704,2070403
207040305,"Sabusaro",452,532,984,2,207,20704,2070403
207040401,"Busumba",493,489,982,2,207,20704,2070404
207040402,"Gatwa",508,527,1035,2,207,20704,2070404
207040403,"Kabimbura",443,520,963,2,207,20704,2070404
207040404,"Mubuga",437,488,925,2,207,20704,2070404
207040405,"Nundwe",405,405,810,2,207,20704,2070404
207040501,"Busindi",457,515,972,2,207,20704,2070405
207040502,"Kabuga",395,464,859,2,207,20704,2070405
207040503,"Matovu",353,406,759,2,207,20704,2070405
207040504,"Munini",341,441,782,2,207,20704,2070405
207040505,"Musagara",521,591,1112,2,207,20704,2070405
207040506,"Nyamirambo",341,397,738,2,207,20704,2070405
207050101,"Gakomeye",520,618,1138,2,207,20705,2070501
207050102,"Kanyungura",413,441,854,2,207,20705,2070501
207050103,"Mataba",386,505,891,2,207,20705,2070501
207050104,"Nyabugwiza",573,607,1180,2,207,20705,2070501
207050105,"Nyamitanga",446,511,957,2,207,20705,2070501
207050201,"Gasenyi",194,231,425,2,207,20705,2070502
207050202,"Gitongati",479,550,1029,2,207,20705,2070502
207050203,"Kabingo",344,363,707,2,207,20705,2070502
207050204,"Kagombero",235,294,529,2,207,20705,2070502
207050205,"Kamazu",320,313,633,2,207,20705,2070502
207050206,"Karama",403,403,806,2,207,20705,2070502
207050207,"Kumukenke",359,375,734,2,207,20705,2070502
207050208,"Masumo",248,289,537,2,207,20705,2070502
207050301,"Cyurutare",363,409,772,2,207,20705,2070503
207050302,"Gahabwa",428,452,880,2,207,20705,2070503
207050303,"Kantonganiye",345,406,751,2,207,20705,2070503
207050304,"Namankurwe",301,318,619,2,207,20705,2070503
207050305,"Nyiramarangara",304,360,664,2,207,20705,2070503
207050306,"Rwabagenzi",432,511,943,2,207,20705,2070503
207050401,"Gisiza",227,264,491,2,207,20705,2070504
207050402,"Kiyoro",655,738,1393,2,207,20705,2070504
207050403,"Muhanga",384,462,846,2,207,20705,2070504
207050404,"Munzereri",494,568,1062,2,207,20705,2070504
207050405,"Murama",442,581,1023,2,207,20705,2070504
207050406,"Naganiro",423,450,873,2,207,20705,2070504
207050501,"Gasaka",403,432,835,2,207,20705,2070505
207050502,"Gitima",524,596,1120,2,207,20705,2070505
207050503,"Kivomo",587,635,1222,2,207,20705,2070505
207050504,"Nyahinda",480,552,1032,2,207,20705,2070505
207050505,"Ruhuha",329,429,758,2,207,20705,2070505
207060101,"Cyarubambire",279,341,620,2,207,20706,2070601
207060102,"Gataba",260,304,564,2,207,20706,2070601
207060103,"Gitwa",438,488,926,2,207,20706,2070601
207060104,"Kabeza",292,336,628,2,207,20706,2070601
207060105,"Nyagasozi",352,453,805,2,207,20706,2070601
207060201,"Kabadaha",329,369,698,2,207,20706,2070602
207060202,"Kabare",360,386,746,2,207,20706,2070602
207060203,"Kiyoro",1298,1542,2840,2,207,20706,2070602
207060204,"Rwinkindi",281,258,539,2,207,20706,2070602
207060301,"Bandora",333,395,728,2,207,20706,2070603
207060302,"Gasharu",255,262,517,2,207,20706,2070603
207060303,"Gihara",311,330,641,2,207,20706,2070603
207060304,"Gisovu",318,341,659,2,207,20706,2070603
207060305,"Kanombe",282,338,620,2,207,20706,2070603
207060306,"Kibonwa",319,370,689,2,207,20706,2070603
207060401,"Bitsibo",240,306,546,2,207,20706,2070604
207060402,"Hanika",302,410,712,2,207,20706,2070604
207060403,"Kamurekezi",457,541,998,2,207,20706,2070604
207060404,"Kivumu",310,375,685,2,207,20706,2070604
207060405,"Rugerero",264,292,556,2,207,20706,2070604
207060501,"Bahimba",332,411,743,2,207,20706,2070605
207060502,"Kanyinya",299,403,702,2,207,20706,2070605
207060503,"Karucura",346,425,771,2,207,20706,2070605
207060504,"Rubona",262,359,621,2,207,20706,2070605
207060601,"Nyamasheke",320,346,666,2,207,20706,2070606
207060602,"Nyanza",456,535,991,2,207,20706,2070606
207060603,"Rwuki",305,335,640,2,207,20706,2070606
207060604,"Ryaruyange",409,488,897,2,207,20706,2070606
207070101,"Munyinya",522,629,1151,2,207,20707,2070701
207070102,"Muzamuzi",252,292,544,2,207,20707,2070701
207070103,"Ndaragati",481,545,1026,2,207,20707,2070701
207070104,"Ryakiyange",454,551,1005,2,207,20707,2070701
207070201,"Cyanika",387,414,801,2,207,20707,2070702
207070202,"Murambi",331,394,725,2,207,20707,2070702
207070203,"Ngaru",390,431,821,2,207,20707,2070702
207070301,"Gitaba",496,595,1091,2,207,20707,2070703
207070302,"Karengeri",337,382,719,2,207,20707,2070703
207070303,"Munini",425,536,961,2,207,20707,2070703
207070304,"Murama",431,395,826,2,207,20707,2070703
207070305,"Nyarusange",282,333,615,2,207,20707,2070703
207070401,"Nyamugari",465,482,947,2,207,20707,2070704
207070402,"Nyamure",488,611,1099,2,207,20707,2070704
207070403,"Nyanza",244,291,535,2,207,20707,2070704
207070501,"Gitwa",428,524,952,2,207,20707,2070705
207070502,"Kamahoro",417,523,940,2,207,20707,2070705
207070503,"Kanombe",381,435,816,2,207,20707,2070705
207070504,"Kanyamizo",476,521,997,2,207,20707,2070705
207070505,"Mugeni",360,374,734,2,207,20707,2070705
207070506,"Rusenge",231,271,502,2,207,20707,2070705
207080101,"Gihuma",644,643,1287,2,207,20708,2070801
207080102,"Kamazuru",1588,1279,2867,2,207,20708,2070801
207080103,"Kamugina",832,916,1748,2,207,20708,2070801
207080104,"Kavumu",750,807,1557,2,207,20708,2070801
207080105,"Nyarucyamu I",1059,1025,2084,2,207,20708,2070801
207080106,"Nyarucyamu Ii",748,758,1506,2,207,20708,2070801
207080107,"Nyarucyamu Iii",1037,894,1931,2,207,20708,2070801
207080108,"Rutenga",1203,1198,2401,2,207,20708,2070801
207080109,"Ruvumera",879,948,1827,2,207,20708,2070801
207080201,"Gifumba",540,639,1179,2,207,20708,2070802
207080202,"Gisiza",237,279,516,2,207,20708,2070802
207080203,"Kirebe",405,452,857,2,207,20708,2070802
207080204,"Rugarama",612,707,1319,2,207,20708,2070802
207080205,"Rutarabana",260,294,554,2,207,20708,2070802
207080206,"Samuduha",536,526,1062,2,207,20708,2070802
207080301,"Gatika",254,249,503,2,207,20708,2070803
207080302,"Gitarama",614,714,1328,2,207,20708,2070803
207080303,"Kavumu",567,611,1178,2,207,20708,2070803
207080304,"Nyabisindu",481,500,981,2,207,20708,2070803
207080305,"Nyarusiza",264,220,484,2,207,20708,2070803
207080306,"Nyarutovu",344,355,699,2,207,20708,2070803
207080401,"Biti",641,769,1410,2,207,20708,2070804
207080402,"Gasenyi",320,347,667,2,207,20708,2070804
207080403,"Gasharu",589,642,1231,2,207,20708,2070804
207080404,"Kinyenkanda",358,426,784,2,207,20708,2070804
207080405,"Kirenge",256,287,543,2,207,20708,2070804
207080406,"Munini",296,344,640,2,207,20708,2070804
207080407,"Nete",358,799,1157,2,207,20708,2070804
207080408,"Nyakabingo",310,296,606,2,207,20708,2070804
207090101,"Gasave",389,435,824,2,207,20709,2070901
207090102,"Gasharu",682,740,1422,2,207,20709,2070901
207090103,"Gisasa",432,487,919,2,207,20709,2070901
207090104,"Karehe",202,231,433,2,207,20709,2070901
207090105,"Kintobo",335,361,696,2,207,20709,2070901
207090106,"Ntenderi",457,517,974,2,207,20709,2070901
207090107,"Nyarushora",616,743,1359,2,207,20709,2070901
207090201,"Cyiciro",539,587,1126,2,207,20709,2070902
207090202,"Jabiro",356,418,774,2,207,20709,2070902
207090203,"Kagarama",637,733,1370,2,207,20709,2070902
207090204,"Kamanga",775,827,1602,2,207,20709,2070902
207090205,"Murambi",757,876,1633,2,207,20709,2070902
207090206,"Ngororano",530,590,1120,2,207,20709,2070902
207090301,"Gitega",814,909,1723,2,207,20709,2070903
207090302,"Kibirizi",613,719,1332,2,207,20709,2070903
207090303,"Remera",500,557,1057,2,207,20709,2070903
207090304,"Rukamiro",402,469,871,2,207,20709,2070903
207090401,"Mututu",609,655,1264,2,207,20709,2070904
207090402,"Rukurazo",643,711,1354,2,207,20709,2070904
207090403,"Rwambariro",1065,1233,2298,2,207,20709,2070904
207090404,"Vugo",545,588,1133,2,207,20709,2070904
207100101,"Fumbwe",390,450,840,2,207,20710,2071001
207100102,"Gasharu",409,473,882,2,207,20710,2071001
207100103,"Kidahwe",512,550,1062,2,207,20710,2071001
207100104,"Murehe",373,403,776,2,207,20710,2071001
207100105,"Musenyi",260,305,565,2,207,20710,2071001
207100106,"Nyabugombe",328,283,611,2,207,20710,2071001
207100201,"Birehe",394,414,808,2,207,20710,2071002
207100202,"Gituza",351,430,781,2,207,20710,2071002
207100203,"Kabirizi",362,346,708,2,207,20710,2071002
207100204,"Kabuga",491,531,1022,2,207,20710,2071002
207100205,"Karama",323,368,691,2,207,20710,2071002
207100206,"Nyamiyaga",337,364,701,2,207,20710,2071002
207100301,"Gifurwe",376,412,788,2,207,20710,2071003
207100302,"Gitwa",458,489,947,2,207,20710,2071003
207100303,"Nyabikenke",354,408,762,2,207,20710,2071003
207100304,"Nyagasozi",455,490,945,2,207,20710,2071003
207100305,"Rushenyi",356,401,757,2,207,20710,2071003
207100401,"Gisoro",305,323,628,2,207,20710,2071004
207100402,"Kabakungu",322,338,660,2,207,20710,2071004
207100403,"Karambi",415,454,869,2,207,20710,2071004
207100404,"Masizi",190,222,412,2,207,20710,2071004
207100405,"Mugwato",350,407,757,2,207,20710,2071004
207100406,"Ntarabana",397,472,869,2,207,20710,2071004
207100407,"Rugogwe",322,427,749,2,207,20710,2071004
207100408,"Rwamure",421,452,873,2,207,20710,2071004
207100501,"Burerabana",877,930,1807,2,207,20710,2071005
207100502,"Kondo",607,729,1336,2,207,20710,2071005
207100503,"Muyebe",1270,1330,2600,2,207,20710,2071005
207100504,"Rukoma",779,915,1694,2,207,20710,2071005
207110101,"Gakoma",386,467,853,2,207,20711,2071101
207110102,"Gasharu",364,414,778,2,207,20711,2071101
207110103,"Giturwa",358,370,728,2,207,20711,2071101
207110104,"Nyagasozi",349,409,758,2,207,20711,2071101
207110105,"Nyakibuye",293,360,653,2,207,20711,2071101
207110106,"Nyamatete",278,320,598,2,207,20711,2071101
207110201,"Gasovu",517,622,1139,2,207,20711,2071102
207110202,"Kabuba",416,480,896,2,207,20711,2071102
207110203,"Muheta",590,644,1234,2,207,20711,2071102
207110204,"Ntonde",451,531,982,2,207,20711,2071102
207110301,"Kiduha",382,404,786,2,207,20711,2071103
207110302,"Mataba",421,519,940,2,207,20711,2071103
207110303,"Njamena",534,637,1171,2,207,20711,2071103
207110401,"Buganda",426,446,872,2,207,20711,2071104
207110402,"Gisiza",420,491,911,2,207,20711,2071104
207110501,"Mpongo",288,361,649,2,207,20711,2071105
207110502,"Ngando",341,413,754,2,207,20711,2071105
207110503,"Nyundo",506,572,1078,2,207,20711,2071105
207110504,"Rugwiza",360,388,748,2,207,20711,2071105
207110505,"Twabumbogo",466,578,1044,2,207,20711,2071105
207120101,"Gatare",526,564,1090,2,207,20712,2071201
207120102,"Kabungo",318,427,745,2,207,20712,2071201
207120103,"Kinyami",438,449,887,2,207,20712,2071201
207120104,"Musezero",769,716,1485,2,207,20712,2071201
207120105,"Nyakabingo",222,261,483,2,207,20712,2071201
207120106,"Nyakaguhu",259,291,550,2,207,20712,2071201
207120201,"Buriza",405,431,836,2,207,20712,2071202
207120202,"Muremberi",386,467,853,2,207,20712,2071202
207120203,"Nyabisindu",272,320,592,2,207,20712,2071202
207120204,"Rubugurizo",410,458,868,2,207,20712,2071202
207120205,"Rubuye",319,387,706,2,207,20712,2071202
207120206,"Songa",285,493,778,2,207,20712,2071202
207120207,"Vunga",337,433,770,2,207,20712,2071202
207120301,"Gakomeye",328,374,702,2,207,20712,2071203
207120302,"Gasharu",510,591,1101,2,207,20712,2071203
207120303,"Kigarama",527,553,1080,2,207,20712,2071203
207120304,"Mapfundo",1263,1140,2403,2,207,20712,2071203
207120305,"Matsinsi",439,472,911,2,207,20712,2071203
207120306,"Nyamaganda",447,499,946,2,207,20712,2071203
207120307,"Nyarucyamu",719,671,1390,2,207,20712,2071203
207120308,"Rwamaraba",494,536,1030,2,207,20712,2071203
207120401,"Gakombe",413,478,891,2,207,20712,2071204
207120402,"Kabeza",653,691,1344,2,207,20712,2071204
207120403,"Karama",408,410,818,2,207,20712,2071204
207120404,"Kavumu",383,426,809,2,207,20712,2071204
207120405,"Munyinya",459,543,1002,2,207,20712,2071204
207120406,"Murambi",650,720,1370,2,207,20712,2071204
207120407,"Nyagacyamu",367,368,735,2,207,20712,2071204
207120408,"Ruhina",6288,1191,7479,2,207,20712,2071204
208010101,"Kagarama",560,636,1196,2,208,20801,2080101
208010102,"Kambyeyi",302,371,673,2,208,20801,2080101
208010103,"Karama",556,619,1175,2,208,20801,2080101
208010104,"Nyagasozi",601,678,1279,2,208,20801,2080101
208010105,"Nyarunyinya",232,278,510,2,208,20801,2080101
208010106,"Ryabitana",710,766,1476,2,208,20801,2080101
208010201,"Bugaba",516,547,1063,2,208,20801,2080102
208010202,"Kibanza",393,395,788,2,208,20801,2080102
208010203,"Kidaturwa",374,395,769,2,208,20801,2080102
208010204,"Migina",608,693,1301,2,208,20801,2080102
208010205,"Nyabitare",407,473,880,2,208,20801,2080102
208010301,"Buhoro",519,668,1187,2,208,20801,2080103
208010302,"Kabatsi",485,574,1059,2,208,20801,2080103
208010303,"Kagarama",337,412,749,2,208,20801,2080103
208010304,"Mushimba",591,675,1266,2,208,20801,2080103
208010305,"Nyakabungo",332,404,736,2,208,20801,2080103
208010306,"Rugobagoba",509,559,1068,2,208,20801,2080103
208010401,"Juru",226,228,454,2,208,20801,2080104
208010402,"Kamonyi",599,1007,1606,2,208,20801,2080104
208010403,"Mataba",326,391,717,2,208,20801,2080104
208010404,"Nyamiryango",331,368,699,2,208,20801,2080104
208010405,"Nyamugari",550,670,1220,2,208,20801,2080104
208010406,"Rubona",527,621,1148,2,208,20801,2080104
208020101,"Gisanze",265,306,571,2,208,20802,2080201
208020102,"Kabuga",432,485,917,2,208,20802,2080201
208020103,"Kajevuba",488,539,1027,2,208,20802,2080201
208020104,"Kinkeri",469,521,990,2,208,20802,2080201
208020105,"Kokobe",456,536,992,2,208,20802,2080201
208020201,"Bunyonga",452,518,970,2,208,20802,2080202
208020202,"Nyarurembo",435,499,934,2,208,20802,2080202
208020203,"Nyenyeri",450,541,991,2,208,20802,2080202
208020204,"Ryagashaza",486,589,1075,2,208,20802,2080202
208020301,"Bitagata",319,364,683,2,208,20802,2080203
208020302,"Gatare",319,642,961,2,208,20802,2080203
208020303,"Ngoma",270,307,577,2,208,20802,2080203
208020304,"Nyamitanga",308,345,653,2,208,20802,2080203
208020305,"Nyaruteja",386,504,890,2,208,20802,2080203
208020401,"Gaji",415,441,856,2,208,20802,2080204
208020402,"Gasharu",410,454,864,2,208,20802,2080204
208020403,"Kavumu",457,528,985,2,208,20802,2080204
208020404,"Kigabiro",281,331,612,2,208,20802,2080204
208020405,"Nyakizu",380,494,874,2,208,20802,2080204
208030101,"Buhurura",540,560,1100,2,208,20803,2080301
208030102,"Munyegera",458,507,965,2,208,20803,2080301
208030103,"Nyarurama",619,800,1419,2,208,20803,2080301
208030104,"Remera",590,667,1257,2,208,20803,2080301
208030201,"Gitwa",333,364,697,2,208,20803,2080302
208030202,"Kamabuye",295,338,633,2,208,20803,2080302
208030203,"Ntwari",321,338,659,2,208,20803,2080302
208030204,"Nyakigezi",364,416,780,2,208,20803,2080302
208030205,"Rwishywa",272,296,568,2,208,20803,2080302
208030301,"Kigwene",445,559,1004,2,208,20803,2080303
208030302,"Muza",528,578,1106,2,208,20803,2080303
208030303,"Nyabubare",445,422,867,2,208,20803,2080303
208030401,"Gasamba",259,309,568,2,208,20803,2080304
208030402,"Gisizi",311,335,646,2,208,20803,2080304
208030403,"Gitwa",338,376,714,2,208,20803,2080304
208030404,"Kigunga",325,374,699,2,208,20803,2080304
208030405,"Ruheka",355,337,692,2,208,20803,2080304
208030501,"Gasasa",377,387,764,2,208,20803,2080305
208030502,"Gikurubuye",291,345,636,2,208,20803,2080305
208030503,"Kabana",343,403,746,2,208,20803,2080305
208030504,"Nyarubaya",357,422,779,2,208,20803,2080305
208030505,"Rugoma",366,365,731,2,208,20803,2080305
208030601,"Bushara",492,539,1031,2,208,20803,2080306
208030602,"Kibuye",439,470,909,2,208,20803,2080306
208030603,"Rugaragara",540,612,1152,2,208,20803,2080306
208040101,"Buramba",450,508,958,2,208,20804,2080401
208040102,"Manyana",378,408,786,2,208,20804,2080401
208040103,"Nyabuhoro",539,653,1192,2,208,20804,2080401
208040104,"Nyarugenge",694,621,1315,2,208,20804,2080401
208040201,"Gasiza",368,464,832,2,208,20804,2080402
208040202,"Kigarama",297,342,639,2,208,20804,2080402
208040203,"Nyarunyinya",567,689,1256,2,208,20804,2080402
208040301,"Gasharu",422,438,860,2,208,20804,2080403
208040302,"Mirehe",663,717,1380,2,208,20804,2080403
208040303,"Nyarusange",452,475,927,2,208,20804,2080403
208040304,"Ryamanywa",479,539,1018,2,208,20804,2080403
208040401,"Kaje",516,574,1090,2,208,20804,2080404
208040402,"Kangenzi",355,396,751,2,208,20804,2080404
208040403,"Murambi",351,393,744,2,208,20804,2080404
208040404,"Nyarurembo",466,479,945,2,208,20804,2080404
208050101,"Kigarama",538,572,1110,2,208,20805,2080501
208050102,"Kiyonza",573,655,1228,2,208,20805,2080501
208050103,"Mataba Nord",575,634,1209,2,208,20805,2080501
208050104,"Munini",527,644,1171,2,208,20805,2080501
208050105,"Nyamurenga",480,546,1026,2,208,20805,2080501
208050201,"Bihenga",744,778,1522,2,208,20805,2080502
208050202,"Cyeru",1118,1117,2235,2,208,20805,2080502
208050203,"Mataba Sud",773,844,1617,2,208,20805,2080502
208050204,"Runzenzi",1019,1161,2180,2,208,20805,2080502
208050301,"Kansoro",599,672,1271,2,208,20805,2080503
208050302,"Kigorora",784,791,1575,2,208,20805,2080503
208050303,"Mbati",779,911,1690,2,208,20805,2080503
208050304,"Mikamba",950,1099,2049,2,208,20805,2080503
208050305,"Murambi",504,583,1087,2,208,20805,2080503
208050401,"Kagasa",435,499,934,2,208,20805,2080504
208050402,"Kireka",441,516,957,2,208,20805,2080504
208050403,"Mparo",383,448,831,2,208,20805,2080504
208050404,"Mugina",763,940,1703,2,208,20805,2080504
208050501,"Gishari",553,638,1191,2,208,20805,2080505
208050502,"Kona",447,522,969,2,208,20805,2080505
208050503,"Ntasi",537,546,1083,2,208,20805,2080505
208050504,"Nyagisozi",1248,568,1816,2,208,20805,2080505
208050505,"Rusoro",363,405,768,2,208,20805,2080505
208060101,"Busasamana",447,522,969,2,208,20806,2080601
208060102,"Gihembe",723,817,1540,2,208,20806,2080601
208060103,"Gihogwe",496,590,1086,2,208,20806,2080601
208060104,"Reramacu",525,544,1069,2,208,20806,2080601
208060201,"Bimomwe",343,430,773,2,208,20806,2080602
208060202,"Gacaca",398,410,808,2,208,20806,2080602
208060203,"Giheta",470,509,979,2,208,20806,2080602
208060204,"Rugarama",516,640,1156,2,208,20806,2080602
208060205,"Ruvumura",597,664,1261,2,208,20806,2080602
208060206,"Shaka",366,421,787,2,208,20806,2080602
208060301,"Kamayanja",566,748,1314,2,208,20806,2080603
208060302,"Mbari",505,554,1059,2,208,20806,2080603
208060303,"Nyarusange",487,622,1109,2,208,20806,2080603
208060304,"Nyarutovu",406,510,916,2,208,20806,2080603
208060305,"Rubanga",622,641,1263,2,208,20806,2080603
208060401,"Gahondo",352,410,762,2,208,20806,2080604
208060402,"Gitega",369,486,855,2,208,20806,2080604
208060403,"Munazi",405,467,872,2,208,20806,2080604
208060404,"Nyagisozi",299,352,651,2,208,20806,2080604
208060405,"Nyerenga",452,503,955,2,208,20806,2080604
208060406,"Wimana",272,278,550,2,208,20806,2080604
208060501,"Gitwiko",644,723,1367,2,208,20806,2080605
208060502,"Kabere",347,469,816,2,208,20806,2080605
208060503,"Kamashashi",462,578,1040,2,208,20806,2080605
208060504,"Kingoma",460,472,932,2,208,20806,2080605
208060505,"Nyarubuye",568,663,1231,2,208,20806,2080605
208060506,"Nyarurama",398,447,845,2,208,20806,2080605
208060601,"Bitsibo",359,422,781,2,208,20806,2080606
208060602,"Ngoma",415,463,878,2,208,20806,2080606
208060603,"Nkomane",334,332,666,2,208,20806,2080606
208060604,"Nyamirembe",493,486,979,2,208,20806,2080606
208070101,"Cyimigenge",362,422,784,2,208,20807,2080701
208070102,"Fukwe",448,526,974,2,208,20807,2080701
208070103,"Musenyi",501,584,1085,2,208,20807,2080701
208070104,"Nyagasozi",360,371,731,2,208,20807,2080701
208070105,"Nyamugari",411,483,894,2,208,20807,2080701
208070106,"Raro",401,421,822,2,208,20807,2080701
208070201,"Bigobe",363,438,801,2,208,20807,2080702
208070202,"Gatare",451,453,904,2,208,20807,2080702
208070203,"Gatwa",343,419,762,2,208,20807,2080702
208070204,"Kabande",397,419,816,2,208,20807,2080702
208070205,"Kajevuba",256,287,543,2,208,20807,2080702
208070206,"Munoga",360,387,747,2,208,20807,2080702
208070301,"Gahinga",363,393,756,2,208,20807,2080703
208070302,"Kabagogo",343,396,739,2,208,20807,2080703
208070303,"Kigina",368,419,787,2,208,20807,2080703
208070304,"Nyabitare",405,416,821,2,208,20807,2080703
208070305,"Rugarama",400,381,781,2,208,20807,2080703
208080101,"Byenene",329,366,695,2,208,20808,2080801
208080102,"Karubanda",344,432,776,2,208,20808,2080801
208080103,"Murambi",397,426,823,2,208,20808,2080801
208080104,"Nkimbiri",332,378,710,2,208,20808,2080801
208080105,"Nyamabere",291,332,623,2,208,20808,2080801
208080106,"Nyamurasa",217,252,469,2,208,20808,2080801
208080107,"Nyamweru",340,443,783,2,208,20808,2080801
208080108,"Rwabinagu",367,396,763,2,208,20808,2080801
208080201,"Bumbogo",380,428,808,2,208,20808,2080802
208080202,"Buye",397,453,850,2,208,20808,2080802
208080203,"Gacumu",278,320,598,2,208,20808,2080802
208080204,"Kigabiro",399,434,833,2,208,20808,2080802
208080205,"Mukuyo",232,206,438,2,208,20808,2080802
208080206,"Murehe",273,363,636,2,208,20808,2080802
208080207,"Nkoto",315,344,659,2,208,20808,2080802
208080208,"Ruvugizo",264,310,574,2,208,20808,2080802
208080209,"Ruyumba",392,338,730,2,208,20808,2080802
208080210,"Umugarama",177,238,415,2,208,20808,2080802
208080301,"Kiranzi",185,203,388,2,208,20808,2080803
208080302,"Kirehe",186,198,384,2,208,20808,2080803
208080303,"Magu",234,257,491,2,208,20808,2080803
208080304,"Nyamiyaga",243,309,552,2,208,20808,2080803
208080305,"Nyarubuye",191,236,427,2,208,20808,2080803
208080306,"Rugarama",296,358,654,2,208,20808,2080803
208080307,"Rugwiro",268,298,566,2,208,20808,2080803
208080308,"Rwezamenyo",276,331,607,2,208,20808,2080803
208080309,"Sabununga",329,361,690,2,208,20808,2080803
208080401,"Birembo",312,335,647,2,208,20808,2080804
208080402,"Kabeza",223,260,483,2,208,20808,2080804
208080403,"Kayenzi",322,386,708,2,208,20808,2080804
208080404,"Mbayaya",306,327,633,2,208,20808,2080804
208080405,"Nyabubare",363,394,757,2,208,20808,2080804
208080406,"Nyamahuru",399,388,787,2,208,20808,2080804
208080407,"Nyarugenge",296,342,638,2,208,20808,2080804
208080408,"Nyaruhengeri",348,408,756,2,208,20808,2080804
208080409,"Wimana",176,211,387,2,208,20808,2080804
208080501,"Buhoro",295,364,659,2,208,20808,2080805
208080502,"Gitega",282,290,572,2,208,20808,2080805
208080503,"Kabahazi",332,343,675,2,208,20808,2080805
208080504,"Kamabuye",294,342,636,2,208,20808,2080805
208080505,"Kinanira",340,407,747,2,208,20808,2080805
208080506,"Kivugiza",297,334,631,2,208,20808,2080805
208080507,"Munyinya",410,450,860,2,208,20808,2080805
208080508,"Rwankeke",422,466,888,2,208,20808,2080805
208090101,"Karora",366,433,799,2,208,20809,2080901
208090102,"Kibingo",380,441,821,2,208,20809,2080901
208090103,"Mugereke",451,487,938,2,208,20809,2080901
208090104,"Nyabitare",391,439,830,2,208,20809,2080901
208090105,"Remera",302,320,622,2,208,20809,2080901
208090106,"Rwigerero",394,448,842,2,208,20809,2080901
208090201,"Kabungo",555,586,1141,2,208,20809,2080902
208090202,"Kigwene",395,490,885,2,208,20809,2080902
208090203,"Kirwa",282,331,613,2,208,20809,2080902
208090204,"Nyagihamba",558,588,1146,2,208,20809,2080902
208090205,"Ruhuha",382,410,792,2,208,20809,2080902
208090206,"Ruseke",285,308,593,2,208,20809,2080902
208090301,"Birembo",356,389,745,2,208,20809,2080903
208090302,"Gaserege",352,406,758,2,208,20809,2080903
208090303,"Kigarama",389,464,853,2,208,20809,2080903
208090304,"Kintama",531,564,1095,2,208,20809,2080903
208090305,"Rugarama",511,630,1141,2,208,20809,2080903
208090306,"Rwinanka",222,240,462,2,208,20809,2080903
208090401,"Kabere",459,485,944,2,208,20809,2080904
208090402,"Ngendo",352,414,766,2,208,20809,2080904
208090403,"Nombe",440,527,967,2,208,20809,2080904
208090404,"Nyagasozi",460,521,981,2,208,20809,2080904
208090405,"Tare",201,214,415,2,208,20809,2080904
208090501,"Buhunga",248,280,528,2,208,20809,2080905
208090502,"Gatagara",330,399,729,2,208,20809,2080905
208090503,"Gitega",415,436,851,2,208,20809,2080905
208090504,"Kanombe",274,318,592,2,208,20809,2080905
208090505,"Kavumu",266,314,580,2,208,20809,2080905
208090506,"Ngarama",256,326,582,2,208,20809,2080905
208100101,"Gitwa",460,555,1015,2,208,20810,2081001
208100102,"Kadasaya",265,339,604,2,208,20810,2081001
208100103,"Karama",521,619,1140,2,208,20810,2081001
208100104,"Rubona",219,228,447,2,208,20810,2081001
208100105,"Rutovu",167,223,390,2,208,20810,2081001
208100106,"Rwabayanga",401,440,841,2,208,20810,2081001
208100201,"Bikamba",435,497,932,2,208,20810,2081002
208100202,"Kigese",417,468,885,2,208,20810,2081002
208100203,"Kirega",318,339,657,2,208,20810,2081002
208100204,"Mibirizi",774,831,1605,2,208,20810,2081002
208100205,"Rugarama",598,650,1248,2,208,20810,2081002
208100301,"Masaka",256,380,636,2,208,20810,2081003
208100302,"Mpungwe",430,482,912,2,208,20810,2081003
208100303,"Ruramba",361,449,810,2,208,20810,2081003
208100304,"Rwimondo",310,353,663,2,208,20810,2081003
208100305,"Taba",374,469,843,2,208,20810,2081003
208100401,"Kabarama",636,741,1377,2,208,20810,2081004
208100402,"Musave",399,455,854,2,208,20810,2081004
208100403,"Nzagwa",731,849,1580,2,208,20810,2081004
208100404,"Remera",490,610,1100,2,208,20810,2081004
208100405,"Ruhogo",361,460,821,2,208,20810,2081004
208100406,"Samuduha",547,639,1186,2,208,20810,2081004
208100501,"Butera",473,557,1030,2,208,20810,2081005
208100502,"Gatovu",639,663,1302,2,208,20810,2081005
208100503,"Kagangayire",357,421,778,2,208,20810,2081005
208100504,"Karehe",674,814,1488,2,208,20810,2081005
208100505,"Kigarama",415,539,954,2,208,20810,2081005
208100506,"Ntebe",554,612,1166,2,208,20810,2081005
208110101,"Bugoba",349,388,737,2,208,20811,2081101
208110102,"Gatare",329,368,697,2,208,20811,2081101
208110103,"Kabuga",254,268,522,2,208,20811,2081101
208110104,"Nyarurama",366,394,760,2,208,20811,2081101
208110105,"Nyenge",511,542,1053,2,208,20811,2081101
208110201,"Buguri",267,323,590,2,208,20811,2081102
208110202,"Nyabuvomo",389,442,831,2,208,20811,2081102
208110203,"Nyagasozi",438,493,931,2,208,20811,2081102
208110204,"Nyakabande",436,548,984,2,208,20811,2081102
208110205,"Ruzege",312,355,667,2,208,20811,2081102
208110206,"Tunza",352,459,811,2,208,20811,2081102
208110301,"Gahungeri",563,578,1141,2,208,20811,2081103
208110302,"Gishyeshye",605,625,1230,2,208,20811,2081103
208110303,"Murambi",487,525,1012,2,208,20811,2081103
208110304,"Nyamabuye",534,663,1197,2,208,20811,2081103
208110305,"Rubare",309,353,662,2,208,20811,2081103
208110401,"Kabagabo",393,460,853,2,208,20811,2081104
208110402,"Kamuzi",493,540,1033,2,208,20811,2081104
208110403,"Mubuga",566,645,1211,2,208,20811,2081104
208110404,"Rushikiri",365,449,814,2,208,20811,2081104
208110405,"Uwingando",322,379,701,2,208,20811,2081104
208110501,"Gafonogo",331,389,720,2,208,20811,2081105
208110502,"Mwirute",278,325,603,2,208,20811,2081105
208110503,"Nyarusave",439,436,875,2,208,20811,2081105
208110504,"Rubuye",386,434,820,2,208,20811,2081105
208110505,"Rugarama",280,288,568,2,208,20811,2081105
208110601,"Gisenyi",393,470,863,2,208,20811,2081106
208110602,"Kabande",1078,1375,2453,2,208,20811,2081106
208110603,"Kanyinya",377,379,756,2,208,20811,2081106
208110604,"Kigarama",362,402,764,2,208,20811,2081106
208110605,"Mbizi",166,173,339,2,208,20811,2081106
208110606,"Remera",456,507,963,2,208,20811,2081106
208110701,"Bukokora",423,513,936,2,208,20811,2081107
208110702,"Karuri",399,444,843,2,208,20811,2081107
208110703,"Nyarusange",595,646,1241,2,208,20811,2081107
208110704,"Nyirabihanya",267,330,597,2,208,20811,2081107
208110705,"Taba",594,598,1192,2,208,20811,2081107
208120101,"Bikimba",281,311,592,2,208,20812,2081201
208120102,"Bimba",374,372,746,2,208,20812,2081201
208120103,"Kabasanza",655,652,1307,2,208,20812,2081201
208120104,"Nyagatare",405,506,911,2,208,20812,2081201
208120105,"Rukaragata",417,492,909,2,208,20812,2081201
208120106,"Ruyigi",342,390,732,2,208,20812,2081201
208120201,"Bwirabo",457,465,922,2,208,20812,2081202
208120202,"Kabagesera",544,643,1187,2,208,20812,2081202
208120203,"Muhambara",769,855,1624,2,208,20812,2081202
208120204,"Rubuye",781,872,1653,2,208,20812,2081202
208120205,"Rugogwe",482,557,1039,2,208,20812,2081202
208120301,"Gasharara",514,554,1068,2,208,20812,2081203
208120302,"Kagina",363,394,757,2,208,20812,2081203
208120303,"Kamuhoza",493,387,880,2,208,20812,2081203
208120304,"Kigusa",331,372,703,2,208,20812,2081203
208120305,"Rugarama",563,638,1201,2,208,20812,2081203
208120401,"Kigabiro",511,514,1025,2,208,20812,2081204
208120402,"Musebeya",348,373,721,2,208,20812,2081204
208120403,"Nyagacyamu",630,650,1280,2,208,20812,2081204
208120404,"Nyaruhoko",295,357,652,2,208,20812,2081204
208120405,"Rubona",428,502,930,2,208,20812,2081204
208120501,"Kibaya",633,639,1272,2,208,20812,2081205
208120502,"Nyabitare",251,279,530,2,208,20812,2081205
208120503,"Nyagacaca",761,847,1608,2,208,20812,2081205
208120504,"Rubumba",1096,825,1921,2,208,20812,2081205
208120505,"Rugazi",483,500,983,2,208,20812,2081205
301010101,"Kabuga ",192,232,424,3,301,30101,3010101
301010102,"Majuri  ",181,189,370,3,301,30101,3010101
301010103,"Matyazo ",206,234,440,3,301,30101,3010101
301010104,"Nyabikenke ",247,285,532,3,301,30101,3010101
301010105,"Nyamarebe ",291,329,620,3,301,30101,3010101
301010106,"Ruyenzi ",235,289,524,3,301,30101,3010101
301010107,"Twimbogo ",185,195,380,3,301,30101,3010101
301010201,"Gafuruguto ",231,284,515,3,301,30101,3010102
301010202,"Gatare ",217,252,469,3,301,30101,3010102
301010203,"Gatoki  ",254,266,520,3,301,30101,3010102
301010204,"Gisayo ",172,162,334,3,301,30101,3010102
301010205,"Nyabihanga ",186,224,410,3,301,30101,3010102
301010206,"Nyagahinga ",340,323,663,3,301,30101,3010102
301010207,"Nyarusange ",233,271,504,3,301,30101,3010102
301010208,"Ruganda ",240,244,484,3,301,30101,3010102
301010301,"Gitarama ",209,207,416,3,301,30101,3010103
301010302,"Gomba ",266,280,546,3,301,30101,3010103
301010303,"Josi ",228,240,468,3,301,30101,3010103
301010304,"Karambo ",156,186,342,3,301,30101,3010103
301010305,"Kigezi ",179,212,391,3,301,30101,3010103
301010306,"Kirambo ",268,291,559,3,301,30101,3010103
301010307,"Kivomo ",222,255,477,3,301,30101,3010103
301010308,"Nyamigina  ",185,168,353,3,301,30101,3010103
301010401,"Buhoro ",278,300,578,3,301,30101,3010104
301010402,"Gitega ",268,324,592,3,301,30101,3010104
301010403,"Mugomba ",269,296,565,3,301,30101,3010104
301010404,"Nyabikenke  ",276,305,581,3,301,30101,3010104
301010405,"Ruhande ",240,264,504,3,301,30101,3010104
301010406,"Sakinnyaga ",387,416,803,3,301,30101,3010104
301010501,"Gacumba ",234,271,505,3,301,30101,3010105
301010502,"Gatwaro  ",211,190,401,3,301,30101,3010105
301010503,"Rurembo ",1247,701,1948,3,301,30101,3010105
301010601,"Karutete ",221,268,489,3,301,30101,3010106
301010602,"Kiyovu ",350,358,708,3,301,30101,3010106
301010603,"Maryohe",586,374,960,3,301,30101,3010106
301010604,"Nyabaguma ",170,207,377,3,301,30101,3010106
301010605,"Nyakigezi ",602,413,1015,3,301,30101,3010106
301010606,"Nyarurembo ",265,234,499,3,301,30101,3010106
301010607,"Nyegabo ",236,215,451,3,301,30101,3010106
301010608,"Ruganda ",234,115,349,3,301,30101,3010106
301010701,"Birembo ",391,457,848,3,301,30101,3010107
301010702,"Bupfune ",274,284,558,3,301,30101,3010107
301010703,"Bwishyura ",236,289,525,3,301,30101,3010107
301010704,"Kanyabusage ",326,355,681,3,301,30101,3010107
301010705,"Karongi  ",297,356,653,3,301,30101,3010107
301010706,"Nyarusozi ",249,278,527,3,301,30101,3010107
301020101,"Birambo",819,821,1640,3,301,30102,3010201
301020102,"Gashari",289,354,643,3,301,30102,3010201
301020103,"Kabirizi",279,331,610,3,301,30102,3010201
301020104,"Kakibereka",185,208,393,3,301,30102,3010201
301020105,"Kananira",276,295,571,3,301,30102,3010201
301020106,"Ntarabana",223,256,479,3,301,30102,3010201
301020107,"Nyabikenke",212,246,458,3,301,30102,3010201
301020108,"Nyakibuguma ",162,179,341,3,301,30102,3010201
301020109,"Nyarusange",203,230,433,3,301,30102,3010201
301020110,"Rugarama",187,207,394,3,301,30102,3010201
301020201,"Kabasare ",256,315,571,3,301,30102,3010202
301020202,"Kaduha",341,386,727,3,301,30102,3010202
301020203,"Kagangare ",241,289,530,3,301,30102,3010202
301020204,"Kigarama ",264,288,552,3,301,30102,3010202
301020205,"Musasa",348,360,708,3,301,30102,3010202
301020206,"Rasaniro",360,398,758,3,301,30102,3010202
301020301,"Gakurwe ",326,426,752,3,301,30102,3010203
301020302,"Gataba",322,377,699,3,301,30102,3010203
301020303,"Gihororo",214,252,466,3,301,30102,3010203
301020304,"Kabageni ",245,276,521,3,301,30102,3010203
301020305,"Kayogoro ",247,237,484,3,301,30102,3010203
301020306,"Nyamigina",233,265,498,3,301,30102,3010203
301020401,"Karambo",297,374,671,3,301,30102,3010204
301020402,"Karutare ",334,353,687,3,301,30102,3010204
301020403,"Kibingo ",334,346,680,3,301,30102,3010204
301020404,"Musongati ",263,320,583,3,301,30102,3010204
301020405,"Nkingo ",303,317,620,3,301,30102,3010204
301020406,"Shungwe ",309,325,634,3,301,30102,3010204
301020501,"Kayonga ",284,349,633,3,301,30102,3010205
301020502,"Nyabivumu ",194,242,436,3,301,30102,3010205
301020503,"Nyagisozi ",368,415,783,3,301,30102,3010205
301020504,"Rubona ",351,278,629,3,301,30102,3010205
301030101,"Buhire ",240,274,514,3,301,30103,3010301
301030102,"Mboneko ",222,217,439,3,301,30103,3010301
301030103,"Mweya ",216,250,466,3,301,30103,3010301
301030104,"Ruhunde ",254,303,557,3,301,30103,3010301
301030105,"Tura",290,307,597,3,301,30103,3010301
301030201,"Gataba ",260,332,592,3,301,30103,3010302
301030202,"Gatare  ",298,301,599,3,301,30103,3010302
301030203,"Gisiza ",270,281,551,3,301,30103,3010302
301030204,"Gitovu ",460,328,788,3,301,30103,3010302
301030205,"Kabuga ",244,274,518,3,301,30103,3010302
301030206,"Kagano ",186,216,402,3,301,30103,3010302
301030207,"Mpatsi ",197,237,434,3,301,30103,3010302
301030301,"Gitwa",332,380,712,3,301,30103,3010303
301030302,"Kabwenge ",257,295,552,3,301,30103,3010303
301030303,"Karenge ",266,298,564,3,301,30103,3010303
301030304,"Kubutare  ",232,246,478,3,301,30103,3010303
301030401,"Butare ",218,246,464,3,301,30103,3010304
301030402,"Bweramvura ",201,235,436,3,301,30103,3010304
301030403,"Gisoro ",216,213,429,3,301,30103,3010304
301030404,"Ngugu ",218,229,447,3,301,30103,3010304
301030405,"Nyakabuye ",206,277,483,3,301,30103,3010304
301030501,"Cyimbo ",198,234,432,3,301,30103,3010305
301030502,"Gasharu ",233,272,505,3,301,30103,3010305
301030503,"Kabuga  ",207,254,461,3,301,30103,3010305
301030504,"Kamunungu ",203,235,438,3,301,30103,3010305
301030505,"Kibaya ",246,231,477,3,301,30103,3010305
301030506,"Kirunga ",189,242,431,3,301,30103,3010305
301030507,"Musebeya ",205,229,434,3,301,30103,3010305
301030508,"Rwagisasa ",232,266,498,3,301,30103,3010305
301030601,"Kanyinya ",196,193,389,3,301,30103,3010306
301030602,"Magarama  ",302,333,635,3,301,30103,3010306
301030603,"Mataba ",336,468,804,3,301,30103,3010306
301030604,"Murambi ",210,248,458,3,301,30103,3010306
301030605,"Rufumberi ",221,232,453,3,301,30103,3010306
301030606,"Uwingabo ",322,330,652,3,301,30103,3010306
301040101,"Gasharu ",297,320,617,3,301,30104,3010401
301040102,"Kinyami",253,303,556,3,301,30104,3010401
301040103,"Nyarukeri ",198,238,436,3,301,30104,3010401
301040104,"Nyaruvumu ",207,290,497,3,301,30104,3010401
301040105,"Rwintare ",252,252,504,3,301,30104,3010401
301040201,"Bugoberi ",267,286,553,3,301,30104,3010402
301040202,"Kagari ",255,302,557,3,301,30104,3010402
301040203,"Kamihaho",298,286,584,3,301,30104,3010402
301040204,"Muvungu ",278,328,606,3,301,30104,3010402
301040205,"Senga ",267,277,544,3,301,30104,3010402
301040301,"Giticyuma",208,265,473,3,301,30104,3010403
301040302,"Karongi ",224,244,468,3,301,30104,3010403
301040303,"Nemba ",132,159,291,3,301,30104,3010403
301040304,"Nyabitare",193,218,411,3,301,30104,3010403
301040305,"Nyagisozi ",238,281,519,3,301,30104,3010403
301040306,"Nyarugenge ",174,212,386,3,301,30104,3010403
301040401,"Buye ",254,296,550,3,301,30104,3010404
301040402,"Karongi ",229,229,458,3,301,30104,3010404
301040403,"Kirambo",244,321,565,3,301,30104,3010404
301040404,"Nyarusange ",283,390,673,3,301,30104,3010404
301040405,"Nzabuhara ",203,255,458,3,301,30104,3010404
301040501,"Gahigiro",308,323,631,3,301,30104,3010405
301040502,"Gatare ",200,222,422,3,301,30104,3010405
301040503,"Kinama ",279,275,554,3,301,30104,3010405
301040504,"Munanira ",286,296,582,3,301,30104,3010405
301040505,"Nyabigugu ",269,286,555,3,301,30104,3010405
301040506,"Nyarucyamo ",280,206,486,3,301,30104,3010405
301040507,"Ruhundo",208,261,469,3,301,30104,3010405
301040601,"Burega ",233,255,488,3,301,30104,3010406
301040602,"Cyimba ",253,281,534,3,301,30104,3010406
301040603,"Gisasa ",192,232,424,3,301,30104,3010406
301040604,"Kagari ",244,296,540,3,301,30104,3010406
301040605,"Kivuruga ",295,291,586,3,301,30104,3010406
301040701,"Gasayo ",184,246,430,3,301,30104,3010407
301040702,"Muramba ",274,354,628,3,301,30104,3010407
301040703,"Nyabikati",194,216,410,3,301,30104,3010407
301040704,"Nyagahinga ",290,320,610,3,301,30104,3010407
301040705,"Nyamiyaga",263,278,541,3,301,30104,3010407
301040706,"Nyarubuye ",282,311,593,3,301,30104,3010407
301040707,"Ruhondo ",215,204,419,3,301,30104,3010407
301040801,"Karwiru",153,187,340,3,301,30104,3010408
301040802,"Kigarama ",352,388,740,3,301,30104,3010408
301040803,"Kirwa ",178,188,366,3,301,30104,3010408
301040804,"Rurumbu ",204,251,455,3,301,30104,3010408
301040805,"Rusekera ",161,189,350,3,301,30104,3010408
301040806,"Rwariro",241,300,541,3,301,30104,3010408
301050101,"Bitaba",187,232,419,3,301,30105,3010501
301050102,"Buhari ",222,233,455,3,301,30105,3010501
301050103,"Kagabiro ",171,232,403,3,301,30105,3010501
301050104,"Kagarama ",228,258,486,3,301,30105,3010501
301050105,"Mweya ",160,221,381,3,301,30105,3010501
301050106,"Nyabinyenga ",195,245,440,3,301,30105,3010501
301050107,"Nyakabande",211,237,448,3,301,30105,3010501
301050108,"Nyakagezi ",200,240,440,3,301,30105,3010501
301050109,"Rubondo ",172,215,387,3,301,30105,3010501
301050110,"Runyinya ",169,202,371,3,301,30105,3010501
301050201,"Gisunzu ",244,263,507,3,301,30105,3010502
301050202,"Kabuga ",233,256,489,3,301,30105,3010502
301050203,"Kaduha ",193,227,420,3,301,30105,3010502
301050204,"Karora ",233,294,527,3,301,30105,3010502
301050205,"Murangara ",305,316,621,3,301,30105,3010502
301050206,"Nyabitare ",229,266,495,3,301,30105,3010502
301050207,"Rubyiro ",281,285,566,3,301,30105,3010502
301050208,"Rwakamuri  ",263,268,531,3,301,30105,3010502
301050301,"Bikomero ",187,208,395,3,301,30105,3010503
301050302,"Gisizi ",249,263,512,3,301,30105,3010503
301050303,"Karora ",227,236,463,3,301,30105,3010503
301050304,"Mara ",227,225,452,3,301,30105,3010503
301050305,"Nyagatovu ",219,225,444,3,301,30105,3010503
301050306,"Nyankira ",255,297,552,3,301,30105,3010503
301050307,"Ryarugenzi",215,280,495,3,301,30105,3010503
301050401,"Bikenke ",268,297,565,3,301,30105,3010504
301050402,"Gihira ",216,259,475,3,301,30105,3010504
301050403,"Jurwe ",239,282,521,3,301,30105,3010504
301050404,"Kizibaziba ",283,326,609,3,301,30105,3010504
301050405,"Mubuga ",245,302,547,3,301,30105,3010504
301050406,"Rwamiko ",232,286,518,3,301,30105,3010504
301050407,"Ryaruhanga ",381,419,800,3,301,30105,3010504
301060101,"Cyamatare ",285,335,620,3,301,30106,3010601
301060102,"Gasebeya ",227,278,505,3,301,30106,3010601
301060103,"Kazibaziba ",244,303,547,3,301,30106,3010601
301060104,"Migina ",212,243,455,3,301,30106,3010601
301060105,"Nyabivumu ",227,274,501,3,301,30106,3010601
301060106,"Nyabwoma",238,281,519,3,301,30106,3010601
301060107,"Nyaruvumu",199,255,454,3,301,30106,3010601
301060201,"Birambo",230,252,482,3,301,30106,3010602
301060202,"Bwakira ",405,358,763,3,301,30106,3010602
301060203,"Kananira ",244,263,507,3,301,30106,3010602
301060204,"Ndago",308,381,689,3,301,30106,3010602
301060205,"Nyabiranga ",291,349,640,3,301,30106,3010602
301060206,"Nyakabuye",210,243,453,3,301,30106,3010602
301060207,"Tariro ",283,319,602,3,301,30106,3010602
301060301,"Gakoma ",251,321,572,3,301,30106,3010603
301060302,"Gisovu  ",261,305,566,3,301,30106,3010603
301060303,"Kakirinda ",290,301,591,3,301,30106,3010603
301060304,"Kibamba ",293,374,667,3,301,30106,3010603
301060305,"Mataba",240,284,524,3,301,30106,3010603
301060306,"Muramba ",224,296,520,3,301,30106,3010603
301060401,"Gituntu ",238,339,577,3,301,30106,3010604
301060402,"Kamasambu",315,349,664,3,301,30106,3010604
301060403,"Karambo",246,306,552,3,301,30106,3010604
301060404,"Kigandaro ",255,331,586,3,301,30106,3010604
301060405,"Murambi",268,283,551,3,301,30106,3010604
301060406,"Nyarusave",403,498,901,3,301,30106,3010604
301060501,"Bugaramantare ",214,223,437,3,301,30106,3010605
301060502,"Gitwa ",197,232,429,3,301,30106,3010605
301060503,"Kaburega",240,260,500,3,301,30106,3010605
301060504,"Kavumu",362,389,751,3,301,30106,3010605
301060505,"Musibya",170,203,373,3,301,30106,3010605
301060506,"Nyabaguma ",191,242,433,3,301,30106,3010605
301060507,"Nyabisindu ",233,274,507,3,301,30106,3010605
301060508,"Nyamagana ",241,298,539,3,301,30106,3010605
301060509,"Nyamugari ",261,288,549,3,301,30106,3010605
301060510,"Nyaruhanga ",365,365,730,3,301,30106,3010605
301070101,"Bugeni",198,231,429,3,301,30107,3010701
301070102,"Bukiro",356,403,759,3,301,30107,3010701
301070103,"Gitwa",246,307,553,3,301,30107,3010701
301070104,"Munzanga",295,350,645,3,301,30107,3010701
301070105,"Nyamabuye",208,225,433,3,301,30107,3010701
301070106,"Nyamyumba",187,229,416,3,301,30107,3010701
301070201,"Burwi ",230,267,497,3,301,30107,3010702
301070202,"Gakomeye ",355,355,710,3,301,30107,3010702
301070203,"Karambo ",333,390,723,3,301,30107,3010702
301070204,"Mujyojyo ",329,345,674,3,301,30107,3010702
301070205,"Murambi ",297,309,606,3,301,30107,3010702
301070206,"Mwumba  ",267,264,531,3,301,30107,3010702
301070301,"Kiraro",319,387,706,3,301,30107,3010703
301070302,"Kirehe ",317,403,720,3,301,30107,3010703
301070303,"Murehe",185,227,412,3,301,30107,3010703
301070304,"Mwunguzi",404,492,896,3,301,30107,3010703
301070305,"Nyakarambi",261,326,587,3,301,30107,3010703
301070306,"Nzobe ",232,252,484,3,301,30107,3010703
301070401,"Bwenda ",194,227,421,3,301,30107,3010704
301070402,"Gasave ",330,396,726,3,301,30107,3010704
301070403,"Gasharu ",328,401,729,3,301,30107,3010704
301070404,"Gisebeya",290,305,595,3,301,30107,3010704
301070405,"Kibingo ",167,223,390,3,301,30107,3010704
301070406,"Kuruganda    ",278,246,524,3,301,30107,3010704
301070407,"Ruhungamiyaga ",319,381,700,3,301,30107,3010704
301070501,"Gasharu ",257,267,524,3,301,30107,3010705
301070502,"Gitwa  ",233,269,502,3,301,30107,3010705
301070503,"Kisenge ",367,452,819,3,301,30107,3010705
301070504,"Ngoma ",328,402,730,3,301,30107,3010705
301070505,"Nyarurembo ",265,347,612,3,301,30107,3010705
301070506,"Remera ",223,300,523,3,301,30107,3010705
301070507,"Rubona ",254,247,501,3,301,30107,3010705
301070601,"Gatwaro ",390,475,865,3,301,30107,3010706
301070602,"Gishyikiro ",380,418,798,3,301,30107,3010706
301070603,"Nyabinombe ",296,331,627,3,301,30107,3010706
301070604,"Nyamabuye ",392,476,868,3,301,30107,3010706
301070605,"Remera ",407,405,812,3,301,30107,3010706
301070606,"Ruhondo ",225,268,493,3,301,30107,3010706
301070607,"Rusovu  ",397,407,804,3,301,30107,3010706
301080101,"Gasenyi",525,411,936,3,301,30108,3010801
301080102,"Gititi",281,311,592,3,301,30108,3010801
301080103,"Kivumu",288,302,590,3,301,30108,3010801
301080104,"Muhondo",242,232,474,3,301,30108,3010801
301080105,"Murambi",287,311,598,3,301,30108,3010801
301080106,"Musango",221,263,484,3,301,30108,3010801
301080107,"Rugogo",246,273,519,3,301,30108,3010801
301080201,"Gashanga",222,262,484,3,301,30108,3010802
301080202,"Gasharu",253,281,534,3,301,30108,3010802
301080203,"Gituntu",210,254,464,3,301,30108,3010802
301080204,"Mukungu",358,403,761,3,301,30108,3010802
301080205,"Mutuntu",269,298,567,3,301,30108,3010802
301080206,"Nyabiguri",285,330,615,3,301,30108,3010802
301080301,"Gashubi",177,202,379,3,301,30108,3010803
301080302,"Gatwa",202,244,446,3,301,30108,3010803
301080303,"Kabariro",214,236,450,3,301,30108,3010803
301080304,"Mayombo",220,247,467,3,301,30108,3010803
301080305,"Ryarugango",205,221,426,3,301,30108,3010803
301080306,"Taba",184,190,374,3,301,30108,3010803
301080401,"Gitumba",281,293,574,3,301,30108,3010804
301080402,"Kanyege",240,312,552,3,301,30108,3010804
301080403,"Kavumu",216,243,459,3,301,30108,3010804
301080404,"Manji",270,342,612,3,301,30108,3010804
301080405,"Mukongoro",226,259,485,3,301,30108,3010804
301080406,"Nyarubuye",212,256,468,3,301,30108,3010804
301080407,"Rugogwe",150,190,340,3,301,30108,3010804
301080501,"Kadehero ",240,261,501,3,301,30108,3010805
301080502,"Kinyonzwe ",3067,631,3698,3,301,30108,3010805
301080503,"Matyazo ",326,328,654,3,301,30108,3010805
301080504,"Ruhindiro ",271,296,567,3,301,30108,3010805
301080505,"Uwabashi ",240,302,542,3,301,30108,3010805
301080506,"Uwibumba ",289,311,600,3,301,30108,3010805
301080601,"Cyamakamba",273,311,584,3,301,30108,3010806
301080602,"Karambo ",222,289,511,3,301,30108,3010806
301080603,"Ngundusi ",264,334,598,3,301,30108,3010806
301080604,"Nyarutovu ",283,294,577,3,301,30108,3010806
301080605,"Uwiraro ",246,279,525,3,301,30108,3010806
301080701,"Cyiha ",207,243,450,3,301,30108,3010807
301080702,"Gatiti ",174,248,422,3,301,30108,3010807
301080703,"Mwumba",245,254,499,3,301,30108,3010807
301080704,"Rasaniro ",244,288,532,3,301,30108,3010807
301080705,"Rugusa",220,264,484,3,301,30108,3010807
301080706,"Ruhuha ",218,247,465,3,301,30108,3010807
301090101,"Gakomeye ",199,185,384,3,301,30109,3010901
301090102,"Gitwa ",179,224,403,3,301,30109,3010901
301090103,"Kabuga ",248,258,506,3,301,30109,3010901
301090104,"Kavumu",202,257,459,3,301,30109,3010901
301090105,"Kigarama ",192,240,432,3,301,30109,3010901
301090106,"Makurungwe",195,217,412,3,301,30109,3010901
301090107,"Nyagahinga ",225,275,500,3,301,30109,3010901
301090201,"Gakomeye",188,245,433,3,301,30109,3010902
301090202,"Gasharu ",291,291,582,3,301,30109,3010902
301090203,"Kamuvunyi ",489,448,937,3,301,30109,3010902
301090204,"Kamwijagi ",442,436,878,3,301,30109,3010902
301090205,"Karehe",266,317,583,3,301,30109,3010902
301090206,"Nyarubuye ",257,287,544,3,301,30109,3010902
301090207,"Remera",217,276,493,3,301,30109,3010902
301090301,"Kabatara ",297,340,637,3,301,30109,3010903
301090302,"Kibande",214,213,427,3,301,30109,3010903
301090303,"Kigabiro ",203,154,357,3,301,30109,3010903
301090304,"Nyabitare ",241,352,593,3,301,30109,3010903
301090305,"Nyamagana",264,297,561,3,301,30109,3010903
301090401,"Bizu ",287,351,638,3,301,30109,3010904
301090402,"Gaseke ",221,238,459,3,301,30109,3010904
301090403,"Gitega ",265,272,537,3,301,30109,3010904
301090404,"Kibande",297,337,634,3,301,30109,3010904
301090405,"Muremera ",213,227,440,3,301,30109,3010904
301090406,"Rubona ",263,284,547,3,301,30109,3010904
301090407,"Rusebeya ",243,292,535,3,301,30109,3010904
301090408,"Rwakigarati ",243,282,525,3,301,30109,3010904
301090501,"Buhoro ",202,263,465,3,301,30109,3010905
301090502,"Cyimana ",158,200,358,3,301,30109,3010905
301090503,"Kabeza ",258,306,564,3,301,30109,3010905
301090504,"Kagarama ",255,291,546,3,301,30109,3010905
301090505,"Kamusanganya ",238,281,519,3,301,30109,3010905
301090506,"Kimigenge ",331,357,688,3,301,30109,3010905
301090507,"Ndengwa ",252,321,573,3,301,30109,3010905
301090508,"Rubona ",364,398,762,3,301,30109,3010905
301090601,"Gitwa ",248,270,518,3,301,30109,3010906
301090602,"Kabahizi ",212,235,447,3,301,30109,3010906
301090603,"Mufumbezi ",205,249,454,3,301,30109,3010906
301090604,"Nyagisozi ",271,280,551,3,301,30109,3010906
301090605,"Ruvumbu",252,288,540,3,301,30109,3010906
301090701,"Bigugu ",223,228,451,3,301,30109,3010907
301090702,"Gatare",193,230,423,3,301,30109,3010907
301090703,"Kabazi ",239,260,499,3,301,30109,3010907
301090704,"Kambogo",248,261,509,3,301,30109,3010907
301090705,"Karusha",239,308,547,3,301,30109,3010907
301090706,"Nkomagurwa",277,341,618,3,301,30109,3010907
301090707,"Rukaragata",199,254,453,3,301,30109,3010907
301090801,"Bunyankungu",159,195,354,3,301,30109,3010908
301090802,"Kabeza ",199,261,460,3,301,30109,3010908
301090803,"Nyagahinga ",253,264,517,3,301,30109,3010908
301090804,"Nyagasozi ",224,272,496,3,301,30109,3010908
301090805,"Nyagatovu",220,278,498,3,301,30109,3010908
301090806,"Nyakabungo ",236,263,499,3,301,30109,3010908
301090807,"Rutabo ",203,232,435,3,301,30109,3010908
301090808,"Rwimpongo",215,210,425,3,301,30109,3010908
301100101,"Gitwa ",207,232,439,3,301,30110,3011001
301100102,"Kamina ",218,248,466,3,301,30110,3011001
301100103,"Muciro ",242,283,525,3,301,30110,3011001
301100104,"Rubona ",239,251,490,3,301,30110,3011001
301100105,"Rugabano ",370,380,750,3,301,30110,3011001
301100106,"Winyambo ",231,259,490,3,301,30110,3011001
301100201,"Cyarubariro ",266,311,577,3,301,30110,3011002
301100202,"Kabyaza ",249,285,534,3,301,30110,3011002
301100203,"Kigarama ",168,169,337,3,301,30110,3011002
301100204,"Mihora ",300,321,621,3,301,30110,3011002
301100205,"Misagara ",199,255,454,3,301,30110,3011002
301100206,"Mutotozi ",259,287,546,3,301,30110,3011002
301100207,"Ngoma  ",310,358,668,3,301,30110,3011002
301100208,"Rwesero",269,280,549,3,301,30110,3011002
301100301,"Bisusa",179,222,401,3,301,30110,3011003
301100302,"Gatobo ",274,289,563,3,301,30110,3011003
301100303,"Matyazo ",294,326,620,3,301,30110,3011003
301100304,"Nganzo ",213,316,529,3,301,30110,3011003
301100305,"Nyabagoyi ",249,291,540,3,301,30110,3011003
301100306,"Rugabe ",272,276,548,3,301,30110,3011003
301100307,"Rutoyi ",231,233,464,3,301,30110,3011003
301100401,"Bihembe ",235,226,461,3,301,30110,3011004
301100402,"Kamata ",209,224,433,3,301,30110,3011004
301100403,"Karambo ",190,235,425,3,301,30110,3011004
301100404,"Kigarama ",227,256,483,3,301,30110,3011004
301100405,"Migina ",259,304,563,3,301,30110,3011004
301100406,"Nyabitare  ",180,225,405,3,301,30110,3011004
301100407,"Nyagasozi ",185,255,440,3,301,30110,3011004
301100408,"Simbi ",273,276,549,3,301,30110,3011004
301100501,"Gatwaro ",324,350,674,3,301,30110,3011005
301100502,"Kabyigo ",293,289,582,3,301,30110,3011005
301100503,"Karumbi ",331,394,725,3,301,30110,3011005
301100504,"Kavumu ",232,300,532,3,301,30110,3011005
301100505,"Mataba   ",276,277,553,3,301,30110,3011005
301100506,"Uwigiti ",252,293,545,3,301,30110,3011005
301100601,"Gihara   ",255,279,534,3,301,30110,3011006
301100602,"Kagombyi ",279,274,553,3,301,30110,3011006
301100603,"Kamonyi ",440,389,829,3,301,30110,3011006
301100604,"Kigarama ",358,424,782,3,301,30110,3011006
301100605,"Kivumu ",283,341,624,3,301,30110,3011006
301100606,"Rwagisozi  ",213,244,457,3,301,30110,3011006
301100607,"Ryangondo ",192,239,431,3,301,30110,3011006
301100701,"Bucensha",226,269,495,3,301,30110,3011007
301100702,"Bwihe",246,247,493,3,301,30110,3011007
301100703,"Gitabi",139,186,325,3,301,30110,3011007
301100704,"Karambo",236,267,503,3,301,30110,3011007
301100705,"Kavumu",195,236,431,3,301,30110,3011007
301100706,"Rukoko",226,268,494,3,301,30110,3011007
301100801,"Gahengeri  ",303,309,612,3,301,30110,3011008
301100802,"Gasharu",243,259,502,3,301,30110,3011008
301100803,"Kabuye ",252,277,529,3,301,30110,3011008
301100804,"Rwungo ",280,321,601,3,301,30110,3011008
301100805,"Wisazi ",267,300,567,3,301,30110,3011008
301100901,"Karambi ",160,190,350,3,301,30110,3011009
301100902,"Kirabo ",196,222,418,3,301,30110,3011009
301100903,"Nyakabingo ",287,301,588,3,301,30110,3011009
301100904,"Rubatura ",224,279,503,3,301,30110,3011009
301100905,"Winzira ",268,271,539,3,301,30110,3011009
301100906,"Wurugogwe  ",243,271,514,3,301,30110,3011009
301110101,"Gitwa",139,183,322,3,301,30111,3011101
301110102,"Murambi",177,166,343,3,301,30111,3011101
301110103,"Muremure",129,146,275,3,301,30111,3011101
301110104,"Ngange",233,257,490,3,301,30111,3011101
301110105,"Nyagasozi",124,149,273,3,301,30111,3011101
301110201,"Bugarura",267,289,556,3,301,30111,3011102
301110202,"Kabingo",322,360,682,3,301,30111,3011102
301110203,"Nyagisozi",191,231,422,3,301,30111,3011102
301110301,"Bizitiro",311,335,646,3,301,30111,3011103
301110302,"Kabaranda",294,309,603,3,301,30111,3011103
301110303,"Kanyegenyege",337,368,705,3,301,30111,3011103
301110401,"Birambo",196,244,440,3,301,30111,3011104
301110402,"Kagorora",256,245,501,3,301,30111,3011104
301110403,"Murambi",237,230,467,3,301,30111,3011104
301110404,"Nyarusange",214,239,453,3,301,30111,3011104
301110501,"Dusasa",239,241,480,3,301,30111,3011105
301110502,"Gahororo",209,280,489,3,301,30111,3011105
301110503,"Kiguhu",266,259,525,3,301,30111,3011105
301110504,"Nyabikeri",275,280,555,3,301,30111,3011105
301110601,"Burango",282,299,581,3,301,30111,3011106
301110602,"Kaduha",257,253,510,3,301,30111,3011106
301110603,"Kibari ",220,243,463,3,301,30111,3011106
301110604,"Nyamugwagwa ",232,288,520,3,301,30111,3011106
301110701,"Gahunduguru",191,213,404,3,301,30111,3011107
301110702,"Maryohe",276,321,597,3,301,30111,3011107
301110703,"Muciro",274,293,567,3,301,30111,3011107
301110704,"Rubona",140,178,318,3,301,30111,3011107
301110801,"Gatare ",220,260,480,3,301,30111,3011108
301110802,"Karambo ",204,230,434,3,301,30111,3011108
301110803,"Nyabisiga  ",184,228,412,3,301,30111,3011108
301110804,"Nyagasambu ",199,259,458,3,301,30111,3011108
301110805,"Nyakivumba ",230,246,476,3,301,30111,3011108
301110806,"Nyarutembe ",185,226,411,3,301,30111,3011108
301120101,"Kagusa ",204,228,432,3,301,30112,3011201
301120102,"Kavumu ",221,234,455,3,301,30112,3011201
301120103,"Mifuba  ",197,197,394,3,301,30112,3011201
301120104,"Nyantwa ",247,241,488,3,301,30112,3011201
301120105,"Ruhondo ",205,263,468,3,301,30112,3011201
301120106,"Ruhuha ",200,247,447,3,301,30112,3011201
301120201,"Bisesero ",268,326,594,3,301,30112,3011202
301120202,"Jurwe",269,258,527,3,301,30112,3011202
301120203,"Kigarama ",264,282,546,3,301,30112,3011202
301120204,"Uwingabo ",294,264,558,3,301,30112,3011202
301120301,"Cyabahanga ",181,218,399,3,301,30112,3011203
301120302,"Muhingo ",176,226,402,3,301,30112,3011203
301120303,"Nyagafumba ",196,226,422,3,301,30112,3011203
301120304,"Rugeti ",212,258,470,3,301,30112,3011203
301120305,"Rurebero",178,212,390,3,301,30112,3011203
301120306,"Rutiti  ",218,215,433,3,301,30112,3011203
301120307,"Rwasheke ",199,251,450,3,301,30112,3011203
301120401,"Bweramana ",297,352,649,3,301,30112,3011204
301120402,"Byimana",193,236,429,3,301,30112,3011204
301120403,"Gakangaga ",231,286,517,3,301,30112,3011204
301120404,"Kinaba ",257,306,563,3,301,30112,3011204
301120405,"Muvumba",250,283,533,3,301,30112,3011204
301120406,"Muyira ",187,261,448,3,301,30112,3011204
301120407,"Winzira ",353,426,779,3,301,30112,3011204
301120501,"Mahembe ",322,304,626,3,301,30112,3011205
301120502,"Musango ",276,342,618,3,301,30112,3011205
301120503,"Nyarushekera  ",250,302,552,3,301,30112,3011205
301120601,"Gasharu ",258,283,541,3,301,30112,3011206
301120602,"Karambo ",229,263,492,3,301,30112,3011206
301120603,"Kigogwe ",228,255,483,3,301,30112,3011206
301120604,"Kinyege ",230,265,495,3,301,30112,3011206
301120605,"Wingwa ",244,284,528,3,301,30112,3011206
301120701,"Bucyurabuhoro",218,265,483,3,301,30112,3011207
301120702,"Kanyarusanga",226,246,472,3,301,30112,3011207
301120703,"Nyaruyaga",164,223,387,3,301,30112,3011207
301120704,"Ruhinga",274,289,563,3,301,30112,3011207
301120705,"Wamahoro",251,274,525,3,301,30112,3011207
301120801,"Gishwati ",241,272,513,3,301,30112,3011208
301120802,"Himbo ",263,288,551,3,301,30112,3011208
301120803,"Rukore ",318,320,638,3,301,30112,3011208
301120804,"Ryampande ",255,307,562,3,301,30112,3011208
301130101,"Bihumbe ",196,276,472,3,301,30113,3011301
301130102,"Bivumu ",352,426,778,3,301,30113,3011301
301130103,"Gikaranka ",281,324,605,3,301,30113,3011301
301130104,"Nyabubare",328,413,741,3,301,30113,3011301
301130105,"Rushishi",252,323,575,3,301,30113,3011301
301130106,"Uwintobo ",269,351,620,3,301,30113,3011301
301130201,"Gakoko",330,384,714,3,301,30113,3011302
301130202,"Karumbi",411,441,852,3,301,30113,3011302
301130203,"Nyamiryango",389,474,863,3,301,30113,3011302
301130204,"Rugogwe",309,334,643,3,301,30113,3011302
301130205,"Twumba",376,410,786,3,301,30113,3011302
301130301,"Bikunda",352,395,747,3,301,30113,3011303
301130302,"Gashihe ",410,496,906,3,301,30113,3011303
301130303,"Kanyovu  ",234,251,485,3,301,30113,3011303
301130304,"Karambo ",187,216,403,3,301,30113,3011303
301130305,"Kibuburo ",302,352,654,3,301,30113,3011303
301130306,"Mwumba ",302,351,653,3,301,30113,3011303
301130307,"Nyakabingo ",246,240,486,3,301,30113,3011303
301130401,"Gatare ",184,231,415,3,301,30113,3011304
301130402,"Kibingo ",342,387,729,3,301,30113,3011304
301130403,"Mataba ",452,497,949,3,301,30113,3011304
301130404,"Nyakiyabo ",166,139,305,3,301,30113,3011304
301130405,"Nyarubuye ",205,229,434,3,301,30113,3011304
301130406,"Nyaruyaga ",289,340,629,3,301,30113,3011304
301130407,"Rugeyo ",275,331,606,3,301,30113,3011304
301130408,"Tuvunasogi  ",169,223,392,3,301,30113,3011304
301130501,"Gasharu ",141,165,306,3,301,30113,3011305
301130502,"Kaganda ",205,273,478,3,301,30113,3011305
301130503,"Kavumu  ",243,334,577,3,301,30113,3011305
301130504,"Muhira ",158,195,353,3,301,30113,3011305
301130505,"Murambi ",178,206,384,3,301,30113,3011305
301130506,"Muronzi ",204,240,444,3,301,30113,3011305
301130507,"Nyarutagara ",187,228,415,3,301,30113,3011305
301130601,"Duhati ",486,393,879,3,301,30113,3011306
301130602,"Gatema ",279,301,580,3,301,30113,3011306
301130603,"Kaganda ",306,363,669,3,301,30113,3011306
301130604,"Murehe ",282,345,627,3,301,30113,3011306
301130701,"Gahondo ",265,264,529,3,301,30113,3011307
301130702,"Nyirabununu ",247,308,555,3,301,30113,3011307
301130703,"Rutabi ",263,330,593,3,301,30113,3011307
301130704,"Wintobo ",284,290,574,3,301,30113,3011307
302010101,"Bikono",259,283,542,3,302,30201,3020101
302010102,"Bugarura",357,404,761,3,302,30201,3020101
302010103,"Gaseke",406,434,840,3,302,30201,3020101
302010104,"Kabirizi",336,353,689,3,302,30201,3020101
302010105,"Kinunu",317,328,645,3,302,30201,3020101
302010106,"Muramba",332,362,694,3,302,30201,3020101
302010107,"Rutagara",289,289,578,3,302,30201,3020101
302010108,"Rwimbogo",273,271,544,3,302,30201,3020101
302010201,"Buhonongo",233,325,558,3,302,30201,3020102
302010202,"Bweramana",297,385,682,3,302,30201,3020102
302010203,"Gashoko",325,361,686,3,302,30201,3020102
302010204,"Kamuyaga",231,259,490,3,302,30201,3020102
302010205,"Rugamba",411,472,883,3,302,30201,3020102
302010206,"Rwabisururu",399,468,867,3,302,30201,3020102
302010301,"Gisiza",351,386,737,3,302,30201,3020103
302010302,"Gisoro",292,366,658,3,302,30201,3020103
302010303,"Kabuga",351,385,736,3,302,30201,3020103
302010304,"Karukamba",316,335,651,3,302,30201,3020103
302010305,"Kigarama",337,352,689,3,302,30201,3020103
302010306,"Munanira",304,340,644,3,302,30201,3020103
302010307,"Murambi",366,376,742,3,302,30201,3020103
302010401,"Bigabiro",288,279,567,3,302,30201,3020104
302010402,"Buhoro",335,376,711,3,302,30201,3020104
302010403,"Kaganza",374,385,759,3,302,30201,3020104
302010404,"Kamuzigura",253,274,527,3,302,30201,3020104
302010405,"Kinunga",321,395,716,3,302,30201,3020104
302010406,"Muyange",259,301,560,3,302,30201,3020104
302010407,"Rusororo",482,531,1013,3,302,30201,3020104
302020101,"Gishushu",220,228,448,3,302,30202,3020201
302020102,"Gitarama",206,240,446,3,302,30202,3020201
302020103,"Kagarama",157,235,392,3,302,30202,3020201
302020104,"Karambi",286,354,640,3,302,30202,3020201
302020201,"Kandahura",421,366,787,3,302,30202,3020202
302020202,"Kindoyi",187,210,397,3,302,30202,3020202
302020203,"Mukebera",380,456,836,3,302,30202,3020202
302020204,"Nduba",417,403,820,3,302,30202,3020202
302020205,"Nkwiro",199,219,418,3,302,30202,3020202
302020301,"Butare",257,279,536,3,302,30202,3020203
302020302,"Kabeza",193,235,428,3,302,30202,3020203
302020303,"Kamutambiro",249,255,504,3,302,30202,3020203
302020304,"Muyange",326,320,646,3,302,30202,3020203
302020305,"Nganzo",243,273,516,3,302,30202,3020203
302020306,"Terimbere",307,338,645,3,302,30202,3020203
302020401,"Gashihe",209,284,493,3,302,30202,3020204
302020402,"Gatomvu",331,418,749,3,302,30202,3020204
302020403,"Karugaju",298,347,645,3,302,30202,3020204
302020404,"Muhora",247,291,538,3,302,30202,3020204
302020405,"Nyagahinga",252,280,532,3,302,30202,3020204
302020501,"Gasharu",214,244,458,3,302,30202,3020205
302020502,"Kabuga",201,227,428,3,302,30202,3020205
302020503,"Nyagahinga",167,205,372,3,302,30202,3020205
302020601,"Gisunzu",299,361,660,3,302,30202,3020206
302020602,"Karambo",310,341,651,3,302,30202,3020206
302020603,"Karongi",300,317,617,3,302,30202,3020206
302020604,"Rugote",290,352,642,3,302,30202,3020206
302020605,"Rwamiyaga",325,340,665,3,302,30202,3020206
302020606,"Shyembe",372,415,787,3,302,30202,3020206
302020701,"Bweramana",315,352,667,3,302,30202,3020207
302020702,"Gasave",277,312,589,3,302,30202,3020207
302020703,"Gateja",290,335,625,3,302,30202,3020207
302020704,"Kanembwe",276,328,604,3,302,30202,3020207
302020705,"Rasaniro",353,357,710,3,302,30202,3020207
302030101,"Burambo",355,374,729,3,302,30203,3020301
302030102,"Bushaka",360,354,714,3,302,30203,3020301
302030103,"Gacaca",329,405,734,3,302,30203,3020301
302030104,"Gaharawe",284,318,602,3,302,30203,3020301
302030105,"Gisiza",272,268,540,3,302,30203,3020301
302030106,"Nkamba",320,299,619,3,302,30203,3020301
302030107,"Nkomero",307,342,649,3,302,30203,3020301
302030108,"Nturo",321,340,661,3,302,30203,3020301
302030201,"Buhimba",492,361,853,3,302,30203,3020302
302030202,"Gahotora",281,324,605,3,302,30203,3020302
302030203,"Gasagara",343,351,694,3,302,30203,3020302
302030204,"Gasereganya",275,298,573,3,302,30203,3020302
302030205,"Humiro",254,283,537,3,302,30203,3020302
302030206,"Kabashyembe",332,355,687,3,302,30203,3020302
302030207,"Kanyirahweza",376,390,766,3,302,30203,3020302
302030208,"Karambi",293,339,632,3,302,30203,3020302
302030209,"Kigugu",310,335,645,3,302,30203,3020302
302030210,"Muhora",338,352,690,3,302,30203,3020302
302030211,"Rukundo",340,396,736,3,302,30203,3020302
302030301,"Bukungu",327,363,690,3,302,30203,3020303
302030302,"Kampi",546,556,1102,3,302,30203,3020303
302030303,"Nteko",316,329,645,3,302,30203,3020303
302030304,"Nyarusuku",218,246,464,3,302,30203,3020303
302030305,"Rugabi",320,361,681,3,302,30203,3020303
302030306,"Rukombe",219,217,436,3,302,30203,3020303
302030307,"Rupango",248,292,540,3,302,30203,3020303
302030308,"Rusisiro",266,302,568,3,302,30203,3020303
302030309,"Ruvumu",186,200,386,3,302,30203,3020303
302030401,"Gahunga",319,358,677,3,302,30203,3020304
302030402,"Gasenyi",338,360,698,3,302,30203,3020304
302030403,"Kagondero",383,420,803,3,302,30203,3020304
302030404,"Kamina",303,348,651,3,302,30203,3020304
302030405,"Kinihira",419,430,849,3,302,30203,3020304
302030406,"Murambi",324,329,653,3,302,30203,3020304
302030407,"Nganzo",259,309,568,3,302,30203,3020304
302030408,"Rwambeho",370,431,801,3,302,30203,3020304
302030409,"Rwamiyaga",273,317,590,3,302,30203,3020304
302030410,"Tagaza",298,382,680,3,302,30203,3020304
302040101,"Bureke",206,241,447,3,302,30204,3020401
302040102,"Gashinga",267,270,537,3,302,30204,3020401
302040103,"Gihari",285,312,597,3,302,30204,3020401
302040104,"Gitwa",215,222,437,3,302,30204,3020401
302040105,"Kabigabiro",310,345,655,3,302,30204,3020401
302040106,"Kanyempanga",281,302,583,3,302,30204,3020401
302040107,"Nyarubuye",391,406,797,3,302,30204,3020401
302040201,"Cyivugiza",485,596,1081,3,302,30204,3020402
302040202,"Kamabuye",361,402,763,3,302,30204,3020402
302040203,"Karungu",322,373,695,3,302,30204,3020402
302040204,"Mpinga",449,476,925,3,302,30204,3020402
302040205,"Rwamvura",283,346,629,3,302,30204,3020402
302040206,"Trafipro",345,421,766,3,302,30204,3020402
302040301,"Burambo",357,430,787,3,302,30204,3020403
302040302,"Burango",281,292,573,3,302,30204,3020403
302040303,"Cyato",404,445,849,3,302,30204,3020403
302040304,"Kabitara",344,381,725,3,302,30204,3020403
302040305,"Kabusagara",351,375,726,3,302,30204,3020403
302040306,"Kagera",426,416,842,3,302,30204,3020403
302040307,"Mushubati",254,296,550,3,302,30204,3020403
302040401,"Bitare",270,320,590,3,302,30204,3020404
302040402,"Buhogo",253,282,535,3,302,30204,3020404
302040403,"Kabagwe",244,295,539,3,302,30204,3020404
302040404,"Kabuye",249,251,500,3,302,30204,3020404
302040405,"Kanyamatembe",243,275,518,3,302,30204,3020404
302040406,"Rurembo",273,265,538,3,302,30204,3020404
302040407,"Rusisiro",282,339,621,3,302,30204,3020404
302040408,"Rutambi",292,337,629,3,302,30204,3020404
302040409,"Tarasi",245,303,548,3,302,30204,3020404
302040501,"Bukiro",400,439,839,3,302,30204,3020405
302040502,"Bukumba",483,484,967,3,302,30204,3020405
302040503,"Buroha",338,385,723,3,302,30204,3020405
302040504,"Bushamba",369,373,742,3,302,30204,3020405
302040505,"Gateko",363,386,749,3,302,30204,3020405
302040506,"Kabuga",361,380,741,3,302,30204,3020405
302040507,"Nyundo",300,348,648,3,302,30204,3020405
302040508,"Rusumo",312,347,659,3,302,30204,3020405
302040601,"Bubira",255,301,556,3,302,30204,3020406
302040602,"Bugarishya",359,358,717,3,302,30204,3020406
302040603,"Kamwimba",225,284,509,3,302,30204,3020406
302040604,"Muramba",337,384,721,3,302,30204,3020406
302040605,"Nyabiti",254,327,581,3,302,30204,3020406
302040606,"Remera",345,371,716,3,302,30204,3020406
302040607,"Rwinyoni",381,411,792,3,302,30204,3020406
302040608,"Tawuni",522,544,1066,3,302,30204,3020406
302050101,"Bitabaro",193,212,405,3,302,30205,3020501
302050102,"Gisunzu",198,265,463,3,302,30205,3020501
302050103,"Gitwe",348,370,718,3,302,30205,3020501
302050104,"Kaziramihunda",280,335,615,3,302,30205,3020501
302050105,"Kivumu",347,375,722,3,302,30205,3020501
302050106,"Mifu",322,353,675,3,302,30205,3020501
302050107,"Rukondo",195,212,407,3,302,30205,3020501
302050108,"Runaba",376,415,791,3,302,30205,3020501
302050201,"Birambo",240,246,486,3,302,30205,3020502
302050202,"Kagarama",253,324,577,3,302,30205,3020502
302050203,"Kamishunguro",195,198,393,3,302,30205,3020502
302050204,"Kanama",140,179,319,3,302,30205,3020502
302050205,"Kimpongo",234,264,498,3,302,30205,3020502
302050206,"Mujebeshi",251,259,510,3,302,30205,3020502
302050207,"Muyira",312,327,639,3,302,30205,3020502
302050208,"Nyakarambi",341,382,723,3,302,30205,3020502
302050209,"Rufungo",277,301,578,3,302,30205,3020502
302050210,"Rutangaza",204,256,460,3,302,30205,3020502
302050211,"Rutare",200,266,466,3,302,30205,3020502
302050301,"Kabeza",214,255,469,3,302,30205,3020503
302050302,"Kadehero",277,310,587,3,302,30205,3020503
302050303,"Kanama",337,376,713,3,302,30205,3020503
302050304,"Karambo",204,211,415,3,302,30205,3020503
302050305,"Munini",319,394,713,3,302,30205,3020503
302050306,"Nyarushogwe",326,348,674,3,302,30205,3020503
302050307,"Rugano",270,303,573,3,302,30205,3020503
302060101,"Kabahigi",207,237,444,3,302,30206,3020601
302060102,"Karambo Ya 1",271,324,595,3,302,30206,3020601
302060103,"Miraramo",301,336,637,3,302,30206,3020601
302060104,"Sanzare",278,335,613,3,302,30206,3020601
302060201,"Cyabatsinga",174,204,378,3,302,30206,3020602
302060202,"Gakeri",275,342,617,3,302,30206,3020602
302060203,"Kabacuzi",197,251,448,3,302,30206,3020602
302060204,"Kagano",294,341,635,3,302,30206,3020602
302060205,"Kamonyi",266,295,561,3,302,30206,3020602
302060206,"Kazizi",314,377,691,3,302,30206,3020602
302060207,"Kibavu",301,370,671,3,302,30206,3020602
302060208,"Kiriba",186,210,396,3,302,30206,3020602
302060209,"Ntobo",152,182,334,3,302,30206,3020602
302060210,"Nyaburama",252,286,538,3,302,30206,3020602
302060211,"Rugomero",193,199,392,3,302,30206,3020602
302060212,"Tumba",203,236,439,3,302,30206,3020602
302060301,"Bitura",156,185,341,3,302,30206,3020603
302060302,"Karumbi",358,428,786,3,302,30206,3020603
302060303,"Kigeyo",299,348,647,3,302,30206,3020603
302060304,"Kimishishi",256,310,566,3,302,30206,3020603
302060305,"Mucaca",283,323,606,3,302,30206,3020603
302060306,"Ntonde",288,374,662,3,302,30206,3020603
302060307,"Nyanzu",271,332,603,3,302,30206,3020603
302060308,"Rukeri",325,386,711,3,302,30206,3020603
302060309,"Rukondo",222,284,506,3,302,30206,3020603
302060310,"Site Mukura 1",185,215,400,3,302,30206,3020603
302060311,"Site Mukura 2",175,215,390,3,302,30206,3020603
302060401,"Bucyeye",263,339,602,3,302,30206,3020604
302060402,"Gako ",339,383,722,3,302,30206,3020604
302060403,"Gasharu",229,222,451,3,302,30206,3020604
302060404,"Muhindo",261,321,582,3,302,30206,3020604
302060405,"Rusasa",250,309,559,3,302,30206,3020604
302060501,"Bandamiko",347,433,780,3,302,30206,3020605
302060502,"Dehero",261,288,549,3,302,30206,3020605
302060503,"Gasambi",327,325,652,3,302,30206,3020605
302060504,"Gihumo",278,302,580,3,302,30206,3020605
302060505,"Gituntu",198,248,446,3,302,30206,3020605
302060506,"Karambo Ya 2",191,250,441,3,302,30206,3020605
302060507,"Terimbere",250,293,543,3,302,30206,3020605
302060601,"Bitenga",384,378,762,3,302,30206,3020606
302060602,"Gafu",330,366,696,3,302,30206,3020606
302060603,"Gako",277,348,625,3,302,30206,3020606
302060604,"Gitega",191,197,388,3,302,30206,3020606
302060605,"Kabeza",238,283,521,3,302,30206,3020606
302060606,"Kabisasa",343,416,759,3,302,30206,3020606
302060607,"Kagogo",312,367,679,3,302,30206,3020606
302060608,"Kagombwa",311,394,705,3,302,30206,3020606
302060609,"Kamariba",179,229,408,3,302,30206,3020606
302060610,"Mataba",289,314,603,3,302,30206,3020606
302060611,"Nyarubande",259,288,547,3,302,30206,3020606
302060612,"Nyarusongati",356,396,752,3,302,30206,3020606
302060613,"Nyove",259,268,527,3,302,30206,3020606
302060614,"Rugari",310,354,664,3,302,30206,3020606
302070101,"Bukongora",394,413,807,3,302,30207,3020701
302070102,"Gasasa",352,362,714,3,302,30207,3020701
302070103,"Kabatemba",188,234,422,3,302,30207,3020701
302070104,"Kajugujugu",218,227,445,3,302,30207,3020701
302070105,"Karumbi",401,389,790,3,302,30207,3020701
302070106,"Karuruma",377,399,776,3,302,30207,3020701
302070107,"Muremure",210,238,448,3,302,30207,3020701
302070108,"Nyenyeri",312,417,729,3,302,30207,3020701
302070109,"Ruhanga",351,415,766,3,302,30207,3020701
302070110,"Rusisiro",227,260,487,3,302,30207,3020701
302070111,"Satinsyi",205,252,457,3,302,30207,3020701
302070201,"Gatoki",239,253,492,3,302,30207,3020702
302070202,"Kamuhoza",233,215,448,3,302,30207,3020702
302070203,"Kariba",226,234,460,3,302,30207,3020702
302070204,"Murunda",539,536,1075,3,302,30207,3020702
302070205,"Rukingu",249,247,496,3,302,30207,3020702
302070206,"Rurimba",275,289,564,3,302,30207,3020702
302070207,"Rwamiko",198,217,415,3,302,30207,3020702
302070301,"Kabeza",280,337,617,3,302,30207,3020703
302070302,"Kamabuye",342,342,684,3,302,30207,3020703
302070303,"Kamusambi",325,384,709,3,302,30207,3020703
302070304,"Karambo",245,282,527,3,302,30207,3020703
302070305,"Musongati",324,338,662,3,302,30207,3020703
302070401,"Bweramana",287,320,607,3,302,30207,3020704
302070402,"Gatare",313,353,666,3,302,30207,3020704
302070403,"Nyarucundura",210,250,460,3,302,30207,3020704
302070404,"Rwanika",294,292,586,3,302,30207,3020704
302070405,"Rwoza",248,294,542,3,302,30207,3020704
302080101,"Gabiro",306,361,667,3,302,30208,3020801
302080102,"Gitwa",119,146,265,3,302,30208,3020801
302080103,"Murama",275,373,648,3,302,30208,3020801
302080104,"Nyagahinga",217,239,456,3,302,30208,3020801
302080105,"Nyarugenge",286,326,612,3,302,30208,3020801
302080106,"Rugarambiro",253,266,519,3,302,30208,3020801
302080107,"Rwagatoki",195,222,417,3,302,30208,3020801
302080108,"Rwangoma",182,213,395,3,302,30208,3020801
302080201,"Bweramana",303,377,680,3,302,30208,3020802
302080202,"Gasharu",296,309,605,3,302,30208,3020802
302080203,"Gihinga",397,389,786,3,302,30208,3020802
302080204,"Gisiza",425,506,931,3,302,30208,3020802
302080205,"Gitovu",296,331,627,3,302,30208,3020802
302080206,"Karambi",354,446,800,3,302,30208,3020802
302080207,"Karambo",200,247,447,3,302,30208,3020802
302080208,"Ngoma",335,337,672,3,302,30208,3020802
302080209,"Nyagafurwe",328,353,681,3,302,30208,3020802
302080210,"Rubaya",303,327,630,3,302,30208,3020802
302080301,"Bunnyari",323,362,685,3,302,30208,3020803
302080302,"Buruseri",370,431,801,3,302,30208,3020803
302080303,"Kabatoni",218,279,497,3,302,30208,3020803
302080304,"Munyinya",245,246,491,3,302,30208,3020803
302080305,"Murambi",344,362,706,3,302,30208,3020803
302080306,"Nyamasheke",369,368,737,3,302,30208,3020803
302080307,"Rwintanga",202,242,444,3,302,30208,3020803
302080308,"Rwumba",289,344,633,3,302,30208,3020803
302080309,"Syiki",345,335,680,3,302,30208,3020803
302080401,"Bwinyana",367,351,718,3,302,30208,3020804
302080402,"Gataka",300,389,689,3,302,30208,3020804
302080403,"Gitete",193,197,390,3,302,30208,3020804
302080404,"Kabuga",234,253,487,3,302,30208,3020804
302080405,"Mirambi",250,278,528,3,302,30208,3020804
302080406,"Muhororo",186,201,387,3,302,30208,3020804
302080407,"Rebero",249,289,538,3,302,30208,3020804
302090101,"Buhunde",300,343,643,3,302,30209,3020901
302090102,"Bushunga",336,358,694,3,302,30209,3020901
302090103,"Buzukira",288,310,598,3,302,30209,3020901
302090104,"Kabakiza",312,355,667,3,302,30209,3020901
302090105,"Kamaranzara",344,311,655,3,302,30209,3020901
302090106,"Karengera",260,324,584,3,302,30209,3020901
302090107,"Mugara",358,409,767,3,302,30209,3020901
302090108,"Rurimba",371,446,817,3,302,30209,3020901
302090201,"Cyondo",342,340,682,3,302,30209,3020902
302090202,"Gakenke",315,344,659,3,302,30209,3020902
302090203,"Kabere",369,461,830,3,302,30209,3020902
302090204,"Kivumu ",345,359,704,3,302,30209,3020902
302090205,"Maziba",384,442,826,3,302,30209,3020902
302090206,"Mubuga",351,397,748,3,302,30209,3020902
302090207,"Rugerero",424,435,859,3,302,30209,3020902
302090208,"Rwesero",366,418,784,3,302,30209,3020902
302090209,"Ryarwasa",348,375,723,3,302,30209,3020902
302090301,"Gakomeye",327,402,729,3,302,30209,3020903
302090302,"Gasave",340,370,710,3,302,30209,3020903
302090303,"Gihumba",295,322,617,3,302,30209,3020903
302090304,"Kakibaba",327,362,689,3,302,30209,3020903
302090305,"Kariba",388,401,789,3,302,30209,3020903
302090306,"Nkomero",350,389,739,3,302,30209,3020903
302090307,"Ruyogoro",377,369,746,3,302,30209,3020903
302090401,"Gasoro",246,321,567,3,302,30209,3020904
302090402,"Gisunzu",323,338,661,3,302,30209,3020904
302090403,"Kaboneye",440,465,905,3,302,30209,3020904
302090404,"Kagano",506,372,878,3,302,30209,3020904
302090405,"Kashishi",257,315,572,3,302,30209,3020904
302090406,"Kavumu",339,416,755,3,302,30209,3020904
302090407,"Mukati",303,364,667,3,302,30209,3020904
302090408,"Ngunguru",244,273,517,3,302,30209,3020904
302090409,"Rugaragara",319,394,713,3,302,30209,3020904
302090410,"Ruhengeri",246,224,470,3,302,30209,3020904
302100101,"Bisyo",343,404,747,3,302,30210,3021001
302100102,"Kabiraho",317,308,625,3,302,30210,3021001
302100103,"Kamushozi",234,227,461,3,302,30210,3021001
302100104,"Karambi",630,503,1133,3,302,30210,3021001
302100105,"Mataba",222,238,460,3,302,30210,3021001
302100106,"Rugote",339,381,720,3,302,30210,3021001
302100107,"Ruhinga",327,364,691,3,302,30210,3021001
302100201,"Bivumu",189,232,421,3,302,30210,3021002
302100202,"Cyahafi",254,305,559,3,302,30210,3021002
302100203,"Gasharu",274,276,550,3,302,30210,3021002
302100204,"Kigarama",292,315,607,3,302,30210,3021002
302100205,"Kunini",289,355,644,3,302,30210,3021002
302100206,"Mugeri",335,351,686,3,302,30210,3021002
302100301,"Gakoma",315,345,660,3,302,30210,3021003
302100302,"Gashinge",247,269,516,3,302,30210,3021003
302100303,"Karambira",237,284,521,3,302,30210,3021003
302100304,"Kibari",280,325,605,3,302,30210,3021003
302100305,"Mbuga",222,243,465,3,302,30210,3021003
302100306,"Mubuga",268,327,595,3,302,30210,3021003
302100307,"Mugote",193,269,462,3,302,30210,3021003
302100308,"Rububa",292,342,634,3,302,30210,3021003
302100309,"Ruhinga",239,266,505,3,302,30210,3021003
302100310,"Rwintore",183,242,425,3,302,30210,3021003
302100311,"Taba",342,342,684,3,302,30210,3021003
302100401,"Gitega",217,257,474,3,302,30210,3021004
302100402,"Murambi",352,397,749,3,302,30210,3021004
302100403,"Nyakabuye",268,274,542,3,302,30210,3021004
302100404,"Nyarusange",208,237,445,3,302,30210,3021004
302100405,"Rarankuba",384,435,819,3,302,30210,3021004
302100406,"Rushikiri",223,213,436,3,302,30210,3021004
302100501,"Kabuga",203,222,425,3,302,30210,3021005
302100502,"Kaduha",266,335,601,3,302,30210,3021005
302100503,"Kagugu",325,401,726,3,302,30210,3021005
302100504,"Kanyinya",411,465,876,3,302,30210,3021005
302100505,"Kivumu",405,436,841,3,302,30210,3021005
302100506,"Nyagahinga",308,300,608,3,302,30210,3021005
302100507,"Nyamahuru",345,372,717,3,302,30210,3021005
302110101,"Bishami",272,304,576,3,302,30211,3021101
302110102,"Busuku",212,232,444,3,302,30211,3021101
302110103,"Busuti",201,256,457,3,302,30211,3021101
302110104,"Bwiza",182,181,363,3,302,30211,3021101
302110105,"Gacaca",236,269,505,3,302,30211,3021101
302110106,"Gatare",312,430,742,3,302,30211,3021101
302110107,"Ngugo",149,207,356,3,302,30211,3021101
302110108,"Nyakibande",225,214,439,3,302,30211,3021101
302110109,"Rwamigega",219,284,503,3,302,30211,3021101
302110110,"Torwe",264,302,566,3,302,30211,3021101
302110111,"Tsindiro",214,277,491,3,302,30211,3021101
302110201,"Cyubi",198,185,383,3,302,30211,3021102
302110202,"Gakumba",140,155,295,3,302,30211,3021102
302110203,"Gishahaga",227,255,482,3,302,30211,3021102
302110204,"Kageyo",155,169,324,3,302,30211,3021102
302110205,"Kamananga",211,232,443,3,302,30211,3021102
302110206,"Mukungu",186,213,399,3,302,30211,3021102
302110207,"Nyabishongo",292,318,610,3,302,30211,3021102
302110208,"Rukomero",228,253,481,3,302,30211,3021102
302110301,"Bugorozi",246,269,515,3,302,30211,3021103
302110302,"Buryoshya",206,242,448,3,302,30211,3021103
302110303,"Gakararanka",241,284,525,3,302,30211,3021103
302110304,"Gashasho",243,302,545,3,302,30211,3021103
302110305,"Gatsiro",235,296,531,3,302,30211,3021103
302110306,"Gitongo",97,132,229,3,302,30211,3021103
302110307,"Kabaratama",156,139,295,3,302,30211,3021103
302110308,"Mubuga",117,147,264,3,302,30211,3021103
302110309,"Pfunda",188,236,424,3,302,30211,3021103
302110310,"Rushubi",209,176,385,3,302,30211,3021103
302110311,"Rutovu",248,252,500,3,302,30211,3021103
302110312,"Rwankuba",222,238,460,3,302,30211,3021103
302110401,"Bukanda",242,260,502,3,302,30211,3021104
302110402,"Bushoga",222,269,491,3,302,30211,3021104
302110403,"Cyeshero",271,310,581,3,302,30211,3021104
302110404,"Gashihe",299,379,678,3,302,30211,3021104
302110405,"Gisayo",236,288,524,3,302,30211,3021104
302110406,"Gishowa",197,229,426,3,302,30211,3021104
302110407,"Kaje",162,198,360,3,302,30211,3021104
302110408,"Kamunyurwe",173,204,377,3,302,30211,3021104
302110409,"Kazo",268,281,549,3,302,30211,3021104
302110410,"Mpati",230,255,485,3,302,30211,3021104
302110411,"Ngoma",206,212,418,3,302,30211,3021104
302110412,"Nkuna",288,302,590,3,302,30211,3021104
302110501,"Gihinga",269,300,569,3,302,30211,3021105
302110502,"Kageshi",235,271,506,3,302,30211,3021105
302110503,"Kanombe",221,253,474,3,302,30211,3021105
302110504,"Karongi",204,238,442,3,302,30211,3021105
302110505,"Kasonga",487,340,827,3,302,30211,3021105
302110506,"Kinyamavuta ",462,514,976,3,302,30211,3021105
302110507,"Mukondo",193,227,420,3,302,30211,3021105
302110508,"Negenero",213,240,453,3,302,30211,3021105
302110509,"Nyampengeri",198,236,434,3,302,30211,3021105
302110510,"Ruraji",273,287,560,3,302,30211,3021105
302110511,"Rwandozi",231,232,463,3,302,30211,3021105
302110512,"Rwangambuto",211,236,447,3,302,30211,3021105
302110513,"Ryanyiraminonko",234,271,505,3,302,30211,3021105
302120101,"Gasovu",320,324,644,3,302,30212,3021201
302120102,"Gasoyo",234,297,531,3,302,30212,3021201
302120103,"Kamuramira",290,328,618,3,302,30212,3021201
302120104,"Kirinja",236,293,529,3,302,30212,3021201
302120105,"Mwurire",282,295,577,3,302,30212,3021201
302120106,"Ruhimbi",264,285,549,3,302,30212,3021201
302120107,"Rukenesha",277,395,672,3,302,30212,3021201
302120201,"Bitenga",395,450,845,3,302,30212,3021202
302120202,"Busenda",279,302,581,3,302,30212,3021202
302120203,"Karambagiro",178,201,379,3,302,30212,3021202
302120204,"Kararo",247,301,548,3,302,30212,3021202
302120205,"Kinyenkanda",158,171,329,3,302,30212,3021202
302120206,"Murambi",493,564,1057,3,302,30212,3021202
302120207,"Rukoko",352,397,749,3,302,30212,3021202
302120208,"Tara",304,375,679,3,302,30212,3021202
302120301,"Gakeri",515,501,1016,3,302,30212,3021203
302120302,"Gasasa",294,320,614,3,302,30212,3021203
302120303,"Gasunzu",305,360,665,3,302,30212,3021203
302120304,"Mubirizi",343,399,742,3,302,30212,3021203
302120305,"Muhingo",461,523,984,3,302,30212,3021203
302120306,"Nyundo",278,323,601,3,302,30212,3021203
302120401,"Buzeyi",356,391,747,3,302,30212,3021204
302120402,"Kabeza",298,327,625,3,302,30212,3021204
302120403,"Kagogo",334,352,686,3,302,30212,3021204
302120404,"Kayove",414,374,788,3,302,30212,3021204
302120405,"Marabuye",342,365,707,3,302,30212,3021204
302120406,"Mugali",253,315,568,3,302,30212,3021204
302120501,"Cyashenge",366,430,796,3,302,30212,3021205
302120502,"Gicaca",363,414,777,3,302,30212,3021205
302120503,"Kabitovu",369,383,752,3,302,30212,3021205
302120504,"Kiraza",387,457,844,3,302,30212,3021205
302120505,"Murambi",304,365,669,3,302,30212,3021205
302120506,"Nyakagezi",339,370,709,3,302,30212,3021205
302120601,"Gakararanka",345,433,778,3,302,30212,3021206
302120602,"Karebero",352,427,779,3,302,30212,3021206
302120603,"Kaziga",186,243,429,3,302,30212,3021206
302120604,"Matyazo",407,469,876,3,302,30212,3021206
302120605,"Rugaragara",254,289,543,3,302,30212,3021206
302120606,"Rushasho",308,370,678,3,302,30212,3021206
302130101,"Byiniro",336,415,751,3,302,30213,3021301
302130102,"Kibara",195,238,433,3,302,30213,3021301
302130103,"Munini",300,359,659,3,302,30213,3021301
302130104,"Murengeri",328,369,697,3,302,30213,3021301
302130105,"Ntereye",320,391,711,3,302,30213,3021301
302130106,"Nyagasambu",375,395,770,3,302,30213,3021301
302130107,"Rusheshi",311,332,643,3,302,30213,3021301
302130108,"Rwamvura",249,314,563,3,302,30213,3021301
302130201,"Bungwe",318,349,667,3,302,30213,3021302
302130202,"Gakeri",305,314,619,3,302,30213,3021302
302130203,"Gashihe",242,278,520,3,302,30213,3021302
302130204,"Gatenga",267,345,612,3,302,30213,3021302
302130205,"Gihinga",262,296,558,3,302,30213,3021302
302130206,"Kabeza",239,266,505,3,302,30213,3021302
302130207,"Kacyiru",225,231,456,3,302,30213,3021302
302130208,"Kagano",320,378,698,3,302,30213,3021302
302130209,"Marimba",316,432,748,3,302,30213,3021302
302130210,"Ruganda",246,291,537,3,302,30213,3021302
302130211,"Rurimba",250,270,520,3,302,30213,3021302
302130301,"Bihira",232,285,517,3,302,30213,3021303
302130302,"Bweramana",255,300,555,3,302,30213,3021303
302130303,"Gahunga",277,332,609,3,302,30213,3021303
302130304,"Kabarirwa",264,291,555,3,302,30213,3021303
302130305,"Kiyanja",277,327,604,3,302,30213,3021303
302130306,"Nturo",192,221,413,3,302,30213,3021303
302130307,"Ruhuha",217,200,417,3,302,30213,3021303
302130308,"Rurambo",321,397,718,3,302,30213,3021303
302130309,"Shyembe",324,363,687,3,302,30213,3021303
302130401,"Gisozi",238,246,484,3,302,30213,3021304
302130402,"Kigali",283,324,607,3,302,30213,3021304
302130403,"Kirumbi",198,259,457,3,302,30213,3021304
302130404,"Mubuga",262,303,565,3,302,30213,3021304
302130405,"Nyamibombwe",330,399,729,3,302,30213,3021304
303010101,"Bugeshi",277,297,574,3,303,30301,3030101
303010102,"Buringo",248,301,549,3,303,30301,3030101
303010103,"Butaka",218,213,431,3,303,30301,3030101
303010104,"Gaharawe",354,346,700,3,303,30301,3030101
303010105,"Gahira",314,331,645,3,303,30301,3030101
303010106,"Jende",302,382,684,3,303,30301,3030101
303010107,"Mutegengeri",262,263,525,3,303,30301,3030101
303010201,"Akabajara",184,196,380,3,303,30301,3030102
303010202,"Akimitoni",234,262,496,3,303,30301,3030102
303010203,"Gaheriheri",313,352,665,3,303,30301,3030102
303010204,"Kabingo",272,292,564,3,303,30301,3030102
303010205,"Kinyamuhanga",231,287,518,3,303,30301,3030102
303010206,"Muremure",177,217,394,3,303,30301,3030102
303010301,"Bereshi",258,307,565,3,303,30301,3030103
303010302,"Bweramana",196,222,418,3,303,30301,3030103
303010303,"Gasizi",308,378,686,3,303,30301,3030103
303010304,"Gitotoma",283,354,637,3,303,30301,3030103
303010305,"Hangari",331,348,679,3,303,30301,3030103
303010306,"Humure",369,459,828,3,303,30301,3030103
303010307,"Kabeza",203,222,425,3,303,30301,3030103
303010308,"Ngando",261,334,595,3,303,30301,3030103
303010401,"Bondi",216,276,492,3,303,30301,3030104
303010402,"Bugeshi",239,266,505,3,303,30301,3030104
303010403,"Gashaka",269,319,588,3,303,30301,3030104
303010404,"Gatovu",578,342,920,3,303,30301,3030104
303010405,"Gihira",255,304,559,3,303,30301,3030104
303010406,"Kabumba",323,312,635,3,303,30301,3030104
303010407,"Mweya",296,352,648,3,303,30301,3030104
303010408,"Ryarukara",137,183,320,3,303,30301,3030104
303010501,"Bigaragara",365,433,798,3,303,30301,3030105
303010502,"Bugeshi",326,357,683,3,303,30301,3030105
303010503,"Kabuhanga",357,370,727,3,303,30301,3030105
303010504,"Kimpongo",295,322,617,3,303,30301,3030105
303010505,"Mburamazi",441,478,919,3,303,30301,3030105
303010506,"Rindiro",209,213,422,3,303,30301,3030105
303010507,"Vuna",329,412,741,3,303,30301,3030105
303010601,"Batikoti",346,401,747,3,303,30301,3030106
303010602,"Bipfura",341,365,706,3,303,30301,3030106
303010603,"Bweza",342,362,704,3,303,30301,3030106
303010604,"Cyumba",261,311,572,3,303,30301,3030106
303010605,"Gaheriheri",273,305,578,3,303,30301,3030106
303010606,"Murangara",245,294,539,3,303,30301,3030106
303010701,"Bihe",241,296,537,3,303,30301,3030107
303010702,"Bunjuri",269,341,610,3,303,30301,3030107
303010703,"Kabarore",276,301,577,3,303,30301,3030107
303010704,"Kitagabwa",340,397,737,3,303,30301,3030107
303010705,"Nyacyonga",289,363,652,3,303,30301,3030107
303010706,"Ryarugamba",325,370,695,3,303,30301,3030107
303020101,"Biziguro",191,228,419,3,303,30302,3030201
303020102,"Bukumu",163,187,350,3,303,30302,3030201
303020103,"Busanganya",262,311,573,3,303,30302,3030201
303020104,"Gakomero",184,223,407,3,303,30302,3030201
303020105,"Kamuyenzi",238,304,542,3,303,30302,3030201
303020106,"Kanondo",275,337,612,3,303,30302,3030201
303020107,"Kanyabijumba",281,265,546,3,303,30302,3030201
303020108,"Nyamyenge",274,331,605,3,303,30302,3030201
303020109,"Nyarubuye",271,353,624,3,303,30302,3030201
303020110,"Nyarusozi",177,223,400,3,303,30302,3030201
303020201,"Bunyogwe",303,367,670,3,303,30302,3030202
303020202,"Gisura",205,232,437,3,303,30302,3030202
303020203,"Kibavu",275,328,603,3,303,30302,3030202
303020204,"Kinyababa",349,375,724,3,303,30302,3030202
303020205,"Kinyandaro",311,364,675,3,303,30302,3030202
303020206,"Kiraro",299,300,599,3,303,30302,3030202
303020207,"Mashinga",253,325,578,3,303,30302,3030202
303020208,"Munanira",324,342,666,3,303,30302,3030202
303020209,"Nyarunembwe",268,335,603,3,303,30302,3030202
303020210,"Rwagare",276,317,593,3,303,30302,3030202
303020301,"Marumba",601,541,1142,3,303,30302,3030203
303020302,"Mubona",220,270,490,3,303,30302,3030203
303020303,"Nyamyumba",300,379,679,3,303,30302,3030203
303020304,"Sabushengo",371,466,837,3,303,30302,3030203
303020401,"Gasenyi",357,393,750,3,303,30302,3030204
303020402,"Kigezi",443,384,827,3,303,30302,3030204
303020403,"Mufumba",313,408,721,3,303,30302,3030204
303020404,"Ruhara",348,398,746,3,303,30302,3030204
303020405,"Rwamigega",327,347,674,3,303,30302,3030204
303020406,"Rwankuba",262,313,575,3,303,30302,3030204
303020501,"Gakuta",279,360,639,3,303,30302,3030205
303020502,"Hanika",229,260,489,3,303,30302,3030205
303020503,"Kamuzamuzi",247,318,565,3,303,30302,3030205
303020504,"Karambi",365,359,724,3,303,30302,3030205
303020505,"Kidadi",212,290,502,3,303,30302,3030205
303020601,"Cyanika",189,247,436,3,303,30302,3030206
303020602,"Kacyiru",188,199,387,3,303,30302,3030206
303020603,"Kamiro",224,298,522,3,303,30302,3030206
303020604,"Kingogo",192,209,401,3,303,30302,3030206
303020605,"Kitagabwa",164,344,508,3,303,30302,3030206
303020606,"Nyarurembo",315,351,666,3,303,30302,3030206
303020701,"Cyamabuye",231,312,543,3,303,30302,3030207
303020702,"Kabagoyi",341,416,757,3,303,30302,3030207
303020703,"Kageyo",303,358,661,3,303,30302,3030207
303020704,"Kambonyi",445,463,908,3,303,30302,3030207
303020705,"Kamivumba",358,439,797,3,303,30302,3030207
303020706,"Kinogo",247,310,557,3,303,30302,3030207
303020707,"Munege",246,303,549,3,303,30302,3030207
303020708,"Rebero",172,186,358,3,303,30302,3030207
303030101,"Bisizi",416,477,893,3,303,30303,3030301
303030102,"Bugu",331,351,682,3,303,30303,3030301
303030103,"Kanembwe",430,306,736,3,303,30303,3030301
303030104,"Rwashungwe",335,427,762,3,303,30303,3030301
303030201,"Butango",308,354,662,3,303,30303,3030302
303030202,"Cyanzarwe",285,287,572,3,303,30303,3030302
303030203,"Gasenyi",258,312,570,3,303,30303,3030302
303030204,"Karangara",302,348,650,3,303,30303,3030302
303030205,"Kiruhura",170,181,351,3,303,30303,3030302
303030206,"Rushura",263,308,571,3,303,30303,3030302
303030301,"Burima",276,314,590,3,303,30303,3030303
303030302,"Gora",393,475,868,3,303,30303,3030303
303030303,"Kabere",367,449,816,3,303,30303,3030303
303030401,"Bushanga",176,205,381,3,303,30303,3030304
303030402,"Kanyentambi",169,228,397,3,303,30303,3030304
303030403,"Kibaya",323,388,711,3,303,30303,3030304
303030404,"Muhororo",188,222,410,3,303,30303,3030304
303030501,"Gashuha",340,391,731,3,303,30303,3030305
303030502,"Makurizo",385,485,870,3,303,30303,3030305
303030503,"Mukingo",329,360,689,3,303,30303,3030305
303030504,"Nyamugari",273,352,625,3,303,30303,3030305
303030505,"Ruhuranda",163,194,357,3,303,30303,3030305
303030601,"Buramazi",296,347,643,3,303,30303,3030306
303030602,"Hanika",254,287,541,3,303,30303,3030306
303030603,"Muti",411,371,782,3,303,30303,3030306
303030604,"Nyakabanda",418,511,929,3,303,30303,3030306
303030605,"Nyakabungo",244,294,538,3,303,30303,3030306
303030701,"Kabirizi",286,306,592,3,303,30303,3030307
303030702,"Karambi",244,257,501,3,303,30303,3030307
303030703,"Kinyamiyaga",233,271,504,3,303,30303,3030307
303030704,"Munaba",400,469,869,3,303,30303,3030307
303030705,"Rukorakore",262,287,549,3,303,30303,3030307
303030801,"Burere",292,353,645,3,303,30303,3030308
303030802,"Kanyamagare",253,285,538,3,303,30303,3030308
303030803,"Kavumu",259,316,575,3,303,30303,3030308
303030804,"Muhuhuri",263,321,584,3,303,30303,3030308
303030805,"Musene",255,305,560,3,303,30303,3030308
303030806,"Nganzo",245,311,556,3,303,30303,3030308
303040101,"Amahoro",3517,588,4105,3,303,30304,3030401
303040102,"Isangano",349,389,738,3,303,30304,3030401
303040103,"Kitagabwa",357,293,650,3,303,30304,3030401
303040104,"Muhabura",528,518,1046,3,303,30304,3030401
303040105,"Murakazaneza",360,293,653,3,303,30304,3030401
303040106,"Murisanga",499,486,985,3,303,30304,3030401
303040107,"Terimbere",398,348,746,3,303,30304,3030401
303040108,"Umunezero",556,469,1025,3,303,30304,3030401
303040109,"Urugwiro",246,222,468,3,303,30304,3030401
303040201,"Amataba",706,418,1124,3,303,30304,3030402
303040202,"Bugoyi",580,553,1133,3,303,30304,3030402
303040203,"Giraneza",418,378,796,3,303,30304,3030402
303040204,"Irakiza",296,262,558,3,303,30304,3030402
303040205,"Isangano",410,404,814,3,303,30304,3030402
303040206,"Ituze",502,477,979,3,303,30304,3030402
303040207,"Kaminuza",576,572,1148,3,303,30304,3030402
303040208,"Nyakabungo",374,354,728,3,303,30304,3030402
303040209,"Ubutabera",476,460,936,3,303,30304,3030402
303040210,"Ubwiza",551,564,1115,3,303,30304,3030402
303040301,"Giponda",593,580,1173,3,303,30304,3030403
303040302,"Igisubizo",397,406,803,3,303,30304,3030403
303040303,"Itangazamakuru",421,382,803,3,303,30304,3030403
303040304,"Karisimbi",305,328,633,3,303,30304,3030403
303040305,"Kivumu",479,437,916,3,303,30304,3030403
303040306,"Muduha",635,571,1206,3,303,30304,3030403
303040307,"Murisanga",360,299,659,3,303,30304,3030403
303040308,"Ubukerarugendo",433,400,833,3,303,30304,3030403
303040309,"Ubumwe",822,573,1395,3,303,30304,3030403
303040310,"Ubutabazi",524,571,1095,3,303,30304,3030403
303040311,"Umurava",422,307,729,3,303,30304,3030403
303040312,"Urumuri",454,457,911,3,303,30304,3030403
303040401,"Abahuje",482,544,1026,3,303,30304,3030404
303040402,"Amajyambere",380,395,775,3,303,30304,3030404
303040403,"Gasutamo",571,592,1163,3,303,30304,3030404
303040404,"Haguruka",417,441,858,3,303,30304,3030404
303040405,"Icyinyambo",529,521,1050,3,303,30304,3030404
303040406,"Ihumure",362,404,766,3,303,30304,3030404
303040407,"Ikaze",473,478,951,3,303,30304,3030404
303040408,"Ikibuga",348,381,729,3,303,30304,3030404
303040409,"Inkurunziza",372,362,734,3,303,30304,3030404
303040410,"Iyobokamana",347,373,720,3,303,30304,3030404
303040411,"Karundo",256,247,503,3,303,30304,3030404
303040412,"Nyarubande",240,255,495,3,303,30304,3030404
303040413,"Rebero",438,439,877,3,303,30304,3030404
303040414,"Uburanga",385,402,787,3,303,30304,3030404
303040415,"Uburezi",384,433,817,3,303,30304,3030404
303040416,"Ubwiyunge",500,507,1007,3,303,30304,3030404
303040417,"Umubano",371,392,763,3,303,30304,3030404
303040418,"Umutekano",263,313,576,3,303,30304,3030404
303040501,"Gacuba",476,413,889,3,303,30304,3030405
303040502,"Gikarani",633,340,973,3,303,30304,3030405
303040503,"Kivu",282,216,498,3,303,30304,3030405
303040504,"Nyabagobe",623,614,1237,3,303,30304,3030405
303040505,"Nyaburanga",332,261,593,3,303,30304,3030405
303040506,"Ubucuruzi",442,309,751,3,303,30304,3030405
303040507,"Urubyiruko",384,351,735,3,303,30304,3030405
303040601,"Gahojo",495,492,987,3,303,30304,3030406
303040602,"Kamayugi",443,427,870,3,303,30304,3030406
303040603,"Kanyarutambi",426,428,854,3,303,30304,3030406
303040604,"Munini",393,383,776,3,303,30304,3030406
303040605,"Rubavu",512,560,1072,3,303,30304,3030406
303040606,"Ruliba",335,380,715,3,303,30304,3030406
303040701,"Bonde",358,384,742,3,303,30304,3030407
303040702,"Dukore",468,454,922,3,303,30304,3030407
303040703,"Ihuriro",429,433,862,3,303,30304,3030407
303040704,"Kabuga",572,565,1137,3,303,30304,3030407
303040705,"Majengo",321,336,657,3,303,30304,3030407
303040706,"Muhato",408,539,947,3,303,30304,3030407
303040707,"Umucyo",643,718,1361,3,303,30304,3030407
303040708,"Umuganda",272,279,551,3,303,30304,3030407
303040709,"Umunyinya",428,454,882,3,303,30304,3030407
303050101,"Bambiro",230,264,494,3,303,30305,3030501
303050102,"Kagarama",290,364,654,3,303,30305,3030501
303050103,"Nyamigogo",313,371,684,3,303,30305,3030501
303050104,"Nyanshundura",277,340,617,3,303,30305,3030501
303050105,"Rukoro",363,400,763,3,303,30305,3030501
303050106,"Rwankomo",327,369,696,3,303,30305,3030501
303050201,"Gahunga",204,203,407,3,303,30305,3030502
303050202,"Mariba",295,325,620,3,303,30305,3030502
303050203,"Mutanda",236,265,501,3,303,30305,3030502
303050204,"Ndongoshori",248,283,531,3,303,30305,3030502
303050301,"Bikuka",224,218,442,3,303,30305,3030503
303050302,"Kabeza",149,129,278,3,303,30305,3030503
303050303,"Kabindi",181,205,386,3,303,30305,3030503
303050304,"Kanama",240,250,490,3,303,30305,3030503
303050305,"Kara",274,324,598,3,303,30305,3030503
303050306,"Mahoko",369,375,744,3,303,30305,3030503
303050307,"Nyagasozi",350,374,724,3,303,30305,3030503
303050308,"Nyamirambo",309,345,654,3,303,30305,3030503
303050309,"Nyamugari",273,338,611,3,303,30305,3030503
303050310,"Nyamuremure",223,313,536,3,303,30305,3030503
303050311,"Rubare",274,305,579,3,303,30305,3030503
303050312,"Shusho",220,318,538,3,303,30305,3030503
303050401,"Kabingo",215,245,460,3,303,30305,3030504
303050402,"Kagano",244,273,517,3,303,30305,3030504
303050403,"Kaje",221,264,485,3,303,30305,3030504
303050404,"Nteranya",217,270,487,3,303,30305,3030504
303050405,"Nyakibande",213,240,453,3,303,30305,3030504
303050406,"Ryamibungo",191,249,440,3,303,30305,3030504
303050501,"Gashasho",214,267,481,3,303,30305,3030505
303050502,"Gatsina",203,218,421,3,303,30305,3030505
303050503,"Nkomane",320,378,698,3,303,30305,3030505
303050504,"Nyabishongo",164,217,381,3,303,30305,3030505
303050505,"Rwanzuki",257,280,537,3,303,30305,3030505
303050601,"Busesa",231,268,499,3,303,30305,3030506
303050602,"Gihurizo",231,289,520,3,303,30305,3030506
303050603,"Kabere",221,263,484,3,303,30305,3030506
303050604,"Kibuga",377,467,844,3,303,30305,3030506
303050605,"Mashyoza",281,270,551,3,303,30305,3030506
303050606,"Muvebwa",219,257,476,3,303,30305,3030506
303050607,"Nyabitunda",207,254,461,3,303,30305,3030506
303050701,"Bwikurure",192,265,457,3,303,30305,3030507
303050702,"Gikomero",284,339,623,3,303,30305,3030507
303050703,"Rugege",380,401,781,3,303,30305,3030507
303050704,"Rugogwe",202,235,437,3,303,30305,3030507
303050705,"Rutagara",276,290,566,3,303,30305,3030507
303050706,"Yungwe",258,312,570,3,303,30305,3030507
303060101,"Giramata",402,468,870,3,303,30306,3030601
303060102,"Kabana",314,394,708,3,303,30306,3030601
303060103,"Mizingo",419,410,829,3,303,30306,3030601
303060104,"Murambi",278,288,566,3,303,30306,3030601
303060201,"Bisesero",389,450,839,3,303,30306,3030602
303060202,"Kirerema",478,529,1007,3,303,30306,3030602
303060203,"Rushasho",603,749,1352,3,303,30306,3030602
303060301,"Kanya",151,192,343,3,303,30306,3030603
303060302,"Muramba",225,270,495,3,303,30306,3030603
303060303,"Rubara",320,382,702,3,303,30306,3030603
303060304,"Tubindi",147,169,316,3,303,30306,3030603
303060401,"Cyivugiza",638,731,1369,3,303,30306,3030604
303060402,"Kabari",802,760,1562,3,303,30306,3030604
303060403,"Nyamikongi",273,381,654,3,303,30306,3030604
303060404,"Rwamikungu",618,739,1357,3,303,30306,3030604
303060501,"Gasizi",499,552,1051,3,303,30306,3030605
303060502,"Mareru",425,499,924,3,303,30306,3030605
303060503,"Mizingo",411,524,935,3,303,30306,3030605
303060504,"Nyamirango",589,657,1246,3,303,30306,3030605
303060601,"Kabere",335,394,729,3,303,30306,3030606
303060602,"Karagarago",147,177,324,3,303,30306,3030606
303060603,"Rugali",259,293,552,3,303,30306,3030606
303070101,"Bihungwe",297,396,693,3,303,30307,3030701
303070102,"Bivumu",415,446,861,3,303,30307,3030701
303070103,"Bunyove",322,410,732,3,303,30307,3030701
303070104,"Mwirima",319,443,762,3,303,30307,3030701
303070105,"Rukeri",423,475,898,3,303,30307,3030701
303070201,"Gahanika",284,293,577,3,303,30307,3030702
303070202,"Mugongo",346,407,753,3,303,30307,3030702
303070203,"Murambi",192,183,375,3,303,30307,3030702
303070204,"Mutura",389,464,853,3,303,30307,3030702
303070205,"Nyamirama",209,266,475,3,303,30307,3030702
303070206,"Rebero",544,441,985,3,303,30307,3030702
303070301,"Gasiza",349,433,782,3,303,30307,3030703
303070302,"Kanombe",260,343,603,3,303,30307,3030703
303070303,"Kanyamitura",309,329,638,3,303,30307,3030703
303070304,"Micinyiro",219,252,471,3,303,30307,3030703
303070305,"Nyagisozi",245,334,579,3,303,30307,3030703
303070306,"Tetero",233,280,513,3,303,30307,3030703
303070401,"Gasumba",423,464,887,3,303,30307,3030704
303070402,"Kiryoha",334,347,681,3,303,30307,3030704
303070403,"Mirindi",464,474,938,3,303,30307,3030704
303070404,"Tamira",421,448,869,3,303,30307,3030704
303070501,"Gaharawe",298,368,666,3,303,30307,3030705
303070502,"Gikuyu",296,338,634,3,303,30307,3030705
303070503,"Gitega",417,488,905,3,303,30307,3030705
303070504,"Karandaryi",367,384,751,3,303,30307,3030705
303070505,"Kinyangwe",195,202,397,3,303,30307,3030705
303070506,"Nyabishongo",446,549,995,3,303,30307,3030705
303070601,"Bihe",415,484,899,3,303,30307,3030706
303070602,"Gahenerezo",323,351,674,3,303,30307,3030706
303070603,"Ndiza",308,378,686,3,303,30307,3030706
303070604,"Rungu",272,343,615,3,303,30307,3030706
303070605,"Rwangara",249,307,556,3,303,30307,3030706
303070701,"Kabunoni",398,476,874,3,303,30307,3030707
303070702,"Muyange",297,337,634,3,303,30307,3030707
303070703,"Nangurubibi",245,308,553,3,303,30307,3030707
303070704,"Nyamugari",406,463,869,3,303,30307,3030707
303080101,"Bweza",273,338,611,3,303,30308,3030801
303080102,"Gisangani",308,341,649,3,303,30308,3030801
303080103,"Kamakinga",264,308,572,3,303,30308,3030801
303080104,"Kibuye",222,293,515,3,303,30308,3030801
303080105,"Kingoma",380,427,807,3,303,30308,3030801
303080106,"Mwumba",238,273,511,3,303,30308,3030801
303080107,"Nyamwishyura",300,342,642,3,303,30308,3030801
303080108,"Runaba",296,381,677,3,303,30308,3030801
303080201,"Kitarimwa",476,553,1029,3,303,30308,3030802
303080202,"Nyabibuye",609,697,1306,3,303,30308,3030802
303080203,"Nyabirezi",299,403,702,3,303,30308,3030802
303080204,"Nyakibande",339,386,725,3,303,30308,3030802
303080205,"Rugerero",264,287,551,3,303,30308,3030802
303080206,"Rushubi",354,418,772,3,303,30308,3030802
303080301,"Kayove",280,263,543,3,303,30308,3030803
303080302,"Kiyovu",471,530,1001,3,303,30308,3030803
303080303,"Muhira",392,424,816,3,303,30308,3030803
303080304,"Nyakabungo",375,385,760,3,303,30308,3030803
303080305,"Rebero",289,324,613,3,303,30308,3030803
303080306,"Rukoro",338,399,737,3,303,30308,3030803
303080401,"Bazirete",353,423,776,3,303,30308,3030804
303080402,"Kivumu",274,371,645,3,303,30308,3030804
303080403,"Makoro",272,363,635,3,303,30308,3030804
303080404,"Nyonirima",264,326,590,3,303,30308,3030804
303080405,"Ruhangiro",344,414,758,3,303,30308,3030804
303080406,"Runyeheri",289,350,639,3,303,30308,3030804
303080407,"Ruvuzananga",213,262,475,3,303,30308,3030804
303090101,"Kaberamo",253,280,533,3,303,30309,3030901
303090102,"Kabuyekera",299,340,639,3,303,30309,3030901
303090103,"Karuvugiro",298,376,674,3,303,30309,3030901
303090104,"Muhingo",263,343,606,3,303,30309,3030901
303090105,"Mutembe",281,308,589,3,303,30309,3030901
303090106,"Nganzo",274,294,568,3,303,30309,3030901
303090107,"Wintwari",330,346,676,3,303,30309,3030901
303090201,"Bugoma",352,400,752,3,303,30309,3030902
303090202,"Buhanga",373,413,786,3,303,30309,3030902
303090203,"Bujenje",196,219,415,3,303,30309,3030902
303090204,"Bushagi",306,337,643,3,303,30309,3030902
303090205,"Buvano",242,312,554,3,303,30309,3030902
303090206,"Gateko",175,219,394,3,303,30309,3030902
303090207,"Kabushongo",446,458,904,3,303,30309,3030902
303090208,"Kanajana",285,308,593,3,303,30309,3030902
303090209,"Kiguri",350,403,753,3,303,30309,3030902
303090301,"Burevu",340,368,708,3,303,30309,3030903
303090302,"Byima",170,278,448,3,303,30309,3030903
303090303,"Gatyazo",278,338,616,3,303,30309,3030903
303090304,"Karambi",344,350,694,3,303,30309,3030903
303090305,"Nyabisusa",278,316,594,3,303,30309,3030903
303090306,"Nyamiko",220,258,478,3,303,30309,3030903
303090307,"Pfunda",370,448,818,3,303,30309,3030903
303090401,"Buhogo",341,421,762,3,303,30309,3030904
303090402,"Bukiro",306,321,627,3,303,30309,3030904
303090403,"Kigufi",431,441,872,3,303,30309,3030904
303090404,"Mukondo",379,392,771,3,303,30309,3030904
303090405,"Nyaruhonga",260,326,586,3,303,30309,3030904
303090406,"Rambo",517,560,1077,3,303,30309,3030904
303090501,"Bugarura",371,379,750,3,303,30309,3030905
303090502,"Busumba",336,349,685,3,303,30309,3030905
303090503,"Cyeya",322,396,718,3,303,30309,3030905
303090504,"Kabakora",313,305,618,3,303,30309,3030905
303090505,"Nyamirambo",264,326,590,3,303,30309,3030905
303090506,"Rebero",231,237,468,3,303,30309,3030905
303090507,"Ruhondo",316,353,669,3,303,30309,3030905
303090508,"Shusho",318,314,632,3,303,30309,3030905
303090601,"Bugasha",289,282,571,3,303,30309,3030906
303090602,"Buharara",280,333,613,3,303,30309,3030906
303090603,"Bunyago",269,331,600,3,303,30309,3030906
303090604,"Burima",399,439,838,3,303,30309,3030906
303090605,"Butotori",441,321,762,3,303,30309,3030906
303090606,"Kabiza",327,367,694,3,303,30309,3030906
303090607,"Kabuyekera",358,371,729,3,303,30309,3030906
303090608,"Remera",282,328,610,3,303,30309,3030906
303090609,"Rurembo",260,241,501,3,303,30309,3030906
303090610,"Rushagara",445,476,921,3,303,30309,3030906
303090611,"Tagaza",341,421,762,3,303,30309,3030906
303100101,"Bahimba",187,200,387,3,303,30310,3031001
303100102,"Buhozi",139,158,297,3,303,30310,3031001
303100103,"Gatuntu",127,165,292,3,303,30310,3031001
303100104,"Kagera",166,198,364,3,303,30310,3031001
303100105,"Kanyiraruhindu",128,134,262,3,303,30310,3031001
303100106,"Ngege",243,318,561,3,303,30310,3031001
303100107,"Rurembo",223,245,468,3,303,30310,3031001
303100201,"Budaha",251,300,551,3,303,30310,3031002
303100202,"Busheru",258,311,569,3,303,30310,3031002
303100203,"Cyima",174,193,367,3,303,30310,3031002
303100204,"Kanyahene",292,329,621,3,303,30310,3031002
303100205,"Murambi",220,258,478,3,303,30310,3031002
303100206,"Ruhanga",186,180,366,3,303,30310,3031002
303100301,"Bahimba",253,304,557,3,303,30310,3031003
303100302,"Burambo",289,309,598,3,303,30310,3031003
303100303,"Gitwa",290,327,617,3,303,30310,3031003
303100304,"Kavumu",220,241,461,3,303,30310,3031003
303100305,"Kinihira",262,328,590,3,303,30310,3031003
303100306,"Kinyendaro",248,304,552,3,303,30310,3031003
303100307,"Shonyi",254,279,533,3,303,30310,3031003
303100401,"Busesa",191,228,419,3,303,30310,3031004
303100402,"Kazabe",168,209,377,3,303,30310,3031004
303100403,"Mwali",243,283,526,3,303,30310,3031004
303100404,"Ndamiye",259,295,554,3,303,30310,3031004
303100405,"Rukore",229,234,463,3,303,30310,3031004
303100406,"Rwandobo",295,349,644,3,303,30310,3031004
303100501,"Buroha",236,269,505,3,303,30310,3031005
303100502,"Busogo",279,334,613,3,303,30310,3031005
303100503,"Byiniro",324,368,692,3,303,30310,3031005
303100504,"Cyungeri",275,297,572,3,303,30310,3031005
303100505,"Kabitongo",133,131,264,3,303,30310,3031005
303100506,"Kanyamisuku",317,351,668,3,303,30310,3031005
303100507,"Kashumba",169,186,355,3,303,30310,3031005
303100508,"Nkora",254,278,532,3,303,30310,3031005
303100509,"Remera",171,224,395,3,303,30310,3031005
303100510,"Tanda",275,301,576,3,303,30310,3031005
303100601,"Birembo",198,243,441,3,303,30310,3031006
303100602,"Gasenyi",195,225,420,3,303,30310,3031006
303100603,"Huye",166,175,341,3,303,30310,3031006
303100604,"Kayanza",318,209,527,3,303,30310,3031006
303100605,"Kiribata",235,245,480,3,303,30310,3031006
303100606,"Kiyove",206,828,1034,3,303,30310,3031006
303100607,"Kiziguro",293,343,636,3,303,30310,3031006
303100608,"Nyakagezi",214,247,461,3,303,30310,3031006
303100609,"Rumbati",173,220,393,3,303,30310,3031006
303100610,"Runandi",267,316,583,3,303,30310,3031006
303100701,"Gahama",250,300,550,3,303,30310,3031007
303100702,"Hanika",490,409,899,3,303,30310,3031007
303100703,"Kanyamatembe",343,331,674,3,303,30310,3031007
303100704,"Keya",257,271,528,3,303,30310,3031007
303100705,"Nombe",202,219,421,3,303,30310,3031007
303100706,"Rambura",219,251,470,3,303,30310,3031007
303100707,"Ruhango",326,344,670,3,303,30310,3031007
303100708,"Terimbere",317,348,665,3,303,30310,3031007
303110101,"Dufatanye",405,458,863,3,303,30311,3031101
303110102,"Gabiro",406,446,852,3,303,30311,3031101
303110103,"Murambi",373,375,748,3,303,30311,3031101
303110201,"Akasengore",254,323,577,3,303,30311,3031102
303110202,"Bubaji",206,336,542,3,303,30311,3031102
303110203,"Gasenyi",474,515,989,3,303,30311,3031102
303110204,"Nyabantu",298,362,660,3,303,30311,3031102
303110205,"Nyamwinshi",333,400,733,3,303,30311,3031102
303110206,"Rwezamenyo",233,273,506,3,303,30311,3031102
303110301,"Buhuru",564,610,1174,3,303,30311,3031103
303110302,"Isangano",424,502,926,3,303,30311,3031103
303110303,"Mikingo",472,540,1012,3,303,30311,3031103
303110304,"Ngugo",659,712,1371,3,303,30311,3031103
303110305,"Rurembo",580,582,1162,3,303,30311,3031103
303110401,"Bambiro",176,222,398,3,303,30311,3031104
303110402,"Bushengo I",183,217,400,3,303,30311,3031104
303110403,"Gafuku",255,282,537,3,303,30311,3031104
303110404,"Mubuga",248,301,549,3,303,30311,3031104
303110405,"Rebero",277,331,608,3,303,30311,3031104
303110501,"Bushengo",229,272,501,3,303,30311,3031105
303110502,"Buzuta",238,284,522,3,303,30311,3031105
303110503,"Bwiru",202,233,435,3,303,30311,3031105
303110504,"Kabere Ii",246,253,499,3,303,30311,3031105
303110505,"Ruvumbu",229,295,524,3,303,30311,3031105
303110506,"Rwangara",322,383,705,3,303,30311,3031105
303110601,"Bugesera",340,413,753,3,303,30311,3031106
303110602,"Gahinga",203,238,441,3,303,30311,3031106
303110603,"Gasayo",278,349,627,3,303,30311,3031106
303110604,"Kabere ",280,346,626,3,303,30311,3031106
303110605,"Kiroji",212,273,485,3,303,30311,3031106
303110701,"Bisizi",534,562,1096,3,303,30311,3031107
303110702,"Isangano",344,418,762,3,303,30311,3031107
303110703,"Karukogo",464,540,1004,3,303,30311,3031107
303110704,"Kitarimwa",254,317,571,3,303,30311,3031107
303110705,"Rutagara",169,194,363,3,303,30311,3031107
303120101,"Buranga",196,211,407,3,303,30312,3031201
303120102,"Gahinga",196,239,435,3,303,30312,3031201
303120103,"Kabeza",132,175,307,3,303,30312,3031201
303120104,"Kanyukiro",123,159,282,3,303,30312,3031201
303120105,"Mukumya",160,184,344,3,303,30312,3031201
303120106,"Nyaruhengeri",284,319,603,3,303,30312,3031201
303120107,"Tagaza",334,371,705,3,303,30312,3031201
303120201,"Gatangare",42,142,184,3,303,30312,3031202
303120202,"Gihira",319,404,723,3,303,30312,3031202
303120203,"Gisa",442,391,833,3,303,30312,3031202
303120204,"Kabashanja",281,301,582,3,303,30312,3031202
303120205,"Kaniga",191,218,409,3,303,30312,3031202
303120206,"Ndobogo",237,279,516,3,303,30312,3031202
303120207,"Rusongati",405,465,870,3,303,30312,3031202
303120208,"Shwemu",922,530,1452,3,303,30312,3031202
303120301,"Amahoro",237,270,507,3,303,30312,3031203
303120302,"Gakoro",210,210,420,3,303,30312,3031203
303120303,"Nkama",246,248,494,3,303,30312,3031203
303120304,"Nyamyiri",329,336,665,3,303,30312,3031203
303120305,"Ruhangiro",371,367,738,3,303,30312,3031203
303120306,"Rukukumbo",319,366,685,3,303,30312,3031203
303120401,"Gatebe I",573,709,1282,3,303,30312,3031204
303120402,"Gatebe Ii",145,167,312,3,303,30312,3031204
303120403,"Gitebe I",424,491,915,3,303,30312,3031204
303120404,"Gitebe Ii",216,258,474,3,303,30312,3031204
303120405,"Kasonga",249,242,491,3,303,30312,3031204
303120406,"Kizi",248,309,557,3,303,30312,3031204
303120407,"Rusamaza",355,409,764,3,303,30312,3031204
303120501,"Kabarora",350,379,729,3,303,30312,3031205
303120502,"Kibaya",499,596,1095,3,303,30312,3031205
303120503,"Nyantomvu",199,235,434,3,303,30312,3031205
303120504,"Nyarurembo",471,564,1035,3,303,30312,3031205
303120505,"Rukingo",404,453,857,3,303,30312,3031205
303120506,"Ruranga",183,252,435,3,303,30312,3031205
303120601,"Busheke",253,319,572,3,303,30312,3031206
303120602,"Butangi",309,351,660,3,303,30312,3031206
303120603,"Butumba",357,413,770,3,303,30312,3031206
303120604,"Kabashara",286,337,623,3,303,30312,3031206
303120605,"Kazika",249,271,520,3,303,30312,3031206
303120606,"Kimina",267,342,609,3,303,30312,3031206
303120607,"Muhingo",124,157,281,3,303,30312,3031206
303120701,"Byima",312,338,650,3,303,30312,3031207
303120702,"Cyanika",451,530,981,3,303,30312,3031207
303120703,"Gashovu",332,349,681,3,303,30312,3031207
303120704,"Gateko",241,248,489,3,303,30312,3031207
303120705,"Kiroji",261,278,539,3,303,30312,3031207
303120706,"Mushoko",338,336,674,3,303,30312,3031207
303120707,"Rebero",291,299,590,3,303,30312,3031207
303120708,"Rohero",216,249,465,3,303,30312,3031207
303120709,"Rucyamo",292,309,601,3,303,30312,3031207
303120710,"Rwaza",240,242,482,3,303,30312,3031207
304010101,"Arusha",381,419,800,3,304,30401,3040101
304010102,"Bukinanyana",428,457,885,3,304,30401,3040101
304010103,"Busasamana",365,470,835,3,304,30401,3040101
304010104,"Ngamba",345,384,729,3,304,30401,3040101
304010105,"Ngandu",269,282,551,3,304,30401,3040101
304010106,"Nyabishunguru",366,376,742,3,304,30401,3040101
304010107,"Nyagihinga",254,261,515,3,304,30401,3040101
304010201,"Buheke",386,448,834,3,304,30401,3040102
304010202,"Gasizi",344,423,767,3,304,30401,3040102
304010203,"Giticyinyoni",390,424,814,3,304,30401,3040102
304010204,"Ngando",251,298,549,3,304,30401,3040102
304010205,"Rusenge",376,439,815,3,304,30401,3040102
304010206,"Vuga",392,439,831,3,304,30401,3040102
304010301,"Bikingi",411,450,861,3,304,30401,3040103
304010302,"Bukinanyana",286,299,585,3,304,30401,3040103
304010303,"Busasamana",324,337,661,3,304,30401,3040103
304010304,"Gasiza",341,452,793,3,304,30401,3040103
304010305,"Gatagara",412,569,981,3,304,30401,3040103
304010306,"Kabaya",444,533,977,3,304,30401,3040103
304010307,"Kazuba",1253,691,1944,3,304,30401,3040103
304010308,"Kijote",487,475,962,3,304,30401,3040103
304010309,"Shaba",199,224,423,3,304,30401,3040103
304010310,"Zihari",316,347,663,3,304,30401,3040103
304010401,"Bweramana",265,289,554,3,304,30401,3040104
304010402,"Kabatezi",331,398,729,3,304,30401,3040104
304010403,"Kabuga",296,337,633,3,304,30401,3040104
304010404,"Kageli",503,507,1010,3,304,30401,3040104
304010405,"Ruhinga",331,415,746,3,304,30401,3040104
304010406,"Rukore",365,405,770,3,304,30401,3040104
304010407,"Rwankuba",404,425,829,3,304,30401,3040104
304010501,"Bihangara",349,358,707,3,304,30401,3040105
304010502,"Kananira",327,374,701,3,304,30401,3040105
304010503,"Kirandaryi",351,389,740,3,304,30401,3040105
304010504,"Murambi",289,301,590,3,304,30401,3040105
304010505,"Rusogo",439,542,981,3,304,30401,3040105
304010601,"Gaturo",547,610,1157,3,304,30401,3040106
304010602,"Kabaya",405,469,874,3,304,30401,3040106
304010603,"Kagano",287,337,624,3,304,30401,3040106
304010604,"Kariyeri",355,385,740,3,304,30401,3040106
304010605,"Kinamba",418,485,903,3,304,30401,3040106
304010606,"Mizingo",438,515,953,3,304,30401,3040106
304010607,"Ngangare",334,388,722,3,304,30401,3040106
304010608,"Nyagafumberi",375,475,850,3,304,30401,3040106
304020101,"Bibanza",236,301,537,3,304,30402,3040201
304020102,"Bugarama",585,635,1220,3,304,30402,3040201
304020103,"Bukinanyana",466,535,1001,3,304,30402,3040201
304020104,"Kageri",530,536,1066,3,304,30402,3040201
304020105,"Karuhirwa",244,252,496,3,304,30402,3040201
304020106,"Kibaya",431,483,914,3,304,30402,3040201
304020107,"Nsakira",559,701,1260,3,304,30402,3040201
304020201,"Kagano",438,513,951,3,304,30402,3040202
304020202,"Kanyaru",293,315,608,3,304,30402,3040202
304020203,"Kanzenze",451,566,1017,3,304,30402,3040202
304020204,"Kinyengagi",619,715,1334,3,304,30402,3040202
304020205,"Mikingo",288,313,601,3,304,30402,3040202
304020206,"Munanira",280,373,653,3,304,30402,3040202
304020207,"Rwanamiza",481,547,1028,3,304,30402,3040202
304020301,"Gitambuko",362,398,760,3,304,30402,3040203
304020302,"Kagaga",344,349,693,3,304,30402,3040203
304020303,"Kibuye",622,671,1293,3,304,30402,3040203
304020304,"Musumba",267,296,563,3,304,30402,3040203
304020305,"Ndorwa",202,243,445,3,304,30402,3040203
304020306,"Runyanja",429,465,894,3,304,30402,3040203
304020401,"Bizu",409,396,805,3,304,30402,3040204
304020402,"Gikombe",283,320,603,3,304,30402,3040204
304020403,"Kamatenge",342,391,733,3,304,30402,3040204
304020404,"Kareba",326,380,706,3,304,30402,3040204
304020405,"Nyacyonga",242,311,553,3,304,30402,3040204
304020406,"Rebero",255,266,521,3,304,30402,3040204
304020407,"Rubare",298,358,656,3,304,30402,3040204
304020501,"Cyamabuye",252,299,551,3,304,30402,3040205
304020502,"Gisozi",346,415,761,3,304,30402,3040205
304020503,"Jenda",310,388,698,3,304,30402,3040205
304020504,"Nteranya",377,438,815,3,304,30402,3040205
304020505,"Nyamutukura",271,380,651,3,304,30402,3040205
304020506,"Rushunguru",356,403,759,3,304,30402,3040205
304020601,"Bihinga",304,337,641,3,304,30402,3040206
304020602,"Gakarara",327,399,726,3,304,30402,3040206
304020603,"Gasesero",272,336,608,3,304,30402,3040206
304020604,"Kajebeshi",316,415,731,3,304,30402,3040206
304020605,"Rega",364,434,798,3,304,30402,3040206
304020606,"Rubare",324,423,747,3,304,30402,3040206
304020607,"Terimbere",346,366,712,3,304,30402,3040206
304030101,"Cyumba",309,420,729,3,304,30403,3040301
304030102,"Gahama",242,305,547,3,304,30403,3040301
304030103,"Gasiza",273,361,634,3,304,30403,3040301
304030104,"Isangano",193,199,392,3,304,30403,3040301
304030105,"Kabingo",185,246,431,3,304,30403,3040301
304030106,"Kanama",263,284,547,3,304,30403,3040301
304030107,"Nyundo",266,296,562,3,304,30403,3040301
304030201,"Gasura",285,275,560,3,304,30403,3040302
304030202,"Gisoro",538,591,1129,3,304,30403,3040302
304030203,"Kagano",284,313,597,3,304,30403,3040302
304030204,"Rwandarugari",240,266,506,3,304,30403,3040302
304030205,"Ryabasenge",260,323,583,3,304,30403,3040302
304030206,"Ryabirumba",254,282,536,3,304,30403,3040302
304030301,"Futi",227,291,518,3,304,30403,3040303
304030302,"Gahanga",287,327,614,3,304,30403,3040303
304030303,"Gikaranka",355,441,796,3,304,30403,3040303
304030304,"Gisizi",286,342,628,3,304,30403,3040303
304030305,"Kagege",166,199,365,3,304,30403,3040303
304030401,"Guriro",240,265,505,3,304,30403,3040304
304030402,"Kabari",403,329,732,3,304,30403,3040304
304030403,"Misegwibiri",232,253,485,3,304,30403,3040304
304030404,"Ngabo",362,346,708,3,304,30403,3040304
304030405,"Nyarusongati",279,330,609,3,304,30403,3040304
304030406,"Ruhunga",253,276,529,3,304,30403,3040304
304030501,"Gasanze",118,144,262,3,304,30403,3040305
304030502,"Kavumu",256,290,546,3,304,30403,3040305
304030503,"Muhare",292,342,634,3,304,30403,3040305
304030504,"Munyege",211,257,468,3,304,30403,3040305
304030505,"Rugerero",202,239,441,3,304,30403,3040305
304030506,"Rushubi",202,228,430,3,304,30403,3040305
304030601,"Bihinga",212,250,462,3,304,30403,3040306
304030602,"Kivumu",358,394,752,3,304,30403,3040306
304030603,"Ntwaro",284,307,591,3,304,30403,3040306
304030604,"Nyamitanzi",286,338,624,3,304,30403,3040306
304030605,"Rubavu",247,311,558,3,304,30403,3040306
304030606,"Rugera",207,246,453,3,304,30403,3040306
304030607,"Ruhongore",186,231,417,3,304,30403,3040306
304030608,"Rutabu",349,408,757,3,304,30403,3040306
304040101,"Batikoti",173,263,436,3,304,30404,3040401
304040102,"Kamuhe",374,428,802,3,304,30404,3040401
304040103,"Rubare",423,507,930,3,304,30404,3040401
304040104,"Sake",200,252,452,3,304,30404,3040401
304040201,"Kabagabo",431,477,908,3,304,30404,3040402
304040202,"Murambi",392,477,869,3,304,30404,3040402
304040203,"Nyabitembo",138,168,306,3,304,30404,3040402
304040301,"Bisukiro",361,437,798,3,304,30404,3040403
304040302,"Kaminuza",377,432,809,3,304,30404,3040403
304040303,"Kinyababa",354,383,737,3,304,30404,3040403
304040304,"Rushubi",292,357,649,3,304,30404,3040403
304040401,"Akabeza",412,403,815,3,304,30404,3040404
304040402,"Akimitoni",382,442,824,3,304,30404,3040404
304040403,"Butaka",180,202,382,3,304,30404,3040404
304040404,"Myuga",394,406,800,3,304,30404,3040404
304040405,"Rugendabari",329,372,701,3,304,30404,3040404
304040501,"Gaharawe",241,278,519,3,304,30404,3040405
304040502,"Kiramira",297,304,601,3,304,30404,3040405
304040503,"Mahurura",185,188,373,3,304,30404,3040405
304040504,"Ngando",214,241,455,3,304,30404,3040405
304040505,"Ruhango",341,389,730,3,304,30404,3040405
304040601,"Karambi",356,413,769,3,304,30404,3040406
304040602,"Kinkware",383,491,874,3,304,30404,3040406
304040603,"Masasa",287,370,657,3,304,30404,3040406
304040604,"Rebero",335,395,730,3,304,30404,3040406
304040605,"Remera",261,293,554,3,304,30404,3040406
304050101,"Gasasa",556,703,1259,3,304,30405,3040501
304050102,"Gatagara",225,268,493,3,304,30405,3040501
304050103,"Gisesa",310,388,698,3,304,30405,3040501
304050104,"Kageshi",246,247,493,3,304,30405,3040501
304050105,"Kagohe",213,244,457,3,304,30405,3040501
304050106,"Rebero",569,624,1193,3,304,30405,3040501
304050107,"Ruhigiro",302,351,653,3,304,30405,3040501
304050201,"Buremera",395,466,861,3,304,30405,3040502
304050202,"Kinyanja",209,261,470,3,304,30405,3040502
304050203,"Matyazo",443,461,904,3,304,30405,3040502
304050204,"Muderi",233,290,523,3,304,30405,3040502
304050205,"Muremure",274,318,592,3,304,30405,3040502
304050206,"Nanga",312,429,741,3,304,30405,3040502
304050207,"Nkomane",182,234,416,3,304,30405,3040502
304050208,"Rubare",282,312,594,3,304,30405,3040502
304050301,"Bikereri",380,465,845,3,304,30405,3040503
304050302,"Budacya",175,199,374,3,304,30405,3040503
304050303,"Gatwe",297,368,665,3,304,30405,3040503
304050304,"Gisunzu",250,262,512,3,304,30405,3040503
304050305,"Karambi",213,264,477,3,304,30405,3040503
304050306,"Kinanira",256,347,603,3,304,30405,3040503
304050307,"Muvure",164,164,328,3,304,30405,3040503
304050401,"Biseke",294,366,660,3,304,30405,3040504
304050402,"Gifumba",228,289,517,3,304,30405,3040504
304050403,"Kanombe",281,346,627,3,304,30405,3040504
304050404,"Nyagasozi",285,317,602,3,304,30405,3040504
304050405,"Rugarambiro",332,390,722,3,304,30405,3040504
304050406,"Rurambo",264,345,609,3,304,30405,3040504
304050501,"Bukongora",192,252,444,3,304,30405,3040505
304050502,"Gakoma",244,319,563,3,304,30405,3040505
304050503,"Gihira",286,333,619,3,304,30405,3040505
304050504,"Karandaryi",195,245,440,3,304,30405,3040505
304050505,"Kivunja",253,291,544,3,304,30405,3040505
304050506,"Muremure",275,299,574,3,304,30405,3040505
304050507,"Mwiyanike",418,383,801,3,304,30405,3040505
304050508,"Nkomane",294,321,615,3,304,30405,3040505
304050509,"Nyaburaro",305,352,657,3,304,30405,3040505
304050601,"Hanika",108,143,251,3,304,30405,3040506
304050602,"Kirwa",336,426,762,3,304,30405,3040506
304050603,"Mashyuza",225,311,536,3,304,30405,3040506
304050604,"Remera",439,530,969,3,304,30405,3040506
304050605,"Ruyebe",306,384,690,3,304,30405,3040506
304050606,"Rwumuyaga",246,287,533,3,304,30405,3040506
304060101,"Gatovu Centre",618,394,1012,3,304,30406,3040601
304060102,"Giharo",191,245,436,3,304,30406,3040601
304060103,"Nyagitaba",307,383,690,3,304,30406,3040601
304060104,"Nyarusekera",157,198,355,3,304,30406,3040601
304060105,"Rubande",182,226,408,3,304,30406,3040601
304060201,"Bikingi",225,270,495,3,304,30406,3040602
304060202,"Gakoro",336,383,719,3,304,30406,3040602
304060203,"Gasura",232,290,522,3,304,30406,3040602
304060204,"Gasyo",287,366,653,3,304,30406,3040602
304060205,"Kansesa",217,266,483,3,304,30406,3040602
304060301,"Dehero",336,412,748,3,304,30406,3040603
304060302,"Hungiro",190,235,425,3,304,30406,3040603
304060303,"Nyanshundura",470,581,1051,3,304,30406,3040603
304060304,"Rutoyi",225,296,521,3,304,30406,3040603
304060305,"Sinayi",225,282,507,3,304,30406,3040603
304060401,"Kabagundu",405,426,831,3,304,30406,3040604
304060402,"Kariyeri",107,134,241,3,304,30406,3040604
304060403,"Karucuranya",124,148,272,3,304,30406,3040604
304060404,"Kiyumba",271,289,560,3,304,30406,3040604
304060405,"Kizunga",261,289,550,3,304,30406,3040604
304060501,"Kamanga",298,366,664,3,304,30406,3040605
304060502,"Kankima",430,526,956,3,304,30406,3040605
304060503,"Kimpundu",223,289,512,3,304,30406,3040605
304060504,"Mugogo",250,279,529,3,304,30406,3040605
304060601,"Gahwege",216,243,459,3,304,30406,3040606
304060602,"Gasenyi",236,265,501,3,304,30406,3040606
304060603,"Humiro",211,236,447,3,304,30406,3040606
304060604,"Kabashumba Centre",182,208,390,3,304,30406,3040606
304060605,"Kadaterurwa",277,300,577,3,304,30406,3040606
304060606,"Kirwa",257,292,549,3,304,30406,3040606
304060607,"Rwamikeri",192,215,407,3,304,30406,3040606
304070101,"Kamiro",515,524,1039,3,304,30407,3040701
304070102,"Sasangabo",365,438,803,3,304,30407,3040701
304070201,"Biriba",350,434,784,3,304,30407,3040702
304070202,"Butondwe",293,336,629,3,304,30407,3040702
304070203,"Gisenyi",668,841,1509,3,304,30407,3040702
304070204,"Hesha",310,412,722,3,304,30407,3040702
304070205,"Nyirabashenyi",405,491,896,3,304,30407,3040702
304070206,"Rwanyirangeni",503,577,1080,3,304,30407,3040702
304070301,"Kabere",339,402,741,3,304,30407,3040703
304070302,"Kanyove",435,507,942,3,304,30407,3040703
304070303,"Musumba",314,433,747,3,304,30407,3040703
304070304,"Rwaseka",344,429,773,3,304,30407,3040703
304070401,"Cyivugiza",447,491,938,3,304,30407,3040704
304070402,"Gashonero",373,440,813,3,304,30407,3040704
304070403,"Kaburende",482,505,987,3,304,30407,3040704
304070404,"Karandaryi",313,353,666,3,304,30407,3040704
304070405,"Kinyababa",270,330,600,3,304,30407,3040704
304070406,"Rwamikeri",302,349,651,3,304,30407,3040704
304070501,"Cyinkenke",324,349,673,3,304,30407,3040705
304070502,"Cyumukenke",404,482,886,3,304,30407,3040705
304070503,"Kamenyo",367,486,853,3,304,30407,3040705
304070504,"Karama",344,340,684,3,304,30407,3040705
304070505,"Kazibake",346,404,750,3,304,30407,3040705
304070506,"Kazuba",427,543,970,3,304,30407,3040705
304070601,"Bihinga",298,315,613,3,304,30407,3040706
304070602,"Gatare",312,387,699,3,304,30407,3040706
304070603,"Gitete",267,322,589,3,304,30407,3040706
304070604,"Pfunda",264,273,537,3,304,30407,3040706
304070605,"Rugaragara",271,298,569,3,304,30407,3040706
304070701,"Kabyaza",454,535,989,3,304,30407,3040707
304070702,"Kibugazi",396,476,872,3,304,30407,3040707
304070703,"Maziba",211,220,431,3,304,30407,3040707
304070704,"Rugarambiro",254,305,559,3,304,30407,3040707
304070705,"Rutovu",318,380,698,3,304,30407,3040707
304070706,"Rwankeri",714,831,1545,3,304,30407,3040707
304080101,"Kabyuma",188,226,414,3,304,30408,3040801
304080102,"Kinihira",378,452,830,3,304,30408,3040801
304080103,"Kinyasenge",235,247,482,3,304,30408,3040801
304080104,"Munini",293,342,635,3,304,30408,3040801
304080105,"Muremure",412,511,923,3,304,30408,3040801
304080201,"Bunywero",258,333,591,3,304,30408,3040802
304080202,"Gakamba",392,414,806,3,304,30408,3040802
304080203,"Gora",258,269,527,3,304,30408,3040802
304080204,"Kamazage",159,188,347,3,304,30408,3040802
304080205,"Kiruma",191,211,402,3,304,30408,3040802
304080206,"Kivugiza",172,197,369,3,304,30408,3040802
304080207,"Migongo",186,194,380,3,304,30408,3040802
304080208,"Ruganda",195,245,440,3,304,30408,3040802
304080209,"Rurambo",151,176,327,3,304,30408,3040802
304080301,"Gitebe",226,265,491,3,304,30408,3040803
304080302,"Kayanza",301,309,610,3,304,30408,3040803
304080303,"Kivuruga",255,322,577,3,304,30408,3040803
304080304,"Mucundebo",230,277,507,3,304,30408,3040803
304080305,"Musaraba",222,231,453,3,304,30408,3040803
304080306,"Nyankukuma",266,326,592,3,304,30408,3040803
304080307,"Ryamwana",280,297,577,3,304,30408,3040803
304080308,"Ryanyirandaba",247,292,539,3,304,30408,3040803
304080401,"Kamajanga",395,472,867,3,304,30408,3040804
304080402,"Kigusa",300,315,615,3,304,30408,3040804
304080403,"Kinaba",409,426,835,3,304,30408,3040804
304080404,"Mabare",334,389,723,3,304,30408,3040804
304080405,"Muremure",328,370,698,3,304,30408,3040804
304080501,"Bambiro",334,385,719,3,304,30408,3040805
304080502,"Kanwiri",157,150,307,3,304,30408,3040805
304080503,"Muyange",230,288,518,3,304,30408,3040805
304080504,"Nyamasheke",282,319,601,3,304,30408,3040805
304080505,"Rubare",306,377,683,3,304,30408,3040805
304080601,"Gasura",367,439,806,3,304,30408,3040806
304080602,"Karambi",331,419,750,3,304,30408,3040806
304080603,"Musenyi",321,385,706,3,304,30408,3040806
304080604,"Ntango",276,296,572,3,304,30408,3040806
304080605,"Rurembo",347,362,709,3,304,30408,3040806
304080606,"Rwandarugari",309,375,684,3,304,30408,3040806
304090101,"Birembo",382,448,830,3,304,30409,3040901
304090102,"Cyugi",305,354,659,3,304,30409,3040901
304090103,"Kimisebeya",244,247,491,3,304,30409,3040901
304090104,"Mariba",243,307,550,3,304,30409,3040901
304090105,"Munyangari",301,352,653,3,304,30409,3040901
304090106,"Nyavuvu",287,338,625,3,304,30409,3040901
304090107,"Rugarambiro",247,320,567,3,304,30409,3040901
304090201,"Cyanika",360,455,815,3,304,30409,3040902
304090202,"Kimisebeya",315,346,661,3,304,30409,3040902
304090203,"Nteko",345,441,786,3,304,30409,3040902
304090204,"Nyanguragura",328,402,730,3,304,30409,3040902
304090205,"Raro",328,452,780,3,304,30409,3040902
304090206,"Rusogo",333,401,734,3,304,30409,3040902
304090301,"Bugonde",546,608,1154,3,304,30409,3040903
304090302,"Gatare",238,292,530,3,304,30409,3040903
304090303,"Kabeza",584,542,1126,3,304,30409,3040903
304090304,"Karambi",262,302,564,3,304,30409,3040903
304090305,"Kinihira",226,291,517,3,304,30409,3040903
304090306,"Nyampuhu",265,302,567,3,304,30409,3040903
304090307,"Rwenzo",266,329,595,3,304,30409,3040903
304090401,"Bihangara",206,223,429,3,304,30409,3040904
304090402,"Bukinanyana",244,267,511,3,304,30409,3040904
304090403,"Kiraza",393,462,855,3,304,30409,3040904
304090404,"Murambi",282,334,616,3,304,30409,3040904
304090405,"Nyiragikokora",467,537,1004,3,304,30409,3040904
304090406,"Rusekera",263,317,580,3,304,30409,3040904
304090407,"Rutazigurwa",437,462,899,3,304,30409,3040904
304090408,"Sukiro",290,301,591,3,304,30409,3040904
304090501,"Gasiza",707,630,1337,3,304,30409,3040905
304090502,"Kamifuho",267,294,561,3,304,30409,3040905
304090503,"Myumba",194,244,438,3,304,30409,3040905
304090504,"Nama",890,810,1700,3,304,30409,3040905
304090505,"Ntagihendo",297,377,674,3,304,30409,3040905
304090506,"Nyempanika",87,132,219,3,304,30409,3040905
304090507,"Rusereka",360,438,798,3,304,30409,3040905
304090508,"Rwinkingi",274,313,587,3,304,30409,3040905
304090601,"Giharo",234,303,537,3,304,30409,3040906
304090602,"Kamiro",335,408,743,3,304,30409,3040906
304090603,"Kibumbiro",211,255,466,3,304,30409,3040906
304090604,"Muturagara",162,234,396,3,304,30409,3040906
304090605,"Muturirwa",338,426,764,3,304,30409,3040906
304090606,"Nkomane",452,542,994,3,304,30409,3040906
304100101,"Bweru",331,394,725,3,304,30410,3041001
304100102,"Kintore",250,305,555,3,304,30410,3041001
304100103,"Mubuga",254,299,553,3,304,30410,3041001
304100104,"Nyakigezi",380,436,816,3,304,30410,3041001
304100105,"Nyarubingo",257,254,511,3,304,30410,3041001
304100106,"Nyarusange",194,225,419,3,304,30410,3041001
304100201,"Bwumba",165,205,370,3,304,30410,3041002
304100202,"Gasayo",203,276,479,3,304,30410,3041002
304100203,"Gasiza",203,202,405,3,304,30410,3041002
304100204,"Giko",173,205,378,3,304,30410,3041002
304100205,"Kabahendanyi",211,244,455,3,304,30410,3041002
304100206,"Kagano",200,247,447,3,304,30410,3041002
304100207,"Nyagasozi",285,353,638,3,304,30410,3041002
304100208,"Rwangege",155,189,344,3,304,30410,3041002
304100209,"Tetero",176,244,420,3,304,30410,3041002
304100301,"Buhete",229,289,518,3,304,30410,3041003
304100302,"Gitotsi",311,344,655,3,304,30410,3041003
304100303,"Kabyaza",327,377,704,3,304,30410,3041003
304100304,"Muhare",388,451,839,3,304,30410,3041003
304100305,"Munyinya",247,282,529,3,304,30410,3041003
304100306,"Musenyi",257,302,559,3,304,30410,3041003
304100307,"Nganzo",193,198,391,3,304,30410,3041003
304100401,"Gatyazo",276,295,571,3,304,30410,3041004
304100402,"Gisenyi",271,313,584,3,304,30410,3041004
304100403,"Jari",225,250,475,3,304,30410,3041004
304100404,"Kamenyo",143,143,286,3,304,30410,3041004
304100405,"Kibumba",181,248,429,3,304,30410,3041004
304100406,"Kirebe",304,338,642,3,304,30410,3041004
304100407,"Mwambi",278,357,635,3,304,30410,3041004
304100408,"Nyamugari",153,191,344,3,304,30410,3041004
304100501,"Bihe",263,294,557,3,304,30410,3041005
304100502,"Bukango",170,212,382,3,304,30410,3041005
304100503,"Cyasenge",172,212,384,3,304,30410,3041005
304100504,"Gahama",133,158,291,3,304,30410,3041005
304100505,"Gaseke",171,220,391,3,304,30410,3041005
304100506,"Gihuri",190,237,427,3,304,30410,3041005
304100507,"Karambi",317,381,698,3,304,30410,3041005
304100508,"Murama",176,212,388,3,304,30410,3041005
304100601,"Harabana",293,329,622,3,304,30410,3041006
304100602,"Kabuye",248,273,521,3,304,30410,3041006
304100603,"Kingona",215,227,442,3,304,30410,3041006
304100604,"Kiyanza",285,343,628,3,304,30410,3041006
304100605,"Mucaca",378,443,821,3,304,30410,3041006
304100606,"Murengeri",258,340,598,3,304,30410,3041006
304100607,"Nyakiriba",308,357,665,3,304,30410,3041006
304110101,"Bihira",150,155,305,3,304,30411,3041101
304110102,"Gahoko",180,190,370,3,304,30411,3041101
304110103,"Gitega",228,267,495,3,304,30411,3041101
304110104,"Kamahwera",205,214,419,3,304,30411,3041101
304110105,"Kanama",141,166,307,3,304,30411,3041101
304110106,"Kazuba",241,249,490,3,304,30411,3041101
304110107,"Murungu",226,314,540,3,304,30411,3041101
304110108,"Musenyi",169,206,375,3,304,30411,3041101
304110109,"Rugendabari",203,251,454,3,304,30411,3041101
304110110,"Rwamigega",186,201,387,3,304,30411,3041101
304110201,"Bukangano",109,109,218,3,304,30411,3041102
304110202,"Cyanika",244,273,517,3,304,30411,3041102
304110203,"Cyivugiza",267,302,569,3,304,30411,3041102
304110204,"Cyuve",153,151,304,3,304,30411,3041102
304110205,"Gitega",268,296,564,3,304,30411,3041102
304110206,"Kagusa",96,139,235,3,304,30411,3041102
304110207,"Rurambo",173,182,355,3,304,30411,3041102
304110301,"Cyayu",112,134,246,3,304,30411,3041103
304110302,"Cyinkware",333,364,697,3,304,30411,3041103
304110303,"Cyogo",252,298,550,3,304,30411,3041103
304110304,"Gabiro",251,251,502,3,304,30411,3041103
304110305,"Gasenyi",299,307,606,3,304,30411,3041103
304110306,"Karuhara",162,173,335,3,304,30411,3041103
304110307,"Kinaba",245,309,554,3,304,30411,3041103
304110308,"Nturo",151,169,320,3,304,30411,3041103
304110309,"Nturoy Inkoko",149,162,311,3,304,30411,3041103
304110401,"Bugeshi",172,203,375,3,304,30411,3041104
304110402,"Gahondo",162,210,372,3,304,30411,3041104
304110403,"Gisoro",149,195,344,3,304,30411,3041104
304110404,"Kabyaza",379,414,793,3,304,30411,3041104
304110405,"Karambi",221,263,484,3,304,30411,3041104
304110406,"Karuhindu",160,173,333,3,304,30411,3041104
304110407,"Kidomo",203,190,393,3,304,30411,3041104
304110408,"Mpinga",321,330,651,3,304,30411,3041104
304110409,"Muremure",237,305,542,3,304,30411,3041104
304110410,"Nyarukangaga",204,205,409,3,304,30411,3041104
304110411,"Rubavu",170,172,342,3,304,30411,3041104
304110412,"Rubona I",182,229,411,3,304,30411,3041104
304110501,"Busenge",210,257,467,3,304,30411,3041105
304110502,"Kamugarura",196,241,437,3,304,30411,3041105
304110503,"Karukungu",119,146,265,3,304,30411,3041105
304110504,"Murama",123,143,266,3,304,30411,3041105
304110505,"Mwana",284,322,606,3,304,30411,3041105
304110506,"Nemba",189,211,400,3,304,30411,3041105
304110507,"Nyagahangara",240,254,494,3,304,30411,3041105
304110601,"Gatobo",154,180,334,3,304,30411,3041106
304110602,"Gifunzo",111,131,242,3,304,30411,3041106
304110603,"Kabutozi",293,340,633,3,304,30411,3041106
304110604,"Kamenyo I",118,119,237,3,304,30411,3041106
304110605,"Kamenyo Ii",127,155,282,3,304,30411,3041106
304110606,"Muhungwe",114,152,266,3,304,30411,3041106
304110607,"Murama",157,192,349,3,304,30411,3041106
304110608,"Musekera",187,191,378,3,304,30411,3041106
304110609,"Musenyi",162,160,322,3,304,30411,3041106
304110610,"Musezero",198,246,444,3,304,30411,3041106
304110611,"Muturagara",146,174,320,3,304,30411,3041106
304110612,"Rubona Ii",147,203,350,3,304,30411,3041106
304110613,"Rugarambiro",176,167,343,3,304,30411,3041106
304110614,"Rugote",98,121,219,3,304,30411,3041106
304110615,"Rwanika",246,263,509,3,304,30411,3041106
304110616,"Tubuye",190,235,425,3,304,30411,3041106
304120101,"Bihembe",284,322,606,3,304,30412,3041201
304120102,"Cyinyana",283,326,609,3,304,30412,3041201
304120103,"Kabuga",268,332,600,3,304,30412,3041201
304120104,"Mugwato",382,347,729,3,304,30412,3041201
304120105,"Murikwa",244,356,600,3,304,30412,3041201
304120201,"Kamahoro",241,288,529,3,304,30412,3041202
304120202,"Kazirankara",302,397,699,3,304,30412,3041202
304120203,"Kibuye",350,377,727,3,304,30412,3041202
304120204,"Kigabiro",223,305,528,3,304,30412,3041202
304120205,"Mataba",280,345,625,3,304,30412,3041202
304120206,"Rubaba",199,252,451,3,304,30412,3041202
304120301,"Kabagabo",296,358,654,3,304,30412,3041203
304120302,"Kabuguzo",363,390,753,3,304,30412,3041203
304120303,"Mabare",162,198,360,3,304,30412,3041203
304120304,"Munanira",224,264,488,3,304,30412,3041203
304120305,"Remera",246,268,514,3,304,30412,3041203
304120401,"Gacurabwenge",271,308,579,3,304,30412,3041204
304120402,"Kagongo",765,556,1321,3,304,30412,3041204
304120403,"Mukaka",389,450,839,3,304,30412,3041204
304120404,"Rwabahungu",216,281,497,3,304,30412,3041204
304120405,"Vunga",361,368,729,3,304,30412,3041204
304120501,"Kaziba",261,307,568,3,304,30412,3041205
304120502,"Kidandari",343,375,718,3,304,30412,3041205
304120503,"Murambi",279,319,598,3,304,30412,3041205
304120504,"Ntende",238,290,528,3,304,30412,3041205
304120601,"Gitega",357,444,801,3,304,30412,3041206
304120602,"Kabuga",300,327,627,3,304,30412,3041206
304120603,"Karambi",296,346,642,3,304,30412,3041206
304120604,"Kirwa",226,236,462,3,304,30412,3041206
304120605,"Kiyovu",380,470,850,3,304,30412,3041206
304120606,"Rutoyi",271,303,574,3,304,30412,3041206
305010101,"Gasura",330,412,742,3,305,30501,3050101
305010102,"Kirwa",506,578,1084,3,305,30501,3050101
305010103,"Nkuri",290,333,623,3,305,30501,3050101
305010104,"Rutembo",376,420,796,3,305,30501,3050101
305010105,"Rutoyi",276,328,604,3,305,30501,3050101
305010201,"Bushyogero",274,291,565,3,305,30501,3050102
305010202,"Cyahafi",227,245,472,3,305,30501,3050102
305010203,"Kamina",341,402,743,3,305,30501,3050102
305010204,"Rushubi",248,269,517,3,305,30501,3050102
305010301,"Gasasa",523,592,1115,3,305,30501,3050103
305010302,"Gitonde",345,377,722,3,305,30501,3050103
305010303,"Rugeshi",491,603,1094,3,305,30501,3050103
305010304,"Rukeri",773,903,1676,3,305,30501,3050103
305010305,"Rwamakara",377,462,839,3,305,30501,3050103
305010401,"Bereshi",408,473,881,3,305,30501,3050104
305010402,"Gitarama",322,370,692,3,305,30501,3050104
305010403,"Kurushishi",263,325,588,3,305,30501,3050104
305010404,"Mukingi",481,530,1011,3,305,30501,3050104
305010405,"Nyakarambi",334,346,680,3,305,30501,3050104
305010501,"Kabirizi",313,330,643,3,305,30501,3050105
305010502,"Kiregamazi",339,395,734,3,305,30501,3050105
305010503,"Mwiha",272,333,605,3,305,30501,3050105
305010504,"Nyabitare",275,340,615,3,305,30501,3050105
305020101,"Birambo",574,472,1046,3,305,30502,3050201
305020102,"Mpara",447,533,980,3,305,30502,3050201
305020103,"Musagara",304,349,653,3,305,30502,3050201
305020104,"Nyakagezi",293,354,647,3,305,30502,3050201
305020105,"Ruvumu",427,471,898,3,305,30502,3050201
305020106,"Rwasare",348,423,771,3,305,30502,3050201
305020201,"Gasave",340,444,784,3,305,30502,3050202
305020202,"Gatongo",246,324,570,3,305,30502,3050202
305020203,"Gatsibo",238,284,522,3,305,30502,3050202
305020204,"Gatwa",196,214,410,3,305,30502,3050202
305020205,"Kimirama",240,320,560,3,305,30502,3050202
305020206,"Rutabataba",255,323,578,3,305,30502,3050202
305020207,"Shyogi",256,288,544,3,305,30502,3050202
305020301,"Byimana",172,184,356,3,305,30502,3050203
305020302,"Gasave",278,364,642,3,305,30502,3050203
305020303,"Karehe",239,356,595,3,305,30502,3050203
305020304,"Kavumu",287,301,588,3,305,30502,3050203
305020305,"Nsyabire",273,339,612,3,305,30502,3050203
305020306,"Nyenyeri",163,184,347,3,305,30502,3050203
305020401,"Gahinga",328,380,708,3,305,30502,3050204
305020402,"Gitega",263,298,561,3,305,30502,3050204
305020403,"Kabarore",195,251,446,3,305,30502,3050204
305020404,"Karehe",274,324,598,3,305,30502,3050204
305020405,"Kimisagara",332,423,755,3,305,30502,3050204
305020406,"Nteko",238,261,499,3,305,30502,3050204
305020407,"Rugara",280,346,626,3,305,30502,3050204
305020501,"Butare",270,321,591,3,305,30502,3050205
305020502,"Gasagara",335,375,710,3,305,30502,3050205
305020503,"Jimbu",284,343,627,3,305,30502,3050205
305020504,"Kabeza",288,330,618,3,305,30502,3050205
305020505,"Kadehero",243,299,542,3,305,30502,3050205
305020506,"Kamina",319,277,596,3,305,30502,3050205
305020601,"Kagarama",261,280,541,3,305,30502,3050206
305020602,"Mataba",151,174,325,3,305,30502,3050206
305020603,"Mukaragata",329,390,719,3,305,30502,3050206
305020604,"Rusumo",470,424,894,3,305,30502,3050206
305030101,"Buyungu",362,494,856,3,305,30503,3050301
305030102,"Kigarama",439,513,952,3,305,30503,3050301
305030103,"Muhororo",389,506,895,3,305,30503,3050301
305030104,"Nyagasozi",306,385,691,3,305,30503,3050301
305030201,"Cyahafi",171,191,362,3,305,30503,3050302
305030202,"Gapfura",276,329,605,3,305,30503,3050302
305030203,"Gasharu",250,330,580,3,305,30503,3050302
305030204,"Gasovu",299,383,682,3,305,30503,3050302
305030205,"Huriro",319,399,718,3,305,30503,3050302
305030206,"Kabenge",178,193,371,3,305,30503,3050302
305030207,"Kagarama",345,331,676,3,305,30503,3050302
305030208,"Rutsiro",227,263,490,3,305,30503,3050302
305030209,"Sereri",121,151,272,3,305,30503,3050302
305030301,"Bwoga",480,534,1014,3,305,30503,3050303
305030302,"Kamana",331,413,744,3,305,30503,3050303
305030303,"Rugari",398,467,865,3,305,30503,3050303
305030304,"Rugeshi",265,313,578,3,305,30503,3050303
305030401,"Kagugu",298,367,665,3,305,30503,3050304
305030402,"Karambo",359,540,899,3,305,30503,3050304
305030403,"Kiribata",320,361,681,3,305,30503,3050304
305030404,"Munyegera",350,394,744,3,305,30503,3050304
305030405,"Muvugangoma",290,352,642,3,305,30503,3050304
305030406,"Rugarika",331,367,698,3,305,30503,3050304
305030501,"Kabuga",337,411,748,3,305,30503,3050305
305030502,"Kamonyi",405,449,854,3,305,30503,3050305
305030503,"Mituga",371,493,864,3,305,30503,3050305
305030504,"Mukoni",425,522,947,3,305,30503,3050305
305030601,"Marembo",482,582,1064,3,305,30503,3050306
305030602,"Murambi",338,472,810,3,305,30503,3050306
305030603,"Rugarambiro",308,408,716,3,305,30503,3050306
305030604,"Rwamiko",285,587,872,3,305,30503,3050306
305040101,"Gitaba",322,426,748,3,305,30504,3050401
305040102,"Kabarenzi",358,434,792,3,305,30504,3050401
305040103,"Kabere",387,435,822,3,305,30504,3050401
305040104,"Kabuganza",299,391,690,3,305,30504,3050401
305040105,"Kabusizi",286,372,658,3,305,30504,3050401
305040106,"Kinyamiyaga",367,446,813,3,305,30504,3050401
305040201,"Mbandari",333,495,828,3,305,30504,3050402
305040202,"Mitabo",216,249,465,3,305,30504,3050402
305040203,"Mizingo",404,451,855,3,305,30504,3050402
305040204,"Muturagara",303,381,684,3,305,30504,3050402
305040205,"Nyamugari",373,420,793,3,305,30504,3050402
305040206,"Nyamweru",331,403,734,3,305,30504,3050402
305040207,"Rugari",337,372,709,3,305,30504,3050402
305040301,"Bitare",373,357,730,3,305,30504,3050403
305040302,"Kimisagara",419,473,892,3,305,30504,3050403
305040303,"Kiyovu",568,582,1150,3,305,30504,3050403
305040304,"Migongo",379,404,783,3,305,30504,3050403
305040305,"Nyanza",417,476,893,3,305,30504,3050403
305040306,"Rebero",286,271,557,3,305,30504,3050403
305040307,"Rurembo",470,495,965,3,305,30504,3050403
305040308,"Rwantozi",364,419,783,3,305,30504,3050403
305040401,"Bukonde",388,434,822,3,305,30504,3050404
305040402,"Butare",304,372,676,3,305,30504,3050404
305040403,"Kabeza",359,405,764,3,305,30504,3050404
305040404,"Karambi",317,376,693,3,305,30504,3050404
305040405,"Merabuye",260,302,562,3,305,30504,3050404
305040406,"Nyabarinda",320,370,690,3,305,30504,3050404
305040407,"Rubambiro",357,433,790,3,305,30504,3050404
305040501,"Gisebeya",396,487,883,3,305,30504,3050405
305040502,"Gitumba",352,428,780,3,305,30504,3050405
305040503,"Hanika",388,444,832,3,305,30504,3050405
305040504,"Ngoma",301,412,713,3,305,30504,3050405
305040505,"Nyamugeyo",416,477,893,3,305,30504,3050405
305040506,"Rukorati",281,402,683,3,305,30504,3050405
305040507,"Rutoyi",306,359,665,3,305,30504,3050405
305040601,"Bukonde",284,361,645,3,305,30504,3050406
305040602,"Gashyitsi",327,372,699,3,305,30504,3050406
305040603,"Kabasare",329,350,679,3,305,30504,3050406
305040604,"Kimiramba",293,372,665,3,305,30504,3050406
305040605,"Kirwa",327,383,710,3,305,30504,3050406
305040606,"Nyamugari",332,407,739,3,305,30504,3050406
305040607,"Nyasenge",291,341,632,3,305,30504,3050406
305050101,"Cyungo",343,416,759,3,305,30505,3050501
305050102,"Kantara",346,382,728,3,305,30505,3050501
305050103,"Kariha",444,528,972,3,305,30505,3050501
305050104,"Mukaka",455,519,974,3,305,30505,3050501
305050105,"Ruganda",521,675,1196,3,305,30505,3050501
305050201,"Gatovu",416,534,950,3,305,30505,3050502
305050202,"Gihonga",354,440,794,3,305,30505,3050502
305050203,"Kabagari",431,518,949,3,305,30505,3050502
305050204,"Nyaruzenga",248,294,542,3,305,30505,3050502
305050301,"Gaseke",422,438,860,3,305,30505,3050503
305050302,"Gitongo",301,295,596,3,305,30505,3050503
305050303,"Kabuhake",321,388,709,3,305,30505,3050503
305050304,"Nyamatanga",357,417,774,3,305,30505,3050503
305050305,"Rusenyi",358,391,749,3,305,30505,3050503
305050401,"Gashinge",335,382,717,3,305,30505,3050504
305050402,"Kabyaza",339,407,746,3,305,30505,3050504
305050403,"Murangara",406,462,868,3,305,30505,3050504
305050404,"Rurambo",534,583,1117,3,305,30505,3050504
305050501,"Bereshi",392,470,862,3,305,30505,3050505
305050502,"Kabuga",289,354,643,3,305,30505,3050505
305050503,"Kagarama",324,389,713,3,305,30505,3050505
305050504,"Kibanda",224,268,492,3,305,30505,3050505
305050505,"Nyamutuku",228,251,479,3,305,30505,3050505
305050601,"Gaseke",333,387,720,3,305,30505,3050506
305050602,"Gasiza",334,400,734,3,305,30505,3050506
305050603,"Giseke",335,383,718,3,305,30505,3050506
305050604,"Mubuga",505,584,1089,3,305,30505,3050506
305060101,"Buhuma",522,571,1093,3,305,30506,3050601
305060102,"Gashaki",537,559,1096,3,305,30506,3050601
305060103,"Kantobo",286,320,606,3,305,30506,3050601
305060104,"Nyabitsina",359,460,819,3,305,30506,3050601
305060105,"Rwanamiza",197,241,438,3,305,30506,3050601
305060201,"Biraro",311,376,687,3,305,30506,3050602
305060202,"Karambi",324,330,654,3,305,30506,3050602
305060203,"Kaziba",292,345,637,3,305,30506,3050602
305060204,"Nyamugari",286,332,618,3,305,30506,3050602
305060205,"Nyarukara",333,411,744,3,305,30506,3050602
305060301,"Cyasenge",320,372,692,3,305,30506,3050603
305060302,"Gasibya",325,337,662,3,305,30506,3050603
305060303,"Ntebeyinuma",381,407,788,3,305,30506,3050603
305060304,"Nyaramba",361,449,810,3,305,30506,3050603
305060305,"Ruhurura",257,333,590,3,305,30506,3050603
305060401,"Gatovu",397,443,840,3,305,30506,3050604
305060402,"Kabere",263,301,564,3,305,30506,3050604
305060403,"Karambo",423,540,963,3,305,30506,3050604
305060404,"Murimba",470,534,1004,3,305,30506,3050604
305060405,"Nyabubanda",404,499,903,3,305,30506,3050604
305060501,"Cyuzi",365,445,810,3,305,30506,3050605
305060502,"Gasumo",318,389,707,3,305,30506,3050605
305060503,"Kabeza",550,672,1222,3,305,30506,3050605
305060504,"Karambi",315,408,723,3,305,30506,3050605
305060505,"Mwiyanike",406,440,846,3,305,30506,3050605
305060601,"Bereshi",734,898,1632,3,305,30506,3050606
305060602,"Gatsibo",533,633,1166,3,305,30506,3050606
305060603,"Kasumo",482,664,1146,3,305,30506,3050606
305060604,"Mizingo",510,600,1110,3,305,30506,3050606
305060605,"Ruherahere",457,511,968,3,305,30506,3050606
305070101,"Busoro",450,541,991,3,305,30507,3050701
305070102,"Kabuye",425,535,960,3,305,30507,3050701
305070103,"Kaseke",620,697,1317,3,305,30507,3050701
305070104,"Kavumu",577,680,1257,3,305,30507,3050701
305070105,"Nyagisozi",450,515,965,3,305,30507,3050701
305070201,"Barama",338,444,782,3,305,30507,3050702
305070202,"Gahanda",301,378,679,3,305,30507,3050702
305070203,"Gasayo",298,377,675,3,305,30507,3050702
305070204,"Gataka",384,510,894,3,305,30507,3050702
305070205,"Kabara",446,516,962,3,305,30507,3050702
305070206,"Rwankenke",349,470,819,3,305,30507,3050702
305070301,"Gako",264,312,576,3,305,30507,3050703
305070302,"Gitega",302,327,629,3,305,30507,3050703
305070303,"Kamasorori",354,409,763,3,305,30507,3050703
305070304,"Munyinya",443,573,1016,3,305,30507,3050703
305070305,"Mwumba",603,622,1225,3,305,30507,3050703
305070306,"Nyenyeri",408,426,834,3,305,30507,3050703
305070401,"Kabingo",555,688,1243,3,305,30507,3050704
305070402,"Nyakiliba",322,379,701,3,305,30507,3050704
305070403,"Ruhurura",542,620,1162,3,305,30507,3050704
305070404,"Rwamabuye",336,387,723,3,305,30507,3050704
305070405,"Shori",357,426,783,3,305,30507,3050704
305070501,"Butare",835,904,1739,3,305,30507,3050705
305070502,"Nyakibande",521,643,1164,3,305,30507,3050705
305070503,"Rusororo",512,595,1107,3,305,30507,3050705
305070504,"Rwamiko",723,853,1576,3,305,30507,3050705
305080101,"Bugarura",272,306,578,3,305,30508,3050801
305080102,"Burorero",475,539,1014,3,305,30508,3050801
305080103,"Gatomvu",427,488,915,3,305,30508,3050801
305080104,"Ngando",221,266,487,3,305,30508,3050801
305080105,"Nkongora",325,372,697,3,305,30508,3050801
305080106,"Runayu",236,269,505,3,305,30508,3050801
305080201,"Gasiza",357,429,786,3,305,30508,3050802
305080202,"Kabeza",319,359,678,3,305,30508,3050802
305080203,"Kigina",378,463,841,3,305,30508,3050802
305080204,"Nyenyeri",312,386,698,3,305,30508,3050802
305080205,"Rukobora",236,269,505,3,305,30508,3050802
305080206,"Rurandama",160,209,369,3,305,30508,3050802
305080207,"Rwantobotobo",294,323,617,3,305,30508,3050802
305080301,"Byerezo",386,483,869,3,305,30508,3050803
305080302,"Kagano",268,290,558,3,305,30508,3050803
305080303,"Karuhindura",279,265,544,3,305,30508,3050803
305080304,"Kazuba",316,390,706,3,305,30508,3050803
305080305,"Maryoha",381,462,843,3,305,30508,3050803
305080306,"Rubaya",404,369,773,3,305,30508,3050803
305080401,"Gisebeya",350,452,802,3,305,30508,3050804
305080402,"Gisiza",305,384,689,3,305,30508,3050804
305080403,"Gisunzu",239,302,541,3,305,30508,3050804
305080404,"Misemburo",213,242,455,3,305,30508,3050804
305080405,"Murehe",301,343,644,3,305,30508,3050804
305080406,"Ntaruko",263,317,580,3,305,30508,3050804
305080501,"Bugobora",273,340,613,3,305,30508,3050805
305080502,"Gacaca",345,389,734,3,305,30508,3050805
305080503,"Karambi",345,388,733,3,305,30508,3050805
305080504,"Ntendure",382,417,799,3,305,30508,3050805
305080505,"Rucano",305,331,636,3,305,30508,3050805
305080506,"Ruganda",348,436,784,3,305,30508,3050805
305080601,"Bambiro",268,321,589,3,305,30508,3050806
305080602,"Gaseke",315,378,693,3,305,30508,3050806
305080603,"Kabari",287,342,629,3,305,30508,3050806
305080604,"Kamashya",280,346,626,3,305,30508,3050806
305080605,"Mushishiro",226,275,501,3,305,30508,3050806
305080606,"Nyamutoni",191,231,422,3,305,30508,3050806
305080607,"Nyanshundura",322,396,718,3,305,30508,3050806
305080608,"Rukondo",294,402,696,3,305,30508,3050806
305080609,"Rurambo",250,334,584,3,305,30508,3050806
305090101,"Buyenzi",366,353,719,3,305,30509,3050901
305090102,"Gasave",322,375,697,3,305,30509,3050901
305090103,"Musanzubize",333,405,738,3,305,30509,3050901
305090104,"Nyagaseke",211,269,480,3,305,30509,3050901
305090105,"Ruhanga",214,247,461,3,305,30509,3050901
305090201,"Burengo",210,245,455,3,305,30509,3050902
305090202,"Gashonyi",186,250,436,3,305,30509,3050902
305090203,"Gasovu",222,259,481,3,305,30509,3050902
305090204,"Mitsimbi",359,463,822,3,305,30509,3050902
305090205,"Murambi",327,379,706,3,305,30509,3050902
305090206,"Nyabigogoro",261,297,558,3,305,30509,3050902
305090207,"Nyamirama",303,344,647,3,305,30509,3050902
305090301,"Kabyiniro",360,435,795,3,305,30509,3050903
305090302,"Myiha",429,494,923,3,305,30509,3050903
305090303,"Shori",262,306,568,3,305,30509,3050903
305090401,"Butinza",351,400,751,3,305,30509,3050904
305090402,"Kibingo",485,535,1020,3,305,30509,3050904
305090403,"Murambi",338,386,724,3,305,30509,3050904
305090404,"Nganzo",328,396,724,3,305,30509,3050904
305090501,"Buhiro",421,470,891,3,305,30509,3050905
305090502,"Gapfura",463,463,926,3,305,30509,3050905
305090503,"Gisovu",227,265,492,3,305,30509,3050905
305090504,"Kagunga",316,376,692,3,305,30509,3050905
305090505,"Rongi",295,343,638,3,305,30509,3050905
305090506,"Ryabadanga",284,288,572,3,305,30509,3050905
305090601,"Gashyushya",392,454,846,3,305,30509,3050906
305090602,"Kansi",333,393,726,3,305,30509,3050906
305090603,"Mubuga",268,335,603,3,305,30509,3050906
305090604,"Nyaruhondo",432,470,902,3,305,30509,3050906
305090605,"Sanza",242,249,491,3,305,30509,3050906
305100101,"Bijyojyo",279,345,624,3,305,30510,3051001
305100102,"Birima",304,385,689,3,305,30510,3051001
305100103,"Cyajongo",374,444,818,3,305,30510,3051001
305100104,"Gasave",383,436,819,3,305,30510,3051001
305100105,"Kavumu",268,310,578,3,305,30510,3051001
305100106,"Kibuga",292,340,632,3,305,30510,3051001
305100107,"Runyoni",300,380,680,3,305,30510,3051001
305100108,"Rutonde",413,504,917,3,305,30510,3051001
305100201,"Gasharu",281,320,601,3,305,30510,3051002
305100202,"Gituza",316,378,694,3,305,30510,3051002
305100203,"Kamuyobora",404,441,845,3,305,30510,3051002
305100204,"Kinga",263,291,554,3,305,30510,3051002
305100205,"Nganzo",238,267,505,3,305,30510,3051002
305100206,"Ngugu",309,332,641,3,305,30510,3051002
305100207,"Nyamugari",164,174,338,3,305,30510,3051002
305100208,"Rwamikeri",273,324,597,3,305,30510,3051002
305100301,"Gasharu",276,353,629,3,305,30510,3051003
305100302,"Kabuga",243,284,527,3,305,30510,3051003
305100303,"Kandamira",201,233,434,3,305,30510,3051003
305100304,"Masoro",312,392,704,3,305,30510,3051003
305100305,"Ruhanga",310,350,660,3,305,30510,3051003
305100401,"Kamina",458,595,1053,3,305,30510,3051004
305100402,"Kideberi",447,523,970,3,305,30510,3051004
305100403,"Kimirehe",391,462,853,3,305,30510,3051004
305100404,"Kirombozi",367,417,784,3,305,30510,3051004
305100405,"Ruhuha",374,470,844,3,305,30510,3051004
305100406,"Rutambiro",202,246,448,3,305,30510,3051004
305100407,"Rwamateke",256,331,587,3,305,30510,3051004
305100408,"Rwambogo",335,338,673,3,305,30510,3051004
305100501,"Gahunga",268,363,631,3,305,30510,3051005
305100502,"Giseke",272,342,614,3,305,30510,3051005
305100503,"Rugeyo",280,327,607,3,305,30510,3051005
305100504,"Rusebeya",359,406,765,3,305,30510,3051005
305110101,"Cyandago",283,323,606,3,305,30511,3051101
305110102,"Gatare",319,366,685,3,305,30511,3051101
305110103,"Kabeza",327,335,662,3,305,30511,3051101
305110104,"Kabusunzu",372,389,761,3,305,30511,3051101
305110105,"Kanyinya",273,318,591,3,305,30511,3051101
305110106,"Nyabisindu",250,301,551,3,305,30511,3051101
305110107,"Nyamabuye",262,332,594,3,305,30511,3051101
305110108,"Nyarubari",410,483,893,3,305,30511,3051101
305110201,"Butezi",399,464,863,3,305,30511,3051102
305110202,"Cyansi",295,314,609,3,305,30511,3051102
305110203,"Kazabe",188,265,453,3,305,30511,3051102
305110204,"Murambi",394,452,846,3,305,30511,3051102
305110205,"Ngororero",570,668,1238,3,305,30511,3051102
305110301,"Gashinya",425,511,936,3,305,30511,3051103
305110302,"Kabuga",450,549,999,3,305,30511,3051103
305110303,"Mana",223,302,525,3,305,30511,3051103
305110304,"Manogo",232,283,515,3,305,30511,3051103
305110305,"Mpara",469,564,1033,3,305,30511,3051103
305110306,"Nyabisindu",225,282,507,3,305,30511,3051103
305110307,"Nyenyeri",339,381,720,3,305,30511,3051103
305110308,"Ruhuha",306,314,620,3,305,30511,3051103
305110401,"Gatare",229,268,497,3,305,30511,3051104
305110402,"Gihe",288,385,673,3,305,30511,3051104
305110403,"Kabeza",228,269,497,3,305,30511,3051104
305110404,"Karama",292,336,628,3,305,30511,3051104
305110405,"Mazimeru",334,388,722,3,305,30511,3051104
305110406,"Nyakaganzo",197,228,425,3,305,30511,3051104
305110407,"Nyange",572,491,1063,3,305,30511,3051104
305110408,"Turamigina",198,210,408,3,305,30511,3051104
305110501,"Cyumba",563,647,1210,3,305,30511,3051105
305110502,"Gasarara",469,522,991,3,305,30511,3051105
305110503,"Kabagari",689,740,1429,3,305,30511,3051105
305110504,"Nyarubingo",473,579,1052,3,305,30511,3051105
305110505,"Rukaragata",492,548,1040,3,305,30511,3051105
305110506,"Rususa",859,852,1711,3,305,30511,3051105
305110601,"Gatare",271,340,611,3,305,30511,3051106
305110602,"Kanama",308,332,640,3,305,30511,3051106
305110603,"Karera",262,336,598,3,305,30511,3051106
305110604,"Nyakariba",347,335,682,3,305,30511,3051106
305110605,"Nyamabuye",236,243,479,3,305,30511,3051106
305110606,"Nyamiyaga",244,301,545,3,305,30511,3051106
305110607,"Rwambariro",366,416,782,3,305,30511,3051106
305120101,"Bugabe",350,404,754,3,305,30512,3051201
305120102,"Butare",194,259,453,3,305,30512,3051201
305120103,"Gakoma",359,479,838,3,305,30512,3051201
305120104,"Muzi",368,434,802,3,305,30512,3051201
305120105,"Nyarushubi",256,321,577,3,305,30512,3051201
305120106,"Rwasankuba",254,320,574,3,305,30512,3051201
305120201,"Birambo",482,552,1034,3,305,30512,3051202
305120202,"Dutwe",468,496,964,3,305,30512,3051202
305120203,"Gaseke",283,358,641,3,305,30512,3051202
305120204,"Giko",415,494,909,3,305,30512,3051202
305120205,"Ngobagoba",665,770,1435,3,305,30512,3051202
305120301,"Cyambogo",550,505,1055,3,305,30512,3051203
305120302,"Kanyinya",226,256,482,3,305,30512,3051203
305120303,"Muganza",287,296,583,3,305,30512,3051203
305120304,"Murambi",334,386,720,3,305,30512,3051203
305120305,"Nyange",250,292,542,3,305,30512,3051203
305120306,"Nyarusange",427,473,900,3,305,30512,3051203
305120307,"Vungu",365,413,778,3,305,30512,3051203
305120308,"Zegenya",302,361,663,3,305,30512,3051203
305120401,"Kakinyoni",390,450,840,3,305,30512,3051204
305120402,"Kamuriza",482,580,1062,3,305,30512,3051204
305120403,"Karambo",283,340,623,3,305,30512,3051204
305120404,"Kazenga",317,434,751,3,305,30512,3051204
305120405,"Mbobo",294,351,645,3,305,30512,3051204
305120406,"Ngorore",209,283,492,3,305,30512,3051204
305120407,"Nyagatama",242,319,561,3,305,30512,3051204
305120408,"Nyamyungo",382,437,819,3,305,30512,3051204
305130101,"Kabayengo",485,576,1061,3,305,30513,3051301
305130102,"Mahembe",360,440,800,3,305,30513,3051301
305130103,"Muyange",408,409,817,3,305,30513,3051301
305130104,"Nshano",286,356,642,3,305,30513,3051301
305130105,"Ruseke",322,324,646,3,305,30513,3051301
305130201,"Gitabage",224,266,490,3,305,30513,3051302
305130202,"Karambo",454,505,959,3,305,30513,3051302
305130203,"Ndagarago",508,545,1053,3,305,30513,3051302
305130204,"Nyamuza",402,453,855,3,305,30513,3051302
305130205,"Rusenge",337,401,738,3,305,30513,3051302
305130301,"Bitaba",381,467,848,3,305,30513,3051303
305130302,"Gahombo",360,477,837,3,305,30513,3051303
305130303,"Gashihe",276,320,596,3,305,30513,3051303
305130304,"Mugobati",368,474,842,3,305,30513,3051303
305130305,"Ruganda",348,421,769,3,305,30513,3051303
305130306,"Rusebeya",348,442,790,3,305,30513,3051303
305130401,"Gihonga",370,450,820,3,305,30513,3051304
305130402,"Gisakavu",210,257,467,3,305,30513,3051304
305130403,"Gisiza",369,423,792,3,305,30513,3051304
305130404,"Kabuga",278,363,641,3,305,30513,3051304
305130405,"Rubindi",400,479,879,3,305,30513,3051304
305130501,"Butenga",381,433,814,3,305,30513,3051305
305130502,"Gatare",259,333,592,3,305,30513,3051305
305130503,"Migendezo",303,378,681,3,305,30513,3051305
305130504,"Nyirabwina",307,347,654,3,305,30513,3051305
305130505,"Sanzare",350,387,737,3,305,30513,3051305
305130601,"Gasiza",407,516,923,3,305,30513,3051306
305130602,"Kanyirajana",279,295,574,3,305,30513,3051306
305130603,"Kigusa",270,308,578,3,305,30513,3051306
305130604,"Ngaza",262,323,585,3,305,30513,3051306
305130605,"Ngugu",500,591,1091,3,305,30513,3051306
305130606,"Rukeri",306,314,620,3,305,30513,3051306
306010101,"Cititi",328,349,677,3,306,30601,3060101
306010102,"Cyagara",359,371,730,3,306,30601,3060101
306010103,"Gatebe",239,226,465,3,306,30601,3060101
306010104,"Kabeza",264,288,552,3,306,30601,3060101
306010105,"Kamabuye",334,383,717,3,306,30601,3060101
306010106,"Mihabura",324,361,685,3,306,30601,3060101
306010107,"Misufi",368,431,799,3,306,30601,3060101
306010108,"Mubogora",379,300,679,3,306,30601,3060101
306010109,"Muko",581,556,1137,3,306,30601,3060101
306010110,"Munini",242,290,532,3,306,30601,3060101
306010111,"Nyange",377,390,767,3,306,30601,3060101
306010112,"Rubumba",373,402,775,3,306,30601,3060101
306010113,"Rusayo",309,354,663,3,306,30601,3060101
306010201,"Buhanga",313,329,642,3,306,30601,3060102
306010202,"Isangano",403,412,815,3,306,30601,3060102
306010203,"Ituze",243,324,567,3,306,30601,3060102
306010204,"Kabusunzu",440,421,861,3,306,30601,3060102
306010205,"Kabuye",300,369,669,3,306,30601,3060102
306010206,"Kinamba",321,363,684,3,306,30601,3060102
306010207,"Kiyovu",255,263,518,3,306,30601,3060102
306010208,"Majyambere",358,405,763,3,306,30601,3060102
306010209,"Murambi",324,368,692,3,306,30601,3060102
306010210,"Murwa",347,399,746,3,306,30601,3060102
306010211,"Mwaro",639,698,1337,3,306,30601,3060102
306010212,"Pera",158,174,332,3,306,30601,3060102
306010301,"Gihigano",296,285,581,3,306,30601,3060103
306010302,"Gombaniro",319,391,710,3,306,30601,3060103
306010303,"Kabuga",256,276,532,3,306,30601,3060103
306010304,"Kagarama",278,224,502,3,306,30601,3060103
306010305,"Kayenzi",417,500,917,3,306,30601,3060103
306010306,"Mahoro",421,451,872,3,306,30601,3060103
306010307,"Mubombo",169,162,331,3,306,30601,3060103
306010308,"Muyange",299,318,617,3,306,30601,3060103
306010309,"Nyehonga",221,214,435,3,306,30601,3060103
306010310,"Rubyiro",377,423,800,3,306,30601,3060103
306010311,"Ruhwa",299,300,599,3,306,30601,3060103
306010312,"Rusizi",342,324,666,3,306,30601,3060103
306020101,"Buganzo",166,209,375,3,306,30602,3060201
306020102,"Gasihe",264,281,545,3,306,30602,3060201
306020103,"Gitega",221,253,474,3,306,30602,3060201
306020104,"Murambi",256,307,563,3,306,30602,3060201
306020105,"Mwoya",148,156,304,3,306,30602,3060201
306020106,"Rugera",267,310,577,3,306,30602,3060201
306020107,"Rujagi",388,398,786,3,306,30602,3060201
306020201,"Giciramata",217,208,425,3,306,30602,3060202
306020202,"Gisovu",164,179,343,3,306,30602,3060202
306020203,"Kabuga",197,219,416,3,306,30602,3060202
306020204,"Karama",261,286,547,3,306,30602,3060202
306020205,"Kareba",274,268,542,3,306,30602,3060202
306020206,"Nyabitimbo",257,260,517,3,306,30602,3060202
306020207,"Nyaburenge",260,307,567,3,306,30602,3060202
306020208,"Nyakibanda",254,239,493,3,306,30602,3060202
306020209,"Nyambeho",217,209,426,3,306,30602,3060202
306020210,"Ruhinga",200,206,406,3,306,30602,3060202
306020211,"Rwibutso",234,247,481,3,306,30602,3060202
306020301,"Kenya",134,158,292,3,306,30602,3060203
306020302,"Kirwano",243,263,506,3,306,30602,3060203
306020303,"Munkamba",202,188,390,3,306,30602,3060203
306020304,"Mwimerere",344,380,724,3,306,30602,3060203
306020305,"Ndengerezi",188,199,387,3,306,30602,3060203
306020306,"Rushwati",372,389,761,3,306,30602,3060203
306020401,"Bisengo",329,369,698,3,306,30602,3060204
306020402,"Buye",301,344,645,3,306,30602,3060204
306020403,"Byimana",364,399,763,3,306,30602,3060204
306020404,"Cyaruhiza",253,282,535,3,306,30602,3060204
306020405,"Cyijuru",218,233,451,3,306,30602,3060204
306020406,"Gasumo",318,354,672,3,306,30602,3060204
306020407,"Karambo",495,532,1027,3,306,30602,3060204
306020408,"Kigarama",353,404,757,3,306,30602,3060204
306020409,"Nyaruteja",413,442,855,3,306,30602,3060204
306020410,"Rutovu",256,276,532,3,306,30602,3060204
306030101,"Kibonajoro",342,377,719,3,306,30603,3060301
306030102,"Rwamagare",384,395,779,3,306,30603,3060301
306030201,"Bunyagiro",215,201,416,3,306,30603,3060302
306030202,"Matyazo",199,185,384,3,306,30603,3060302
306030203,"Mbisabasaba",325,251,576,3,306,30603,3060302
306030204,"Mudasomwa",230,278,508,3,306,30603,3060302
306030205,"Mutara",249,266,515,3,306,30603,3060302
306030206,"Ruhondo",259,294,553,3,306,30603,3060302
306030207,"Runege",150,166,316,3,306,30603,3060302
306030208,"Rutobo",222,240,462,3,306,30603,3060302
306030301,"Muyebe",285,299,584,3,306,30603,3060303
306030302,"Nyabigoma",360,377,737,3,306,30603,3060303
306030401,"Gakopfo",200,226,426,3,306,30603,3060304
306030402,"Kigobe",197,223,420,3,306,30603,3060304
306030403,"Muhiza",248,299,547,3,306,30603,3060304
306030404,"Rwamisave",234,249,483,3,306,30603,3060304
306030501,"Banamba",336,374,710,3,306,30603,3060305
306030502,"Kabuga",301,314,615,3,306,30603,3060305
306030503,"Nyamirambo",326,349,675,3,306,30603,3060305
306030504,"Nyamutake",300,333,633,3,306,30603,3060305
306030505,"Runyami",235,279,514,3,306,30603,3060305
306030506,"Runyovu",251,288,539,3,306,30603,3060305
306030507,"Uwinzovu",206,236,442,3,306,30603,3060305
306040101,"Mariba",351,353,704,3,306,30604,3060401
306040102,"Rurama",293,331,624,3,306,30604,3060401
306040201,"Busekera",279,321,600,3,306,30604,3060402
306040202,"Cyimbazi",196,238,434,3,306,30604,3060402
306040203,"Gahinga",266,299,565,3,306,30604,3060402
306040204,"Kabahizi",237,266,503,3,306,30604,3060402
306040205,"Ryagacece",295,318,613,3,306,30604,3060402
306040301,"Gatare",237,338,575,3,306,30604,3060403
306040302,"Munini",320,303,623,3,306,30604,3060403
306040303,"Rango",145,185,330,3,306,30604,3060403
306040304,"Rwesero",261,273,534,3,306,30604,3060403
306040401,"Mubuga",284,318,602,3,306,30604,3060404
306040402,"Mukaba",225,277,502,3,306,30604,3060404
306040403,"Rango",200,234,434,3,306,30604,3060404
306040404,"Torero",290,323,613,3,306,30604,3060404
306040501,"Gacyamo",242,259,501,3,306,30604,3060405
306040502,"Gasharu",149,185,334,3,306,30604,3060405
306040503,"Kamonyi",205,206,411,3,306,30604,3060405
306040504,"Mashya",283,271,554,3,306,30604,3060405
306040505,"Murehe",242,267,509,3,306,30604,3060405
306040506,"Nyabihanga",140,160,300,3,306,30604,3060405
306040507,"Rebero",144,200,344,3,306,30604,3060405
306040508,"Shara",173,230,403,3,306,30604,3060405
306040601,"Kabaha",219,251,470,3,306,30604,3060406
306040602,"Kabahinda",256,297,553,3,306,30604,3060406
306040603,"Kagikongoro",274,325,599,3,306,30604,3060406
306040604,"Mibirizi",414,494,908,3,306,30604,3060406
306040605,"Rugarama",182,197,379,3,306,30604,3060406
306040701,"Gakombe",276,318,594,3,306,30604,3060407
306040702,"Kabeza",364,454,818,3,306,30604,3060407
306040703,"Karenge",307,344,651,3,306,30604,3060407
306040704,"Marebe",239,229,468,3,306,30604,3060407
306040705,"Rugende",332,310,642,3,306,30604,3060407
306040801,"Bitaba",295,387,682,3,306,30604,3060408
306040802,"Kamuhana",154,175,329,3,306,30604,3060408
306040803,"Kibombwe",203,220,423,3,306,30604,3060408
306040804,"Kiremereye",236,267,503,3,306,30604,3060408
306040805,"Misave",257,268,525,3,306,30604,3060408
306040806,"Nyamutarama",315,318,633,3,306,30604,3060408
306040807,"Ryagatebe",194,231,425,3,306,30604,3060408
306050101,"Burembo",314,407,721,3,306,30605,3060501
306050102,"Kabeza",230,282,512,3,306,30605,3060501
306050103,"Kibakure",237,302,539,3,306,30605,3060501
306050104,"Murinzi",344,418,762,3,306,30605,3060501
306050201,"Buzi",331,362,693,3,306,30605,3060502
306050202,"Gacyamo",326,374,700,3,306,30605,3060502
306050203,"Kabuga",272,331,603,3,306,30605,3060502
306050204,"Kagarama",197,249,446,3,306,30605,3060502
306050205,"Ruvumbu",169,211,380,3,306,30605,3060502
306050301,"Karambo",160,186,346,3,306,30605,3060503
306050302,"Murambi",524,500,1024,3,306,30605,3060503
306050303,"Rugombo",149,197,346,3,306,30605,3060503
306050304,"Rwumvangoma",228,259,487,3,306,30605,3060503
306050305,"Wimana",332,236,568,3,306,30605,3060503
306050401,"Gitwa",318,379,697,3,306,30605,3060504
306050402,"Isha",251,348,599,3,306,30605,3060504
306050403,"Kamuhozi",210,261,471,3,306,30605,3060504
306050404,"Rukombe",205,268,473,3,306,30605,3060504
306050501,"Gahinga",329,378,707,3,306,30605,3060505
306050502,"Gahurubuka",337,378,715,3,306,30605,3060505
306050503,"Rwamiko",144,160,304,3,306,30605,3060505
306050601,"Bubanga",175,210,385,3,306,30605,3060506
306050602,"Kabujyogoro",210,263,473,3,306,30605,3060506
306050603,"Kabyuma",202,232,434,3,306,30605,3060506
306050604,"Karambi",237,306,543,3,306,30605,3060506
306050605,"Kavuye",239,251,490,3,306,30605,3060506
306050606,"Kigenge",189,228,417,3,306,30605,3060506
306050607,"Ntura",279,310,589,3,306,30605,3060506
306050608,"Rebero",235,247,482,3,306,30605,3060506
306050701,"Impala",165,208,373,3,306,30605,3060507
306050702,"Kanoga",172,254,426,3,306,30605,3060507
306050703,"Rwega",291,369,660,3,306,30605,3060507
306050801,"Kamuhoza",166,223,389,3,306,30605,3060508
306050802,"Munyove",193,255,448,3,306,30605,3060508
306050803,"Rwinkwavu",221,262,483,3,306,30605,3060508
306050804,"Turambi",116,145,261,3,306,30605,3060508
306060101,"Burunga",393,353,746,3,306,30606,3060601
306060102,"Cyapa",511,478,989,3,306,30606,3060601
306060103,"Cyunyu",351,353,704,3,306,30606,3060601
306060104,"Gacamahembe",347,387,734,3,306,30606,3060601
306060105,"Kamabuye",294,330,624,3,306,30606,3060601
306060106,"Kanombe",246,289,535,3,306,30606,3060601
306060107,"Karangiro",549,571,1120,3,306,30606,3060601
306060108,"Karitasi",241,290,531,3,306,30606,3060601
306060109,"Karorabose",339,393,732,3,306,30606,3060601
306060110,"Karushaririza",360,396,756,3,306,30606,3060601
306060201,"Gahinga",243,344,587,3,306,30606,3060602
306060202,"Gikombe",297,338,635,3,306,30606,3060602
306060203,"Kavumu",249,301,550,3,306,30606,3060602
306060204,"Kinyereri",197,250,447,3,306,30606,3060602
306060205,"Mpongora",281,354,635,3,306,30606,3060602
306060206,"Rwahi",157,184,341,3,306,30606,3060602
306060207,"Tuwonane",283,270,553,3,306,30606,3060602
306060301,"Budorozo",220,261,481,3,306,30606,3060603
306060302,"Kinyaga",232,232,464,3,306,30606,3060603
306060401,"Bahemba",224,233,457,3,306,30606,3060604
306060402,"Kivoga",215,250,465,3,306,30606,3060604
306060403,"Nyandarama",253,260,513,3,306,30606,3060604
306060404,"Rubenga I",267,291,558,3,306,30606,3060604
306060405,"Rubenga Ii",220,211,431,3,306,30606,3060604
306060406,"Rukohwa",140,161,301,3,306,30606,3060604
306060501,"Cyinzovu",240,256,496,3,306,30606,3060605
306060502,"Gahwazi",717,1042,1759,3,306,30606,3060605
306060503,"Kamanyenga",273,288,561,3,306,30606,3060605
306060504,"Muhari",214,218,432,3,306,30606,3060605
306060505,"Munyana",188,239,427,3,306,30606,3060605
306060506,"Ngoma",365,404,769,3,306,30606,3060605
306060601,"Bisanganira",226,262,488,3,306,30606,3060606
306060602,"Gasharu",171,197,368,3,306,30606,3060606
306060603,"Gitwa",272,281,553,3,306,30606,3060606
306060604,"Kanoga",350,391,741,3,306,30606,3060606
306060605,"Karambo",279,322,601,3,306,30606,3060606
306060606,"Nyagatare",300,332,632,3,306,30606,3060606
306060607,"Shagasha",225,283,508,3,306,30606,3060606
306070101,"Gasharu",321,329,650,3,306,30607,3060701
306070102,"Gitambi",321,327,648,3,306,30607,3060701
306070103,"Hinduka",163,186,349,3,306,30607,3060701
306070104,"Ituze",276,299,575,3,306,30607,3060701
306070105,"Kamabuye",208,253,461,3,306,30607,3060701
306070106,"Mubera",291,311,602,3,306,30607,3060701
306070107,"Mutonga",248,249,497,3,306,30607,3060701
306070108,"Ruhango",345,438,783,3,306,30607,3060701
306070109,"Rukuraza",253,308,561,3,306,30607,3060701
306070110,"Shanike",225,211,436,3,306,30607,3060701
306070201,"Birindiro",163,179,342,3,306,30607,3060702
306070202,"Busarabuye",208,241,449,3,306,30607,3060702
306070203,"Bushenge",236,273,509,3,306,30607,3060702
306070204,"Gihomba",106,134,240,3,306,30607,3060702
306070205,"Kaberenge",128,121,249,3,306,30607,3060702
306070206,"Kagari",99,121,220,3,306,30607,3060702
306070207,"Kirume",275,271,546,3,306,30607,3060702
306070208,"Matyazo",430,500,930,3,306,30607,3060702
306070209,"Mpuzamahanga",334,373,707,3,306,30607,3060702
306070210,"Mubuga",162,146,308,3,306,30607,3060702
306070211,"Mugerero",225,273,498,3,306,30607,3060702
306070212,"Nyabihanga",171,192,363,3,306,30607,3060702
306070213,"Rebero",354,394,748,3,306,30607,3060702
306070301,"Binyaburanga",271,309,580,3,306,30607,3060703
306070302,"Buhinga",317,340,657,3,306,30607,3060703
306070303,"Bumaranyota",284,350,634,3,306,30607,3060703
306070304,"Bwiza",259,288,547,3,306,30607,3060703
306070305,"Jyambere",280,266,546,3,306,30607,3060703
306070306,"Kanoga",289,296,585,3,306,30607,3060703
306070307,"Kariba",246,306,552,3,306,30607,3060703
306080101,"Kabucuku",361,394,755,3,306,30608,3060801
306080102,"Kabugarama",427,501,928,3,306,30608,3060801
306080103,"Mpinga",490,540,1030,3,306,30608,3060801
306080104,"Mugenge",558,600,1158,3,306,30608,3060801
306080105,"Rwihene",428,475,903,3,306,30608,3060801
306080201,"Kamagaju",375,440,815,3,306,30608,3060802
306080202,"Kamonyi",176,201,377,3,306,30608,3060802
306080203,"Kaninda",316,307,623,3,306,30608,3060802
306080204,"Kazinda",363,394,757,3,306,30608,3060802
306080205,"Kigarama",240,236,476,3,306,30608,3060802
306080206,"Mugerero",322,337,659,3,306,30608,3060802
306080207,"Njambwe",363,402,765,3,306,30608,3060802
306080208,"Nyakibingo ",371,428,799,3,306,30608,3060802
306080209,"Nyamaganda",263,329,592,3,306,30608,3060802
306080210,"Nyantaba",312,333,645,3,306,30608,3060802
306080301,"Kabonabose",590,600,1190,3,306,30608,3060803
306080302,"Kabuga",170,204,374,3,306,30608,3060803
306080303,"Karambo",143,139,282,3,306,30608,3060803
306080304,"Kirehe",310,367,677,3,306,30608,3060803
306080305,"Nzabuhaha",212,243,455,3,306,30608,3060803
306080306,"Runanira",618,590,1208,3,306,30608,3060803
306080401,"Busasamana",287,301,588,3,306,30608,3060804
306080402,"Idaga",438,497,935,3,306,30608,3060804
306080403,"Kankuba",561,611,1172,3,306,30608,3060804
306080404,"Karama",419,466,885,3,306,30608,3060804
306080405,"Nyakivomero",384,436,820,3,306,30608,3060804
306080406,"Ruvuruga",383,451,834,3,306,30608,3060804
306090101,"Gatovu",227,249,476,3,306,30609,3060901
306090102,"Karambo",3394,307,3701,3,306,30609,3060901
306090103,"Karangiro",311,311,622,3,306,30609,3060901
306090104,"Mont Cyangugu",428,506,934,3,306,30609,3060901
306090105,"Mundima",201,217,418,3,306,30609,3060901
306090106,"Ngoma",299,302,601,3,306,30609,3060901
306090107,"Ntwari",411,258,669,3,306,30609,3060901
306090201,"Batero",365,350,715,3,306,30609,3060902
306090202,"Burunga",413,434,847,3,306,30609,3060902
306090203,"Kabeza",194,190,384,3,306,30609,3060902
306090204,"Munyinya",471,394,865,3,306,30609,3060902
306090205,"Murambi",284,259,543,3,306,30609,3060902
306090206,"Nkurunziza",288,272,560,3,306,30609,3060902
306090301,"Amahoro",336,371,707,3,306,30609,3060903
306090302,"Badura",159,151,310,3,306,30609,3060903
306090303,"Gitinda",99,121,220,3,306,30609,3060903
306090304,"Kadasomwa",424,421,845,3,306,30609,3060903
306090305,"Kannyogo",218,229,447,3,306,30609,3060903
306090306,"Mbagira",378,389,767,3,306,30609,3060903
306090307,"Mucyamo",183,218,401,3,306,30609,3060903
306090308,"Ntemabiti",295,228,523,3,306,30609,3060903
306090309,"Nyakayonga",259,251,510,3,306,30609,3060903
306090310,"Rushakamba",415,359,774,3,306,30609,3060903
306090311,"Umuganda",432,452,884,3,306,30609,3060903
306090401,"Cyapa",240,195,435,3,306,30609,3060904
306090402,"Gikombe",803,464,1267,3,306,30609,3060904
306090403,"Kamuhirwa",347,344,691,3,306,30609,3060904
306090404,"Murangi",306,374,680,3,306,30609,3060904
306090501,"Kadashya",377,365,742,3,306,30609,3060905
306090502,"Kamubaji",203,241,444,3,306,30609,3060905
306090503,"Murindi",282,265,547,3,306,30609,3060905
306090504,"Ruhimbi",339,299,638,3,306,30609,3060905
306100101,"Gashinjano",288,282,570,3,306,30610,3061001
306100102,"Gashisha",251,232,483,3,306,30610,3061001
306100103,"Gisozi",272,266,538,3,306,30610,3061001
306100104,"Kabamba",296,321,617,3,306,30610,3061001
306100105,"Murira",350,379,729,3,306,30610,3061001
306100106,"Nyakagoma",256,286,542,3,306,30610,3061001
306100107,"Rubumba",236,259,495,3,306,30610,3061001
306100108,"Rubyiro",267,245,512,3,306,30610,3061001
306100109,"Rungunga ",378,447,825,3,306,30610,3061001
306100201,"Gatabuvuga",504,582,1086,3,306,30610,3061002
306100202,"Gatanga",293,308,601,3,306,30610,3061002
306100203,"Kabeza",243,329,572,3,306,30610,3061002
306100204,"Kindobwe",328,329,657,3,306,30610,3061002
306100205,"Kiyovu",395,316,711,3,306,30610,3061002
306100206,"Muhuta",628,662,1290,3,306,30610,3061002
306100207,"Nyakagenge",273,315,588,3,306,30610,3061002
306100208,"Rebero",239,301,540,3,306,30610,3061002
306100209,"Rugaragara",375,412,787,3,306,30610,3061002
306100210,"Sanganiro",493,459,952,3,306,30610,3061002
306100211,"Sano",365,405,770,3,306,30610,3061002
306100212,"Umutuzo",268,301,569,3,306,30610,3061002
306100301,"Busasamana",642,644,1286,3,306,30610,3061003
306100302,"Gakenke",710,798,1508,3,306,30610,3061003
306100303,"Kabarore",266,278,544,3,306,30610,3061003
306100304,"Kamabuye",375,401,776,3,306,30610,3061003
306100305,"Murabyo",505,484,989,3,306,30610,3061003
306100306,"Nyabishunju",189,191,380,3,306,30610,3061003
306100307,"Nyenyeri",577,466,1043,3,306,30610,3061003
306100308,"Ramiro",685,569,1254,3,306,30610,3061003
306100309,"Rubeho",445,469,914,3,306,30610,3061003
306110101,"Birogo",347,341,688,3,306,30611,3061101
306110102,"Buremera",291,343,634,3,306,30611,3061101
306110103,"Cyirabyo A",131,155,286,3,306,30611,3061101
306110104,"Cyirabyo B",253,284,537,3,306,30611,3061101
306110105,"Gipfura",407,479,886,3,306,30611,3061101
306110106,"Kabirizi",295,402,697,3,306,30611,3061101
306110107,"Kamarebe",176,160,336,3,306,30611,3061101
306110108,"Kanunga",227,275,502,3,306,30611,3061101
306110109,"Mutara",658,615,1273,3,306,30611,3061101
306110110,"Ryabadugu",243,280,523,3,306,30611,3061101
306110201,"Kabahire",256,329,585,3,306,30611,3061102
306110202,"Karambo",169,196,365,3,306,30611,3061102
306110203,"Winteko",222,266,488,3,306,30611,3061102
306110301,"Bitongo",171,196,367,3,306,30611,3061103
306110302,"Butazigurwa",268,314,582,3,306,30611,3061103
306110303,"Mutimasi",262,339,601,3,306,30611,3061103
306110401,"Cyete",291,342,633,3,306,30611,3061104
306110402,"Gikungwe",284,358,642,3,306,30611,3061104
306110403,"Gitwa",314,365,679,3,306,30611,3061104
306110404,"Kamatene",433,440,873,3,306,30611,3061104
306110501,"Bugayi",150,158,308,3,306,30611,3061105
306110502,"Gihango",205,235,440,3,306,30611,3061105
306110503,"Kagarama",144,181,325,3,306,30611,3061105
306110601,"Kabageni",335,412,747,3,306,30611,3061106
306110602,"Nyakanyinya",282,305,587,3,306,30611,3061106
306110603,"Ruhimbi",244,258,502,3,306,30611,3061106
306110701,"Byangoma",224,249,473,3,306,30611,3061107
306110702,"Cyandarama",351,421,772,3,306,30611,3061107
306110703,"Gatimbwa",240,236,476,3,306,30611,3061107
306110704,"Kamutongo",287,308,595,3,306,30611,3061107
306110705,"Karanjwa",330,395,725,3,306,30611,3061107
306110706,"Mukorazuba",401,417,818,3,306,30611,3061107
306110707,"Mutongo",458,497,955,3,306,30611,3061107
306110708,"Rugerero",340,335,675,3,306,30611,3061107
306120101,"Buganda",291,384,675,3,306,30612,3061201
306120102,"Burege",327,435,762,3,306,30612,3061201
306120103,"Kanyombya",224,294,518,3,306,30612,3061201
306120104,"Karama",170,223,393,3,306,30612,3061201
306120105,"Muhonga",213,219,432,3,306,30612,3061201
306120106,"Rugarika",321,356,677,3,306,30612,3061201
306120201,"Gatebe",307,399,706,3,306,30612,3061202
306120202,"Hepfo",333,393,726,3,306,30612,3061202
306120203,"Kavogo",213,267,480,3,306,30612,3061202
306120204,"Muramba",473,563,1036,3,306,30612,3061202
306120205,"Nyabiranga",331,400,731,3,306,30612,3061202
306120206,"Rweya",297,345,642,3,306,30612,3061202
306120301,"Bahemba",282,330,612,3,306,30612,3061203
306120302,"Busekanka",308,355,663,3,306,30612,3061203
306120303,"Gafoka",325,382,707,3,306,30612,3061203
306120304,"Muyange",327,378,705,3,306,30612,3061203
306120305,"Rusunyu",288,343,631,3,306,30612,3061203
306120401,"Kabutimbiri",220,270,490,3,306,30612,3061204
306120402,"Kinyaga",205,261,466,3,306,30612,3061204
306120403,"Miramba",476,262,738,3,306,30612,3061204
306120404,"Rugaragara",348,506,854,3,306,30612,3061204
306120405,"Sumoyamana",428,460,888,3,306,30612,3061204
306120501,"Bitaba",236,356,592,3,306,30612,3061205
306120502,"Kagarama",156,199,355,3,306,30612,3061205
306120503,"Kamahoro",214,286,500,3,306,30612,3061205
306120504,"Karambo",270,286,556,3,306,30612,3061205
306120505,"Rebero",207,256,463,3,306,30612,3061205
306120506,"Rurembo",245,253,498,3,306,30612,3061205
306130101,"Gisunyu",204,245,449,3,306,30613,3061301
306130102,"Giteme",234,260,494,3,306,30613,3061301
306130103,"Kabashinga",342,322,664,3,306,30613,3061301
306130104,"Ngoma",255,257,512,3,306,30613,3061301
306130105,"Nyawenya",396,429,825,3,306,30613,3061301
306130106,"Rebero",372,411,783,3,306,30613,3061301
306130201,"Gaturo",315,325,640,3,306,30613,3061302
306130202,"Nyakabanda",142,142,284,3,306,30613,3061302
306130203,"Nyankumbira",378,390,768,3,306,30613,3061302
306130204,"Rurembo",312,356,668,3,306,30613,3061302
306130301,"Biraro",245,300,545,3,306,30613,3061303
306130302,"Kaboneke",270,291,561,3,306,30613,3061303
306130303,"Kabuga",280,341,621,3,306,30613,3061303
306130304,"Mapfura",296,300,596,3,306,30613,3061303
306130401,"Gashara",233,253,486,3,306,30613,3061304
306130402,"Gitwa",378,364,742,3,306,30613,3061304
306130403,"Kabuye",352,358,710,3,306,30613,3061304
306130404,"Kanyinya",197,211,408,3,306,30613,3061304
306130405,"Karenge",368,395,763,3,306,30613,3061304
306130406,"Mbuga",266,287,553,3,306,30613,3061304
306130407,"Muhora",215,233,448,3,306,30613,3061304
306130501,"Gituro",306,361,667,3,306,30613,3061305
306130502,"Mirara",216,243,459,3,306,30613,3061305
306130503,"Nyabintare",370,383,753,3,306,30613,3061305
306130504,"Rutarakiro",314,391,705,3,306,30613,3061305
306140101,"Bahuro",212,231,443,3,306,30614,3061401
306140102,"Cyandarama",276,304,580,3,306,30614,3061401
306140103,"Kimpundu",130,151,281,3,306,30614,3061401
306140104,"Kivugiza",252,241,493,3,306,30614,3061401
306140105,"Madaho",166,199,365,3,306,30614,3061401
306140106,"Njambwe",267,317,584,3,306,30614,3061401
306140107,"Rubona",232,255,487,3,306,30614,3061401
306140108,"Rutegamatwi",182,242,424,3,306,30614,3061401
306140201,"Byugaro",196,228,424,3,306,30614,3061402
306140202,"Gasarabuye",212,273,485,3,306,30614,3061402
306140203,"Kabigohe",231,229,460,3,306,30614,3061402
306140204,"Kabuga",322,280,602,3,306,30614,3061402
306140205,"Kabuganza",236,249,485,3,306,30614,3061402
306140206,"Kadashya",232,229,461,3,306,30614,3061402
306140207,"Kamabuye",228,236,464,3,306,30614,3061402
306140208,"Karongoro",263,215,478,3,306,30614,3061402
306140209,"Mpinga",333,323,656,3,306,30614,3061402
306140210,"Mukenke",215,266,481,3,306,30614,3061402
306140211,"Rebero",246,288,534,3,306,30614,3061402
306140212,"Ryamibuga",158,196,354,3,306,30614,3061402
306140301,"Gashashi",214,241,455,3,306,30614,3061403
306140302,"Gatagara",134,150,284,3,306,30614,3061403
306140303,"Gatondo",176,190,366,3,306,30614,3061403
306140304,"Gikombe",269,286,555,3,306,30614,3061403
306140305,"Honga",230,252,482,3,306,30614,3061403
306140306,"Kabinyugwe",256,286,542,3,306,30614,3061403
306140307,"Kamajumba",296,325,621,3,306,30614,3061403
306140308,"Migazo",155,199,354,3,306,30614,3061403
306140309,"Muhora",269,330,599,3,306,30614,3061403
306140310,"Rubona",245,291,536,3,306,30614,3061403
306140311,"Rwamaraba",158,168,326,3,306,30614,3061403
306140401,"Gako",245,287,532,3,306,30614,3061404
306140402,"Gatarange",319,318,637,3,306,30614,3061404
306140403,"Kigurwe",172,226,398,3,306,30614,3061404
306140404,"Kinanira",213,219,432,3,306,30614,3061404
306140405,"Kiyanza",229,260,489,3,306,30614,3061404
306140406,"Nyarushishi",261,295,556,3,306,30614,3061404
306140407,"Rugabe",222,244,466,3,306,30614,3061404
306140408,"Rususa",329,329,658,3,306,30614,3061404
306140409,"Ryamaraza",293,320,613,3,306,30614,3061404
306150101,"Biteri",166,188,354,3,306,30615,3061501
306150102,"Gacyamo",155,162,317,3,306,30615,3061501
306150103,"Gahuna",203,194,397,3,306,30615,3061501
306150104,"Gaseke",231,279,510,3,306,30615,3061501
306150105,"Gashyuha",165,208,373,3,306,30615,3061501
306150106,"Kabuye",128,166,294,3,306,30615,3061501
306150107,"Kanoga",260,260,520,3,306,30615,3061501
306150108,"Karambi",121,144,265,3,306,30615,3061501
306150109,"Kaveya",282,318,600,3,306,30615,3061501
306150201,"Bitendezi",347,412,759,3,306,30615,3061502
306150202,"Gatambamo",338,398,736,3,306,30615,3061502
306150203,"Kagabiro",330,401,731,3,306,30615,3061502
306150204,"Kagenge",334,371,705,3,306,30615,3061502
306150205,"Kinunga",208,228,436,3,306,30615,3061502
306150206,"Muyange",365,410,775,3,306,30615,3061502
306150207,"Rubona",311,332,643,3,306,30615,3061502
306150301,"Bikinga",304,229,533,3,306,30615,3061503
306150302,"Bugumya",208,197,405,3,306,30615,3061503
306150303,"Gatare",134,186,320,3,306,30615,3061503
306150304,"Gishagara",194,212,406,3,306,30615,3061503
306150305,"Kamusana",281,323,604,3,306,30615,3061503
306150306,"Kiyovu",299,263,562,3,306,30615,3061503
306150307,"Mpoga",275,262,537,3,306,30615,3061503
306150308,"Mukondo",187,202,389,3,306,30615,3061503
306150309,"Murambi",249,283,532,3,306,30615,3061503
306150310,"Nyakagoma",180,199,379,3,306,30615,3061503
306150311,"Nyeshati",167,175,342,3,306,30615,3061503
306150312,"Ruguti",174,190,364,3,306,30615,3061503
306150313,"Ryamberu",113,140,253,3,306,30615,3061503
306150314,"Segege",181,202,383,3,306,30615,3061503
306150315,"Shaba",172,211,383,3,306,30615,3061503
306150316,"Site",387,394,781,3,306,30615,3061503
306150401,"Bunyereri",438,507,945,3,306,30615,3061504
306150402,"Kamagerero",233,278,511,3,306,30615,3061504
306150403,"Makoko",325,341,666,3,306,30615,3061504
306150404,"Nkanga",388,406,794,3,306,30615,3061504
306150405,"Ruhinga",301,324,625,3,306,30615,3061504
306150406,"Rwimbogo",256,321,577,3,306,30615,3061504
306150501,"Cyamura",237,262,499,3,306,30615,3061505
306150502,"Kibirizi",268,295,563,3,306,30615,3061505
306150503,"Nyamaronko",206,221,427,3,306,30615,3061505
306150504,"Ruganzu",202,197,399,3,306,30615,3061505
306150505,"Rukamba",112,128,240,3,306,30615,3061505
306150601,"Barenga",292,337,629,3,306,30615,3061506
306150602,"Gakungu",243,259,502,3,306,30615,3061506
306150603,"Gatanga",292,298,590,3,306,30615,3061506
306150604,"Gatare",287,287,574,3,306,30615,3061506
306150605,"Mabuye",301,357,658,3,306,30615,3061506
306150606,"Mizibira",385,433,818,3,306,30615,3061506
306150607,"Peru",199,237,436,3,306,30615,3061506
306150608,"Ryarubaka",254,274,528,3,306,30615,3061506
306160101,"Bigando",191,234,425,3,306,30616,3061601
306160102,"Kabumbwe",273,346,619,3,306,30616,3061601
306160103,"Rwindare",126,141,267,3,306,30616,3061601
306160201,"Bitaba",250,255,505,3,306,30616,3061602
306160202,"Gacyamo",162,194,356,3,306,30616,3061602
306160203,"Gitovu",197,264,461,3,306,30616,3061602
306160204,"Karambi",132,173,305,3,306,30616,3061602
306160205,"Nyamugari",294,357,651,3,306,30616,3061602
306160301,"Bisenyi",168,196,364,3,306,30616,3061603
306160302,"Kazuba",191,217,408,3,306,30616,3061603
306160303,"Kigarama",142,156,298,3,306,30616,3061603
306160304,"Mashya",195,202,397,3,306,30616,3061603
306160305,"Mugerero",203,253,456,3,306,30616,3061603
306160306,"Nyamagana",279,274,553,3,306,30616,3061603
306160307,"Nyungu",273,298,571,3,306,30616,3061603
306160401,"Kamanura",257,271,528,3,306,30616,3061604
306160402,"Kanoga",250,277,527,3,306,30616,3061604
306160403,"Kanyovu",274,313,587,3,306,30616,3061604
306160404,"Kumana",307,337,644,3,306,30616,3061604
306160501,"Cyimbogo",300,297,597,3,306,30616,3061605
306160502,"Gihusi",187,207,394,3,306,30616,3061605
306160503,"Gituza",175,240,415,3,306,30616,3061605
306160504,"Kabayego",161,187,348,3,306,30616,3061605
306160601,"Gisovu",300,305,605,3,306,30616,3061606
306160602,"Njambwe",306,333,639,3,306,30616,3061606
306160603,"Runyanzovu",248,262,510,3,306,30616,3061606
306160701,"Gataramo",288,335,623,3,306,30616,3061607
306160702,"Karambi",109,151,260,3,306,30616,3061607
306160703,"Mugongo",123,151,274,3,306,30616,3061607
306160704,"Rusambu",119,153,272,3,306,30616,3061607
306170101,"Gashagwa",470,508,978,3,306,30617,3061701
306170102,"Karunyerera",306,378,684,3,306,30617,3061701
306170103,"Muguri",350,380,730,3,306,30617,3061701
306170104,"Ngoma",416,467,883,3,306,30617,3061701
306170105,"Ryarusaro",538,622,1160,3,306,30617,3061701
306170201,"Gihungwe",327,377,704,3,306,30617,3061702
306170202,"Kacyiru",390,407,797,3,306,30617,3061702
306170203,"Karagizwa",245,257,502,3,306,30617,3061702
306170204,"Ndabereye",298,326,624,3,306,30617,3061702
306170301,"Buganza",317,396,713,3,306,30617,3061703
306170302,"Gacuriro",326,401,727,3,306,30617,3061703
306170303,"Gisheke",212,212,424,3,306,30617,3061703
306170304,"Kamina",266,320,586,3,306,30617,3061703
306170305,"Nyagahanga",305,370,675,3,306,30617,3061703
306170306,"Nyagasozi",257,285,542,3,306,30617,3061703
306170307,"Ryagashyitsi",415,430,845,3,306,30617,3061703
306170308,"Tare",381,354,735,3,306,30617,3061703
306170401,"Gasharu",303,320,623,3,306,30617,3061704
306170402,"Gatare",395,428,823,3,306,30617,3061704
306170403,"Kinengwe",293,319,612,3,306,30617,3061704
306170404,"Murindi",416,439,855,3,306,30617,3061704
306170405,"Ruganzu",282,350,632,3,306,30617,3061704
306170406,"Rugunga",322,314,636,3,306,30617,3061704
306170501,"Gatovu",354,407,761,3,306,30617,3061705
306170502,"Giti",322,338,660,3,306,30617,3061705
306170503,"Kabuyange",358,442,800,3,306,30617,3061705
306170504,"Rukoro",327,438,765,3,306,30617,3061705
306170505,"Shariyo",289,355,644,3,306,30617,3061705
306170601,"Gasave",348,419,767,3,306,30617,3061706
306170602,"Kabugabo",317,325,642,3,306,30617,3061706
306170603,"Kibirezi",328,377,705,3,306,30617,3061706
306170604,"Kiranga",348,383,731,3,306,30617,3061706
306170605,"Murambi",309,374,683,3,306,30617,3061706
306170606,"Nyagahinga",329,357,686,3,306,30617,3061706
306170607,"Peru",271,312,583,3,306,30617,3061706
306180101,"Batura",388,431,819,3,306,30618,3061801
306180102,"Gatanga",266,267,533,3,306,30618,3061801
306180103,"Gishoma",596,567,1163,3,306,30618,3061801
306180104,"Makambi",187,233,420,3,306,30618,3061801
306180105,"Nyabihanga",254,236,490,3,306,30618,3061801
306180106,"Ruzeneko",200,222,422,3,306,30618,3061801
306180201,"Kibare",241,250,491,3,306,30618,3061802
306180202,"Murama",332,370,702,3,306,30618,3061802
306180203,"Musigiti",394,461,855,3,306,30618,3061802
306180204,"Nyarusebeya",448,481,929,3,306,30618,3061802
306180205,"Renga",403,459,862,3,306,30618,3061802
306180206,"Rungunga",305,347,652,3,306,30618,3061802
306180301,"Gakombe",330,333,663,3,306,30618,3061803
306180302,"Gatambamo",209,237,446,3,306,30618,3061803
306180303,"Kabajoba",408,432,840,3,306,30618,3061803
306180304,"Kamabuye",324,353,677,3,306,30618,3061803
306180305,"Nyagashora",356,395,751,3,306,30618,3061803
306180401,"Gatare",240,271,511,3,306,30618,3061804
306180402,"Ntenyi",371,435,806,3,306,30618,3061804
306180403,"Nyange",202,209,411,3,306,30618,3061804
306180404,"Rukombe",170,195,365,3,306,30618,3061804
306180501,"Cyunguriro",299,342,641,3,306,30618,3061805
306180502,"Musumba",392,432,824,3,306,30618,3061805
306180503,"Rubamba",438,483,921,3,306,30618,3061805
306180504,"Rubuye",298,334,632,3,306,30618,3061805
306180505,"Ruhinga",332,318,650,3,306,30618,3061805
307010101,"Buhinga",367,401,768,3,307,30701,3070101
307010102,"Bushekeri",379,436,815,3,307,30701,3070101
307010103,"Buvungira",380,417,797,3,307,30701,3070101
307010104,"Gasebeya",376,423,799,3,307,30701,3070101
307010105,"Gisakura",264,253,517,3,307,30701,3070101
307010106,"Kinzovu",219,236,455,3,307,30701,3070101
307010107,"Mujabagiro",233,107,340,3,307,30701,3070101
307010108,"Nkenga",256,309,565,3,307,30701,3070101
307010109,"Ruvumbu",322,348,670,3,307,30701,3070101
307010110,"Rwumba",290,267,557,3,307,30701,3070101
307010111,"Winkamba",241,286,527,3,307,30701,3070101
307010112,"Yove",200,258,458,3,307,30701,3070101
307010201,"Bona",284,332,616,3,307,30701,3070102
307010202,"Gahondo",333,385,718,3,307,30701,3070102
307010203,"Kamina",426,448,874,3,307,30701,3070102
307010204,"Karambi",246,324,570,3,307,30701,3070102
307010205,"Kirombozi",351,439,790,3,307,30701,3070102
307010301,"Bitare",385,401,786,3,307,30701,3070103
307010302,"Buhembe",300,341,641,3,307,30701,3070103
307010303,"Bukiro",235,233,468,3,307,30701,3070103
307010304,"Cyeshero",347,350,697,3,307,30701,3070103
307010305,"Kagarama",274,329,603,3,307,30701,3070103
307010306,"Kanyovu",381,452,833,3,307,30701,3070103
307010307,"Mashuhira",205,226,431,3,307,30701,3070103
307010308,"Rugeregere",343,422,765,3,307,30701,3070103
307010401,"Butangata",396,464,860,3,307,30701,3070104
307010402,"Gatoki",306,372,678,3,307,30701,3070104
307010403,"Kinini",263,276,539,3,307,30701,3070104
307010404,"Mubuga",303,416,719,3,307,30701,3070104
307010405,"Nyanza",416,427,843,3,307,30701,3070104
307010406,"Rundwe",406,437,843,3,307,30701,3070104
307010407,"Rweza",238,288,526,3,307,30701,3070104
307020101,"Bagiramenyo",292,396,688,3,307,30702,3070201
307020102,"Biguzi",247,290,537,3,307,30702,3070201
307020103,"Bugungu",231,293,524,3,307,30702,3070201
307020104,"Gasheke",335,374,709,3,307,30702,3070201
307020105,"Gikombe",205,276,481,3,307,30702,3070201
307020106,"Gitwa",323,365,688,3,307,30702,3070201
307020107,"Kamayenga",221,260,481,3,307,30702,3070201
307020108,"Kamucyamo",236,308,544,3,307,30702,3070201
307020109,"Karambo",143,199,342,3,307,30702,3070201
307020110,"Kigenge",312,367,679,3,307,30702,3070201
307020111,"Kivoga",257,292,549,3,307,30702,3070201
307020112,"Nyamikingo",324,409,733,3,307,30702,3070201
307020113,"Rwashyamba",246,262,508,3,307,30702,3070201
307020201,"Birava",213,210,423,3,307,30702,3070202
307020202,"Buninda",148,169,317,3,307,30702,3070202
307020203,"Bushenge",175,216,391,3,307,30702,3070202
307020204,"Gasharu",171,209,380,3,307,30702,3070202
307020205,"Gasumo",286,286,572,3,307,30702,3070202
307020206,"Kabeza",237,266,503,3,307,30702,3070202
307020207,"Mucuzi",266,262,528,3,307,30702,3070202
307020208,"Rumanga",293,348,641,3,307,30702,3070202
307020209,"Runyinya",246,306,552,3,307,30702,3070202
307020301,"Gashirabwoba",244,284,528,3,307,30702,3070203
307020302,"Gasura",114,141,255,3,307,30702,3070203
307020303,"Gatare",139,169,308,3,307,30702,3070203
307020304,"Kagatamu",259,323,582,3,307,30702,3070203
307020305,"Karunga",179,200,379,3,307,30702,3070203
307020306,"Kidashira",188,204,392,3,307,30702,3070203
307020307,"Maherero",175,222,397,3,307,30702,3070203
307020308,"Ruhinamavi",101,103,204,3,307,30702,3070203
307020309,"Ruhinga I",251,305,556,3,307,30702,3070203
307020310,"Ruhinga Ii",221,262,483,3,307,30702,3070203
307020401,"Gahongo",132,160,292,3,307,30702,3070204
307020402,"Gakombe",258,320,578,3,307,30702,3070204
307020403,"Gasharu",318,401,719,3,307,30702,3070204
307020404,"Karusimbi",220,278,498,3,307,30702,3070204
307020405,"Kasenjara",270,324,594,3,307,30702,3070204
307020406,"Kigaga",349,393,742,3,307,30702,3070204
307020407,"Nyakagezi",148,167,315,3,307,30702,3070204
307020408,"Remera",123,152,275,3,307,30702,3070204
307020409,"Rwumuyaga",348,352,700,3,307,30702,3070204
307030101,"Gasasa",308,435,743,3,307,30703,3070301
307030102,"Hangari",227,273,500,3,307,30703,3070301
307030103,"Kabuga",251,262,513,3,307,30703,3070301
307030104,"Kayo",258,301,559,3,307,30703,3070301
307030105,"Munini",342,399,741,3,307,30703,3070301
307030106,"Mutuntu",242,337,579,3,307,30703,3070301
307030107,"Rugabe",237,297,534,3,307,30703,3070301
307030108,"Rugarama",218,265,483,3,307,30703,3070301
307030109,"Ruhengeri",331,370,701,3,307,30703,3070301
307030110,"Rwaramba",364,415,779,3,307,30703,3070301
307030201,"Bigeyo",250,270,520,3,307,30703,3070302
307030202,"Cyato",277,326,603,3,307,30703,3070302
307030203,"Kamonyi",321,355,676,3,307,30703,3070302
307030204,"Karehe",194,229,423,3,307,30703,3070302
307030205,"Matyazo",325,377,702,3,307,30703,3070302
307030206,"Muhingo",304,384,688,3,307,30703,3070302
307030207,"Muremure",323,357,680,3,307,30703,3070302
307030208,"Murenge",226,257,483,3,307,30703,3070302
307030209,"Mutiti",216,257,473,3,307,30703,3070302
307030210,"Nkomero",270,275,545,3,307,30703,3070302
307030211,"Nyakabingo",368,456,824,3,307,30703,3070302
307030301,"Bwanama",296,247,543,3,307,30703,3070303
307030302,"Kavumu",274,308,582,3,307,30703,3070303
307030303,"Kizinga",246,367,613,3,307,30703,3070303
307030304,"Muyugiri",279,325,604,3,307,30703,3070303
307030305,"Rushahaga",219,321,540,3,307,30703,3070303
307030306,"Rusi",327,397,724,3,307,30703,3070303
307030307,"Rutiritiri",272,352,624,3,307,30703,3070303
307030308,"Yove",315,415,730,3,307,30703,3070303
307030401,"Gakenke",268,347,615,3,307,30703,3070304
307030402,"Gashihe",355,394,749,3,307,30703,3070304
307030403,"Gituntu",254,279,533,3,307,30703,3070304
307030404,"Karambo",146,178,324,3,307,30703,3070304
307030405,"Ntsinduka",376,407,783,3,307,30703,3070304
307030406,"Rubeho",151,222,373,3,307,30703,3070304
307030407,"Rwumba",215,257,472,3,307,30703,3070304
307040101,"Butare",201,245,446,3,307,30704,3070401
307040102,"Gahanda",192,239,431,3,307,30704,3070401
307040103,"Gasharu",284,360,644,3,307,30704,3070401
307040104,"Mbogo",273,362,635,3,307,30704,3070401
307040105,"Nyakabungo",188,231,419,3,307,30704,3070401
307040106,"Rugaragara",380,436,816,3,307,30704,3070401
307040107,"Rwamatamu",306,387,693,3,307,30704,3070401
307040108,"Rwatsi",308,246,554,3,307,30704,3070401
307040201,"Birehe",223,256,479,3,307,30704,3070402
307040202,"Bwerankori",234,322,556,3,307,30704,3070402
307040203,"Doga",298,311,609,3,307,30704,3070402
307040204,"Gasagara",239,264,503,3,307,30704,3070402
307040205,"Gaseke",233,278,511,3,307,30704,3070402
307040206,"Gasharu",293,360,653,3,307,30704,3070402
307040207,"Kinanira",186,201,387,3,307,30704,3070402
307040208,"Nyagahinga",270,305,575,3,307,30704,3070402
307040209,"Ruboreza",358,474,832,3,307,30704,3070402
307040301,"Bigabiro",255,330,585,3,307,30704,3070403
307040302,"Buseso",289,380,669,3,307,30704,3070403
307040303,"Kadobogo",237,298,535,3,307,30704,3070403
307040304,"Karehe",317,365,682,3,307,30704,3070403
307040305,"Kibirizi",298,377,675,3,307,30704,3070403
307040306,"Ruvumbu",333,408,741,3,307,30704,3070403
307040401,"Gituruka",271,324,595,3,307,30704,3070404
307040402,"Kigarama",558,615,1173,3,307,30704,3070404
307040403,"Mataba",226,221,447,3,307,30704,3070404
307040404,"Nyabitare",264,305,569,3,307,30704,3070404
307040405,"Nyarunyinya",267,298,565,3,307,30704,3070404
307040406,"Rushoka",341,367,708,3,307,30704,3070404
307040407,"Rusuzumiro",247,306,553,3,307,30704,3070404
307040408,"Rwabisindu",118,148,266,3,307,30704,3070404
307040409,"Rwanyundo",205,223,428,3,307,30704,3070404
307040501,"Bungo",252,272,524,3,307,30704,3070405
307040502,"Butembo",291,361,652,3,307,30704,3070405
307040503,"Mubuga",224,243,467,3,307,30704,3070405
307040504,"Muhavu",267,309,576,3,307,30704,3070405
307040505,"Muhororo",278,426,704,3,307,30704,3070405
307040506,"Ruhingo",185,187,372,3,307,30704,3070405
307050101,"Bagarama",408,501,909,3,307,30705,3070501
307050102,"Gasharu",286,358,644,3,307,30705,3070501
307050103,"Gitwa",371,461,832,3,307,30705,3070501
307050104,"Kazibira",356,409,765,3,307,30705,3070501
307050105,"Mpombo",266,304,570,3,307,30705,3070501
307050106,"Musagara",385,437,822,3,307,30705,3070501
307050107,"Remera",438,486,924,3,307,30705,3070501
307050108,"Rushondi",276,347,623,3,307,30705,3070501
307050109,"Rwangoma",347,377,724,3,307,30705,3070501
307050110,"Rwisovu",369,453,822,3,307,30705,3070501
307050111,"Ryarutungura",159,192,351,3,307,30705,3070501
307050201,"Bisoro",216,237,453,3,307,30705,3070502
307050202,"Gikomero",168,229,397,3,307,30705,3070502
307050203,"Gitanga",196,223,419,3,307,30705,3070502
307050204,"Kabagabo",388,286,674,3,307,30705,3070502
307050205,"Kabuyekeru",225,308,533,3,307,30705,3070502
307050206,"Mabungo",259,280,539,3,307,30705,3070502
307050207,"Makoko",300,322,622,3,307,30705,3070502
307050208,"Mikingo",242,328,570,3,307,30705,3070502
307050209,"Murambi",204,219,423,3,307,30705,3070502
307050210,"Nyagashinge",293,343,636,3,307,30705,3070502
307050211,"Nyamirambo",213,214,427,3,307,30705,3070502
307050301,"Gasayo",220,246,466,3,307,30705,3070503
307050302,"Gikuyu",806,1131,1937,3,307,30705,3070503
307050303,"Kavune",320,420,740,3,307,30705,3070503
307050304,"Mujabagiro",179,213,392,3,307,30705,3070503
307050305,"Murwa",168,184,352,3,307,30705,3070503
307050306,"Ninzi",258,284,542,3,307,30705,3070503
307050307,"Nyabageni",236,279,515,3,307,30705,3070503
307050308,"Rugabano",250,283,533,3,307,30705,3070503
307050401,"Gasharu",214,235,449,3,307,30705,3070504
307050402,"Gitaba",267,295,562,3,307,30705,3070504
307050403,"Kamasera",332,369,701,3,307,30705,3070504
307050404,"Kijibamba",290,449,739,3,307,30705,3070504
307050405,"Kirehe",235,293,528,3,307,30705,3070504
307050406,"Mutusa",415,513,928,3,307,30705,3070504
307050407,"Rwesero",372,426,798,3,307,30705,3070504
307050501,"Byahi",221,260,481,3,307,30705,3070505
307050502,"Gahumba",245,258,503,3,307,30705,3070505
307050503,"Gihinga",223,257,480,3,307,30705,3070505
307050504,"Gisunzu",203,234,437,3,307,30705,3070505
307050505,"Kaduha",238,256,494,3,307,30705,3070505
307050506,"Kamabuye",164,182,346,3,307,30705,3070505
307050507,"Kamina",210,225,435,3,307,30705,3070505
307050508,"Kibare",203,224,427,3,307,30705,3070505
307050509,"Matara",250,322,572,3,307,30705,3070505
307050510,"Mugohe",220,227,447,3,307,30705,3070505
307050511,"Murambi",198,211,409,3,307,30705,3070505
307050512,"Ntumba",332,349,681,3,307,30705,3070505
307050513,"Rambira",259,297,556,3,307,30705,3070505
307060101,"Bizenga",303,412,715,3,307,30706,3070601
307060102,"Gataba",898,801,1699,3,307,30706,3070601
307060103,"Kabuyaga",321,405,726,3,307,30706,3070601
307060104,"Kagarama",299,355,654,3,307,30706,3070601
307060105,"Kivugiza",279,274,553,3,307,30706,3070601
307060106,"Maseka",450,410,860,3,307,30706,3070601
307060107,"Munini",359,383,742,3,307,30706,3070601
307060108,"Nyagacaca",284,263,547,3,307,30706,3070601
307060109,"Nyarusange",157,172,329,3,307,30706,3070601
307060110,"Nyenyeri",299,362,661,3,307,30706,3070601
307060111,"Rwakagaju",610,489,1099,3,307,30706,3070601
307060201,"Gakomeye",383,461,844,3,307,30706,3070602
307060202,"Gatare",337,364,701,3,307,30706,3070602
307060203,"Gisagara",233,320,553,3,307,30706,3070602
307060204,"Gitwa",321,384,705,3,307,30706,3070602
307060205,"Kajumiro",183,227,410,3,307,30706,3070602
307060206,"Karambi",333,385,718,3,307,30706,3070602
307060207,"Karehe",257,310,567,3,307,30706,3070602
307060208,"Murambi",266,296,562,3,307,30706,3070602
307060301,"Bujanga",442,491,933,3,307,30706,3070603
307060302,"Kabaga",283,328,611,3,307,30706,3070603
307060303,"Kigugu",252,292,544,3,307,30706,3070603
307060304,"Kirambo",348,352,700,3,307,30706,3070603
307060305,"Museke",424,433,857,3,307,30706,3070603
307060306,"Nkero",260,320,580,3,307,30706,3070603
307060307,"Ruganzu",389,418,807,3,307,30706,3070603
307060401,"Baraguma",214,251,465,3,307,30706,3070604
307060402,"Gasihe",363,430,793,3,307,30706,3070604
307060403,"Gasumo",238,288,526,3,307,30706,3070604
307060404,"Kamabuye",372,380,752,3,307,30706,3070604
307060405,"Kamina",249,289,538,3,307,30706,3070604
307060406,"Musasa",397,512,909,3,307,30706,3070604
307060407,"Rambura",252,289,541,3,307,30706,3070604
307060408,"Rugeyo",270,292,562,3,307,30706,3070604
307060501,"Gakenke",345,411,756,3,307,30706,3070605
307060502,"Gatebe",406,467,873,3,307,30706,3070605
307060503,"Kamuramira",292,344,636,3,307,30706,3070605
307060504,"Kibazi",259,295,554,3,307,30706,3070605
307060505,"Marongi",225,275,500,3,307,30706,3070605
307060506,"Nyarubura",324,374,698,3,307,30706,3070605
307060507,"Ruganda",299,340,639,3,307,30706,3070605
307060508,"Wamugeyo",315,399,714,3,307,30706,3070605
307070101,"Bitare",266,329,595,3,307,30707,3070701
307070102,"Gasamba",247,304,551,3,307,30707,3070701
307070103,"Gikangaga",212,288,500,3,307,30707,3070701
307070104,"Gitwa",290,336,626,3,307,30707,3070701
307070105,"Kabeza",249,295,544,3,307,30707,3070701
307070106,"Murambi",268,300,568,3,307,30707,3070701
307070107,"Nyarugenge",275,309,584,3,307,30707,3070701
307070108,"Rurembo",267,357,624,3,307,30707,3070701
307070109,"Ryanyagahangara",232,279,511,3,307,30707,3070701
307070201,"Giti",252,303,555,3,307,30707,3070702
307070202,"Gitwe",242,305,547,3,307,30707,3070702
307070203,"Kamina",167,133,300,3,307,30707,3070702
307070204,"Karongi",315,371,686,3,307,30707,3070702
307070205,"Kibiko",277,317,594,3,307,30707,3070702
307070206,"Mburabuturo",447,466,913,3,307,30707,3070702
307070207,"Rubingo",226,286,512,3,307,30707,3070702
307070208,"Taba",314,365,679,3,307,30707,3070702
307070301,"Bugarama",234,272,506,3,307,30707,3070703
307070302,"Gaseke",254,287,541,3,307,30707,3070703
307070303,"Kamukiza",260,265,525,3,307,30707,3070703
307070304,"Kanombe",263,324,587,3,307,30707,3070703
307070305,"Mugohe",253,274,527,3,307,30707,3070703
307070306,"Munini",299,357,656,3,307,30707,3070703
307070307,"Nyabitare",227,272,499,3,307,30707,3070703
307070308,"Nyarusovu",176,254,430,3,307,30707,3070703
307070309,"Rugano",251,308,559,3,307,30707,3070703
307070310,"Rutiti",215,285,500,3,307,30707,3070703
307070401,"Bizimba",192,243,435,3,307,30707,3070704
307070402,"Cyankuba",318,361,679,3,307,30707,3070704
307070403,"Gituntu",174,252,426,3,307,30707,3070704
307070404,"Kabingo",354,420,774,3,307,30707,3070704
307070405,"Kamagese",200,263,463,3,307,30707,3070704
307070406,"Karambo",168,199,367,3,307,30707,3070704
307070407,"Misirimbo",213,211,424,3,307,30707,3070704
307070408,"Rubona",157,212,369,3,307,30707,3070704
307070409,"Tetero",194,245,439,3,307,30707,3070704
307070410,"Wibungo",167,213,380,3,307,30707,3070704
307070501,"Amizero",352,411,763,3,307,30707,3070705
307070502,"Cyivugiza",170,206,376,3,307,30707,3070705
307070503,"Kageyo",210,273,483,3,307,30707,3070705
307070504,"Nkomero",148,197,345,3,307,30707,3070705
307070505,"Rubyiruko",187,223,410,3,307,30707,3070705
307070506,"Rudaga",212,261,473,3,307,30707,3070705
307070507,"Ruzibira",284,366,650,3,307,30707,3070705
307070508,"Rwunamuka",227,291,518,3,307,30707,3070705
307070509,"Tyazo",246,293,539,3,307,30707,3070705
307080101,"Gitwa",563,612,1175,3,307,30708,3070801
307080102,"Muganza",567,598,1165,3,307,30708,3070801
307080103,"Nyamugari",591,630,1221,3,307,30708,3070801
307080104,"Nyamurira",484,521,1005,3,307,30708,3070801
307080105,"Rubona",503,557,1060,3,307,30708,3070801
307080201,"Kabuye",533,609,1142,3,307,30708,3070802
307080202,"Kanenge",555,592,1147,3,307,30708,3070802
307080203,"Karangiro",386,444,830,3,307,30708,3070802
307080204,"Mwiyando",458,517,975,3,307,30708,3070802
307080205,"Rwinkuba",422,491,913,3,307,30708,3070802
307080301,"Gihaya",279,335,614,3,307,30708,3070803
307080302,"Gitunda",274,323,597,3,307,30708,3070803
307080303,"Mpinga",505,542,1047,3,307,30708,3070803
307080304,"Muhora",280,312,592,3,307,30708,3070803
307080305,"Rujeberi",402,420,822,3,307,30708,3070803
307080306,"Rukunguri",328,363,691,3,307,30708,3070803
307080401,"Boli",404,486,890,3,307,30708,3070804
307080402,"Kabisheshe",598,647,1245,3,307,30708,3070804
307080403,"Karehe",293,337,630,3,307,30708,3070804
307080404,"Mbanda",439,469,908,3,307,30708,3070804
307080405,"Nyabwinshi",201,260,461,3,307,30708,3070804
307080406,"Nyagisozi",251,293,544,3,307,30708,3070804
307080407,"Nyamiyaga",255,288,543,3,307,30708,3070804
307080408,"Rutare",320,407,727,3,307,30708,3070804
307080501,"Gakeri",376,391,767,3,307,30708,3070805
307080502,"Gatagara",245,304,549,3,307,30708,3070805
307080503,"Kamanu",248,287,535,3,307,30708,3070805
307080504,"Nyagafunzo",371,396,767,3,307,30708,3070805
307080505,"Nyagashikura",329,374,703,3,307,30708,3070805
307080506,"Nyarusange",624,653,1277,3,307,30708,3070805
307080507,"Ruhabwa",306,324,630,3,307,30708,3070805
307080508,"Ruhinga",308,334,642,3,307,30708,3070805
307090101,"Buha",342,369,711,3,307,30709,3070901
307090102,"Gitwa",337,375,712,3,307,30709,3070901
307090103,"Kamatare",211,278,489,3,307,30709,3070901
307090104,"Katabaro",306,357,663,3,307,30709,3070901
307090105,"Rugeregere",239,297,536,3,307,30709,3070901
307090106,"Uwakibaba",252,303,555,3,307,30709,3070901
307090107,"Uwamuduru",275,292,567,3,307,30709,3070901
307090108,"Uwamugisha",241,301,542,3,307,30709,3070901
307090201,"Gisenyi",320,403,723,3,307,30709,3070902
307090202,"Kabuga",225,290,515,3,307,30709,3070902
307090203,"Kaburiro",369,432,801,3,307,30709,3070902
307090204,"Karambi",372,404,776,3,307,30709,3070902
307090205,"Mitanga",313,321,634,3,307,30709,3070902
307090206,"Mukoto",311,330,641,3,307,30709,3070902
307090207,"Nduba",780,596,1376,3,307,30709,3070902
307090208,"Rubumba",285,316,601,3,307,30709,3070902
307090209,"Rugote",184,203,387,3,307,30709,3070902
307090301,"Gabiro",301,350,651,3,307,30709,3070903
307090302,"Gacumbi",194,263,457,3,307,30709,3070903
307090303,"Giseke",381,452,833,3,307,30709,3070903
307090304,"Gisesero",280,315,595,3,307,30709,3070903
307090305,"Kigarama",197,223,420,3,307,30709,3070903
307090306,"Nyagacaca",260,294,554,3,307,30709,3070903
307090307,"Nyakabingo",221,258,479,3,307,30709,3070903
307090308,"Rusebeya",268,309,577,3,307,30709,3070903
307090401,"Bunyamanza",299,428,727,3,307,30709,3070904
307090402,"Gisheke",415,492,907,3,307,30709,3070904
307090403,"Gitsimbwe",196,218,414,3,307,30709,3070904
307090404,"Mushungo",223,243,466,3,307,30709,3070904
307090405,"Nyabinaga",297,344,641,3,307,30709,3070904
307090406,"Rubona",308,387,695,3,307,30709,3070904
307090407,"Rwamiko",334,339,673,3,307,30709,3070904
307100101,"Buhoro",195,242,437,3,307,30710,3071001
307100102,"Gaseke",176,263,439,3,307,30710,3071001
307100103,"Gasharu",197,213,410,3,307,30710,3071001
307100104,"Gashwi",211,257,468,3,307,30710,3071001
307100105,"Kabeza",194,227,421,3,307,30710,3071001
307100106,"Kayenzi",242,277,519,3,307,30710,3071001
307100107,"Murama",196,267,463,3,307,30710,3071001
307100108,"Nyakabingo",180,222,402,3,307,30710,3071001
307100109,"Rugarama",221,248,469,3,307,30710,3071001
307100110,"Ryasagahara",164,213,377,3,307,30710,3071001
307100111,"Wimana",288,282,570,3,307,30710,3071001
307100112,"Wingabe",202,232,434,3,307,30710,3071001
307100201,"Kamina",195,230,425,3,307,30710,3071002
307100202,"Kanyenkondo",237,266,503,3,307,30710,3071002
307100203,"Karamba",193,215,408,3,307,30710,3071002
307100204,"Nyabihanga",199,238,437,3,307,30710,3071002
307100205,"Rupango",241,265,506,3,307,30710,3071002
307100206,"Ryagatari",196,234,430,3,307,30710,3071002
307100207,"Ryarugamba",180,210,390,3,307,30710,3071002
307100301,"Kajumiro",242,275,517,3,307,30710,3071003
307100302,"Kanyege",326,365,691,3,307,30710,3071003
307100303,"Mataba",385,424,809,3,307,30710,3071003
307100304,"Musumba",248,281,529,3,307,30710,3071003
307100305,"Mwasa",249,262,511,3,307,30710,3071003
307100306,"Nyarunombe",210,239,449,3,307,30710,3071003
307100307,"Rugote",259,282,541,3,307,30710,3071003
307100308,"Rumamfu",237,279,516,3,307,30710,3071003
307100309,"Rwankuba",200,212,412,3,307,30710,3071003
307100401,"Bitaba",208,258,466,3,307,30710,3071004
307100402,"Bunyamanza",136,233,369,3,307,30710,3071004
307100403,"Butare",216,271,487,3,307,30710,3071004
307100404,"Gatyazo",179,242,421,3,307,30710,3071004
307100405,"Gitwa",224,247,471,3,307,30710,3071004
307100406,"Kabuga",201,211,412,3,307,30710,3071004
307100407,"Kazimba",193,229,422,3,307,30710,3071004
307100408,"Kirehe",349,411,760,3,307,30710,3071004
307100409,"Matare",172,191,363,3,307,30710,3071004
307100410,"Munimba",198,228,426,3,307,30710,3071004
307100411,"Nyakariba",262,262,524,3,307,30710,3071004
307100412,"Rusozi",213,254,467,3,307,30710,3071004
307100413,"Rutaragwe",148,201,349,3,307,30710,3071004
307100414,"Rwambogo",213,246,459,3,307,30710,3071004
307100415,"Rwamiko",264,292,556,3,307,30710,3071004
307100501,"Bitega",160,182,342,3,307,30710,3071005
307100502,"Bizi",237,282,519,3,307,30710,3071005
307100503,"Cyijima",345,332,677,3,307,30710,3071005
307100504,"Kagarama",214,213,427,3,307,30710,3071005
307100505,"Kigandi",239,270,509,3,307,30710,3071005
307100506,"Kirambira",191,253,444,3,307,30710,3071005
307100507,"Nkuro",202,228,430,3,307,30710,3071005
307100508,"Nyagahinga",303,305,608,3,307,30710,3071005
307100509,"Nyarusange",304,321,625,3,307,30710,3071005
307100510,"Wisovu",204,235,439,3,307,30710,3071005
307110101,"Fumba",326,379,705,3,307,30711,3071101
307110102,"Giko",134,161,295,3,307,30711,3071101
307110103,"Gisebeya",202,211,413,3,307,30711,3071101
307110104,"Kamashinge",238,289,527,3,307,30711,3071101
307110105,"Kanyoni",185,196,381,3,307,30711,3071101
307110106,"Kivumu",277,305,582,3,307,30711,3071101
307110107,"Muramba",302,352,654,3,307,30711,3071101
307110108,"Nyabumera",160,187,347,3,307,30711,3071101
307110201,"Gabiro",344,331,675,3,307,30711,3071102
307110202,"Gasharu",298,317,615,3,307,30711,3071102
307110203,"Giti",227,261,488,3,307,30711,3071102
307110204,"Kanombe",194,276,470,3,307,30711,3071102
307110205,"Kigara",108,121,229,3,307,30711,3071102
307110206,"Mikingo",253,286,539,3,307,30711,3071102
307110207,"Nyamiheha",253,298,551,3,307,30711,3071102
307110208,"Ruhanga",147,197,344,3,307,30711,3071102
307110209,"Rukaragata",226,263,489,3,307,30711,3071102
307110301,"Gatare",236,274,510,3,307,30711,3071103
307110302,"Karambo",165,205,370,3,307,30711,3071103
307110303,"Kizenga",207,251,458,3,307,30711,3071103
307110304,"Murundo",239,254,493,3,307,30711,3071103
307110305,"Nyagahima",195,220,415,3,307,30711,3071103
307110306,"Nyakabande",132,173,305,3,307,30711,3071103
307110307,"Uwamaheke",190,231,421,3,307,30711,3071103
307110401,"Bigali",172,215,387,3,307,30711,3071104
307110402,"Bisharara",295,328,623,3,307,30711,3071104
307110403,"Bungo",208,244,452,3,307,30711,3071104
307110404,"Cyinjira",214,249,463,3,307,30711,3071104
307110405,"Cyiya",246,284,530,3,307,30711,3071104
307110406,"Gitwa",232,249,481,3,307,30711,3071104
307110407,"Nyarusiza",289,344,633,3,307,30711,3071104
307120101,"Bunyenga",261,329,590,3,307,30712,3071201
307120102,"Butsure",356,425,781,3,307,30712,3071201
307120103,"Cyamuti",229,334,563,3,307,30712,3071201
307120104,"Kabarore",350,399,749,3,307,30712,3071201
307120105,"Kamahongo",230,247,477,3,307,30712,3071201
307120106,"Kigarama",267,327,594,3,307,30712,3071201
307120107,"Mariba",275,321,596,3,307,30712,3071201
307120108,"Murambi",222,268,490,3,307,30712,3071201
307120109,"Ruginga",225,282,507,3,307,30712,3071201
307120110,"Rweru",216,287,503,3,307,30712,3071201
307120201,"Gahwazi",197,213,410,3,307,30712,3071202
307120202,"Gasebeya",172,210,382,3,307,30712,3071202
307120203,"Gashashi",161,219,380,3,307,30712,3071202
307120204,"Kabanda",233,265,498,3,307,30712,3071202
307120205,"Kagarama",248,292,540,3,307,30712,3071202
307120206,"Karambi",177,214,391,3,307,30712,3071202
307120207,"Kibanda",254,268,522,3,307,30712,3071202
307120208,"Mukarange",294,304,598,3,307,30712,3071202
307120209,"Muremure",192,229,421,3,307,30712,3071202
307120210,"Rugarama",255,321,576,3,307,30712,3071202
307120211,"Shenyeri",302,336,638,3,307,30712,3071202
307120301,"Buhinga",267,347,614,3,307,30712,3071203
307120302,"Gahuhezi",244,277,521,3,307,30712,3071203
307120303,"Gakoma",270,287,557,3,307,30712,3071203
307120304,"Kabacuzi",355,441,796,3,307,30712,3071203
307120305,"Kabukunzi",318,329,647,3,307,30712,3071203
307120306,"Kamabera",255,315,570,3,307,30712,3071203
307120307,"Kamuhoza",137,198,335,3,307,30712,3071203
307120308,"Karango",374,425,799,3,307,30712,3071203
307120309,"Mataba",228,360,588,3,307,30712,3071203
307120310,"Murenge",300,335,635,3,307,30712,3071203
307120311,"Nyarusange",313,344,657,3,307,30712,3071203
307120401,"Buhokoro",213,256,469,3,307,30712,3071204
307120402,"Bukiro",181,209,390,3,307,30712,3071204
307120403,"Bukuri",166,189,355,3,307,30712,3071204
307120404,"Gafunzo",281,359,640,3,307,30712,3071204
307120405,"Gahabwa",324,341,665,3,307,30712,3071204
307120406,"Gikombe",250,307,557,3,307,30712,3071204
307120407,"Kazibo",181,185,366,3,307,30712,3071204
307120408,"Nyange",159,183,342,3,307,30712,3071204
307120409,"Taba",319,364,683,3,307,30712,3071204
307120410,"Tundwe",276,313,589,3,307,30712,3071204
307120501,"Bugiga",215,297,512,3,307,30712,3071205
307120502,"Buhinga",222,252,474,3,307,30712,3071205
307120503,"Kankoni",228,253,481,3,307,30712,3071205
307120504,"Kanombe",243,318,561,3,307,30712,3071205
307120505,"Kayenzi",193,250,443,3,307,30712,3071205
307120506,"Murambi",239,282,521,3,307,30712,3071205
307120507,"Nyamirundi",248,338,586,3,307,30712,3071205
307120508,"Rebero",219,293,512,3,307,30712,3071205
307120509,"Ruhonga",309,389,698,3,307,30712,3071205
307120510,"Taba",319,377,696,3,307,30712,3071205
307130101,"Bururi",311,341,652,3,307,30713,3071301
307130102,"Gahira",375,415,790,3,307,30713,3071301
307130103,"Gasumo",266,369,635,3,307,30713,3071301
307130104,"Nkamba",360,413,773,3,307,30713,3071301
307130105,"Uwakagano",348,367,715,3,307,30713,3071301
307130201,"Gahisi",255,283,538,3,307,30713,3071302
307130202,"Gasovu",309,369,678,3,307,30713,3071302
307130203,"Kamatsira",305,364,669,3,307,30713,3071302
307130204,"Ruhana",233,315,548,3,307,30713,3071302
307130205,"Rwasa",358,396,754,3,307,30713,3071302
307130301,"Gasebeya",240,299,539,3,307,30713,3071303
307130302,"Gatagara",269,344,613,3,307,30713,3071303
307130303,"Kaneke",253,341,594,3,307,30713,3071303
307130304,"Kibavu",301,353,654,3,307,30713,3071303
307130305,"Rudehero",302,347,649,3,307,30713,3071303
307130306,"Rugomero",354,393,747,3,307,30713,3071303
307130401,"Bigeyo",167,216,383,3,307,30713,3071304
307130402,"Bunyenyezi",202,263,465,3,307,30713,3071304
307130403,"Munini",279,302,581,3,307,30713,3071304
307130404,"Murambi",784,482,1266,3,307,30713,3071304
307130405,"Nyakabingo",274,330,604,3,307,30713,3071304
307130406,"Nyarwungo",205,284,489,3,307,30713,3071304
307130407,"Ryarubasha",246,284,530,3,307,30713,3071304
307140101,"Gashwati",238,318,556,3,307,30714,3071401
307140102,"Gitaba",252,313,565,3,307,30714,3071401
307140103,"Kadashya",294,326,620,3,307,30714,3071401
307140104,"Kamuhumuza",209,238,447,3,307,30714,3071401
307140105,"Karambo",183,241,424,3,307,30714,3071401
307140106,"Rubiha",289,360,649,3,307,30714,3071401
307140107,"Rukerereza",100,119,219,3,307,30714,3071401
307140108,"Rusambu",189,227,416,3,307,30714,3071401
307140109,"Rwamahwa",244,271,515,3,307,30714,3071401
307140110,"Ryamashuri",186,229,415,3,307,30714,3071401
307140201,"Gasharu",171,247,418,3,307,30714,3071402
307140202,"Kacyiru",702,597,1299,3,307,30714,3071402
307140203,"Kagarama",173,218,391,3,307,30714,3071402
307140204,"Kamabuye",240,314,554,3,307,30714,3071402
307140205,"Kamonyi",209,223,432,3,307,30714,3071402
307140206,"Karambi",165,214,379,3,307,30714,3071402
307140207,"Kigabiro",163,165,328,3,307,30714,3071402
307140208,"Kigenge",190,212,402,3,307,30714,3071402
307140209,"Muko",302,345,647,3,307,30714,3071402
307140210,"Nganzo",320,412,732,3,307,30714,3071402
307140211,"Risansi",234,289,523,3,307,30714,3071402
307140212,"Rukoma",180,221,401,3,307,30714,3071402
307140213,"Wimpundu",297,299,596,3,307,30714,3071402
307140301,"Bigutu",163,178,341,3,307,30714,3071403
307140302,"Gihinga",199,251,450,3,307,30714,3071403
307140303,"Giko",235,280,515,3,307,30714,3071403
307140304,"Kanyovu",176,200,376,3,307,30714,3071403
307140305,"Manzi",262,292,554,3,307,30714,3071403
307140306,"Munini",289,315,604,3,307,30714,3071403
307140307,"Nkomero",252,273,525,3,307,30714,3071403
307140308,"Nyamuhunga",245,339,584,3,307,30714,3071403
307140309,"Save",202,287,489,3,307,30714,3071403
307140401,"Gacyamo",215,254,469,3,307,30714,3071404
307140402,"Gakomeye ",300,344,644,3,307,30714,3071404
307140403,"Gasumo",151,186,337,3,307,30714,3071404
307140404,"Gatanga",124,166,290,3,307,30714,3071404
307140405,"Gikundamvura ",141,172,313,3,307,30714,3071404
307140406,"Kabusunzu",236,246,482,3,307,30714,3071404
307140407,"Kamudende",160,189,349,3,307,30714,3071404
307140408,"Mpinga",132,160,292,3,307,30714,3071404
307140409,"Murambi",196,232,428,3,307,30714,3071404
307140410,"Ngoboka",250,289,539,3,307,30714,3071404
307140411,"Nkomero",198,263,461,3,307,30714,3071404
307140412,"Nyarushwati",211,215,426,3,307,30714,3071404
307140413,"Rugabano",202,221,423,3,307,30714,3071404
307140414,"Rumuna",228,237,465,3,307,30714,3071404
307140415,"Ryangange",178,200,378,3,307,30714,3071404
307150101,"Busangati",347,430,777,3,307,30715,3071501
307150102,"Gikombe",230,270,500,3,307,30715,3071501
307150103,"Kabahande",256,299,555,3,307,30715,3071501
307150104,"Nyakagano",394,448,842,3,307,30715,3071501
307150105,"Nyakibingo",223,326,549,3,307,30715,3071501
307150106,"Rubayi",342,401,743,3,307,30715,3071501
307150107,"Rukohwa",372,396,768,3,307,30715,3071501
307150201,"Gabiro",315,372,687,3,307,30715,3071502
307150202,"Gasumo",319,360,679,3,307,30715,3071502
307150203,"Mataba",321,376,697,3,307,30715,3071502
307150204,"Mpishyi",307,386,693,3,307,30715,3071502
307150205,"Ruzinga",272,321,593,3,307,30715,3071502
307150206,"Rwabagoyi",306,361,667,3,307,30715,3071502
307150301,"Bweranyange",380,442,822,3,307,30715,3071503
307150302,"Karugero",397,442,839,3,307,30715,3071503
307150303,"Karuhatana",321,449,770,3,307,30715,3071503
307150304,"Karuhigi",381,472,853,3,307,30715,3071503
307150305,"Kavo",423,430,853,3,307,30715,3071503
307150306,"Rwonga",325,367,692,3,307,30715,3071503
307150401,"Amahoro",316,413,729,3,307,30715,3071504
307150402,"Bitaba",344,472,816,3,307,30715,3071504
307150403,"Kabare",326,421,747,3,307,30715,3071504
307150404,"Mpande",316,393,709,3,307,30715,3071504
307150405,"Nyamateke",364,414,778,3,307,30715,3071504
307150406,"Nyamihondo",306,386,692,3,307,30715,3071504
307150407,"Rubavu",361,487,848,3,307,30715,3071504
307150501,"Bugomba",397,497,894,3,307,30715,3071505
307150502,"Busasamana",623,862,1485,3,307,30715,3071505
307150503,"Gasharu",309,392,701,3,307,30715,3071505
307150504,"Kabere",497,354,851,3,307,30715,3071505
307150505,"Karambo",395,415,810,3,307,30715,3071505
307150506,"Ngoboka",442,470,912,3,307,30715,3071505
307150507,"Taba",326,408,734,3,307,30715,3071505
401010101,"Bukangano",235,271,506,4,401,40101,4010101
401010102,"Buramba",263,323,586,4,401,40101,4010101
401010103,"Gihemba",385,458,843,4,401,40101,4010101
401010104,"Gitwa",196,244,440,4,401,40101,4010101
401010105,"Kabingo",251,292,543,4,401,40101,4010101
401010106,"Kabuga",131,170,301,4,401,40101,4010101
401010107,"Musenyi",120,169,289,4,401,40101,4010101
401010108,"Mushongi",326,372,698,4,401,40101,4010101
401010109,"Nyangoyi",203,293,496,4,401,40101,4010101
401010110,"Rubanda",269,337,606,4,401,40101,4010101
401010201,"Bushyiga",278,328,606,4,401,40101,4010102
401010202,"Gatete",188,261,449,4,401,40101,4010102
401010203,"Gihora",182,177,359,4,401,40101,4010102
401010204,"Gisiza",184,251,435,4,401,40101,4010102
401010205,"Kirwa",263,299,562,4,401,40101,4010102
401010206,"Mugenda I",225,270,495,4,401,40101,4010102
401010207,"Mugenda Ii",201,224,425,4,401,40101,4010102
401010208,"Nyamugali",170,227,397,4,401,40101,4010102
401010209,"Rugaragara",179,212,391,4,401,40101,4010102
401010210,"Rugerero",228,295,523,4,401,40101,4010102
401010301,"Base",248,294,542,4,401,40101,4010103
401010302,"Cyondo",328,405,733,4,401,40101,4010103
401010303,"Gitovu",262,337,599,4,401,40101,4010103
401010304,"Kabahama",358,457,815,4,401,40101,4010103
401010305,"Kabeza",251,302,553,4,401,40101,4010103
401010306,"Karambi",435,524,959,4,401,40101,4010103
401010307,"Kiruli",477,506,983,4,401,40101,4010103
401010308,"Mutima",297,376,673,4,401,40101,4010103
401020101,"Gacyamo",189,190,379,4,401,40102,4010201
401020102,"Gashinge",150,153,303,4,401,40102,4010201
401020103,"Karambi",129,124,253,4,401,40102,4010201
401020104,"Karugaju",123,142,265,4,401,40102,4010201
401020105,"Kerera",148,146,294,4,401,40102,4010201
401020106,"Kibiraro",123,183,306,4,401,40102,4010201
401020107,"Kigabiro",194,215,409,4,401,40102,4010201
401020108,"Kigarama",133,145,278,4,401,40102,4010201
401020109,"Kisigiro",178,205,383,4,401,40102,4010201
401020110,"Mayaga",201,242,443,4,401,40102,4010201
401020111,"Muduha",98,130,228,4,401,40102,4010201
401020112,"Muhondo",135,134,269,4,401,40102,4010201
401020113,"Nyamiyaga",109,134,243,4,401,40102,4010201
401020114,"Runyinya",94,153,247,4,401,40102,4010201
401020201,"Bugoboka",156,149,305,4,401,40102,4010202
401020202,"Byerwa",147,161,308,4,401,40102,4010202
401020203,"Gasare",208,188,396,4,401,40102,4010202
401020204,"Gasharu",140,154,294,4,401,40102,4010202
401020205,"Gashinge",117,145,262,4,401,40102,4010202
401020206,"Gatete",105,106,211,4,401,40102,4010202
401020207,"Kantabo",117,154,271,4,401,40102,4010202
401020208,"Kanunga",147,152,299,4,401,40102,4010202
401020209,"Kizenga",178,175,353,4,401,40102,4010202
401020210,"Kiziba",162,163,325,4,401,40102,4010202
401020211,"Mataba",177,163,340,4,401,40102,4010202
401020212,"Mitabi",174,172,346,4,401,40102,4010202
401020213,"Mukarange",142,177,319,4,401,40102,4010202
401020214,"Rwamiko",175,170,345,4,401,40102,4010202
401020301,"Bugarama",120,169,289,4,401,40102,4010203
401020302,"Cyinzuzi",135,129,264,4,401,40102,4010203
401020303,"Gasango",144,194,338,4,401,40102,4010203
401020304,"Kiboha",153,151,304,4,401,40102,4010203
401020305,"Kivomo",115,133,248,4,401,40102,4010203
401020306,"Mwenene",113,117,230,4,401,40102,4010203
401020307,"Mwite",133,156,289,4,401,40102,4010203
401020308,"Ngange",163,198,361,4,401,40102,4010203
401020309,"Nyagisozi",178,197,375,4,401,40102,4010203
401020310,"Rubara",145,158,303,4,401,40102,4010203
401020311,"Rusine",117,141,258,4,401,40102,4010203
401020312,"Ryinzovu",146,155,301,4,401,40102,4010203
401030101,"Budaha",307,404,711,4,401,40103,4010301
401030102,"Buhande ",289,312,601,4,401,40103,4010301
401030103,"Gitwa",272,284,556,4,401,40103,4010301
401030104,"Karambi",330,370,700,4,401,40103,4010301
401030105,"Remera",353,389,742,4,401,40103,4010301
401030106,"Ruhanga",322,344,666,4,401,40103,4010301
401030107,"Rulindo",212,325,537,4,401,40103,4010301
401030201,"Buramira",225,294,519,4,401,40103,4010302
401030202,"Cyiri",260,350,610,4,401,40103,4010302
401030203,"Gashiru",225,267,492,4,401,40103,4010302
401030204,"Karambo",172,211,383,4,401,40103,4010302
401030205,"Kigamba",335,394,729,4,401,40103,4010302
401030206,"Kivomo",188,212,400,4,401,40103,4010302
401030207,"Ngarama",235,249,484,4,401,40103,4010302
401030208,"Rugote",288,346,634,4,401,40103,4010302
401030301,"Gitaba",202,237,439,4,401,40103,4010303
401030302,"Muduha",280,391,671,4,401,40103,4010303
401030303,"Murambo",325,294,619,4,401,40103,4010303
401030304,"Rebero",309,366,675,4,401,40103,4010303
401030305,"Rwanzu",372,361,733,4,401,40103,4010303
401030401,"Buvumo",232,258,490,4,401,40103,4010304
401030402,"Buyogoma",274,321,595,4,401,40103,4010304
401030403,"Gatare",184,256,440,4,401,40103,4010304
401030404,"Marembo",207,179,386,4,401,40103,4010304
401030405,"Muko",235,270,505,4,401,40103,4010304
401030406,"Mukoto",255,302,557,4,401,40103,4010304
401030407,"Rusave",184,232,416,4,401,40103,4010304
401030501,"Bubiro",244,316,560,4,401,40103,4010305
401030502,"Byimana",183,206,389,4,401,40103,4010305
401030503,"Gatenga",92,123,215,4,401,40103,4010305
401030504,"Gifuba",232,270,502,4,401,40103,4010305
401030505,"Karambi",148,152,300,4,401,40103,4010305
401030506,"Nyenyeri",126,156,282,4,401,40103,4010305
401030507,"Nyirangarama",394,287,681,4,401,40103,4010305
401030508,"Remera",169,229,398,4,401,40103,4010305
401030509,"Tare",206,232,438,4,401,40103,4010305
401030510,"Terambere",209,252,461,4,401,40103,4010305
401040101,"Gashana",284,285,569,4,401,40104,4010401
401040102,"Gatwa",192,227,419,4,401,40104,4010401
401040103,"Karambo",261,303,564,4,401,40104,4010401
401040104,"Kibanda",272,318,590,4,401,40104,4010401
401040105,"Rugarama",403,403,806,4,401,40104,4010401
401040201,"Gasave",232,265,497,4,401,40104,4010402
401040202,"Giko",262,248,510,4,401,40104,4010402
401040203,"Kankanga",305,316,621,4,401,40104,4010402
401040204,"Karambi",195,219,414,4,401,40104,4010402
401040205,"Ryanyirakayobe",177,203,380,4,401,40104,4010402
401040301,"Bunyana",328,403,731,4,401,40104,4010403
401040302,"Gatare",300,353,653,4,401,40104,4010403
401040303,"Gatenderi",281,309,590,4,401,40104,4010403
401040304,"Gipfundo",294,339,633,4,401,40104,4010403
401040305,"Gitabura",272,297,569,4,401,40104,4010403
401040306,"Shagasha",416,448,864,4,401,40104,4010403
401040401,"Gitaba",315,452,767,4,401,40104,4010404
401040402,"Munini",284,356,640,4,401,40104,4010404
401040403,"Nyarubuye",295,370,665,4,401,40104,4010404
401040404,"Remera",251,298,549,4,401,40104,4010404
401040405,"Rutabo",238,291,529,4,401,40104,4010404
401040501,"Cyasenge",271,325,596,4,401,40104,4010405
401040502,"Kajeneni",313,393,706,4,401,40104,4010405
401040503,"Karambi",161,192,353,4,401,40104,4010405
401040504,"Karambo",311,324,635,4,401,40104,4010405
401040505,"Kavumo",165,199,364,4,401,40104,4010405
401040506,"Kigarama",247,291,538,4,401,40104,4010405
401040601,"Gakoma",342,371,713,4,401,40104,4010406
401040602,"Mataba",402,396,798,4,401,40104,4010406
401040603,"Murambo",270,334,604,4,401,40104,4010406
401040604,"Nyamwiza",283,303,586,4,401,40104,4010406
401040605,"Nyarubuye",363,422,785,4,401,40104,4010406
401040701,"Gahondo",195,245,440,4,401,40104,4010407
401040702,"Gikingo",253,314,567,4,401,40104,4010407
401040703,"Kagozi",327,344,671,4,401,40104,4010407
401040704,"Karambi",171,189,360,4,401,40104,4010407
401040705,"Kimagali",215,290,505,4,401,40104,4010407
401050101,"Gatagara",257,314,571,4,401,40105,4010501
401050102,"Gihinga",301,346,647,4,401,40105,4010501
401050103,"Kamatongo",339,352,691,4,401,40105,4010501
401050104,"Kanyoni",182,208,390,4,401,40105,4010501
401050105,"Kavumu",294,319,613,4,401,40105,4010501
401050106,"Kigarama",323,338,661,4,401,40105,4010501
401050107,"Nyakabanga",286,284,570,4,401,40105,4010501
401050108,"Rugaragara",258,313,571,4,401,40105,4010501
401050201,"Cyanya",190,206,396,4,401,40105,4010502
401050202,"Gitabage",311,334,645,4,401,40105,4010502
401050203,"Karambo",198,266,464,4,401,40105,4010502
401050204,"Marembo",237,280,517,4,401,40105,4010502
401050205,"Ngabitsinze",184,210,394,4,401,40105,4010502
401050206,"Nyamugali",193,248,441,4,401,40105,4010502
401050207,"Remera",293,347,640,4,401,40105,4010502
401050208,"Rusagara",270,322,592,4,401,40105,4010502
401050301,"Gasekabuye",367,385,752,4,401,40105,4010503
401050302,"Gaseke",244,246,490,4,401,40105,4010503
401050303,"Gasizi",244,298,542,4,401,40105,4010503
401050304,"Gihuke",212,266,478,4,401,40105,4010503
401050305,"Kirambo",227,272,499,4,401,40105,4010503
401050306,"Munini",266,235,501,4,401,40105,4010503
401050307,"Munoga",162,228,390,4,401,40105,4010503
401050308,"Musenyi",210,281,491,4,401,40105,4010503
401060101,"Gitandi",174,254,428,4,401,40106,4010601
401060102,"Karambo",223,273,496,4,401,40106,4010601
401060103,"Karengeri",126,140,266,4,401,40106,4010601
401060104,"Kibande",122,175,297,4,401,40106,4010601
401060105,"Kibogora",248,264,512,4,401,40106,4010601
401060106,"Nyagatovu",331,364,695,4,401,40106,4010601
401060107,"Sove",291,332,623,4,401,40106,4010601
401060201,"Buyaga",290,343,633,4,401,40106,4010602
401060202,"Gahinga",294,331,625,4,401,40106,4010602
401060203,"Kibuye",280,312,592,4,401,40106,4010602
401060204,"Kidomo",281,329,610,4,401,40106,4010602
401060205,"Murambo",316,394,710,4,401,40106,4010602
401060206,"Nganzo",283,331,614,4,401,40106,4010602
401060207,"Rugaragara",327,356,683,4,401,40106,4010602
401060208,"Rusayu",278,354,632,4,401,40106,4010602
401060301,"Kabanda",287,346,633,4,401,40106,4010603
401060302,"Karambi",355,369,724,4,401,40106,4010603
401060303,"Kirwa",308,341,649,4,401,40106,4010603
401060304,"Kivumu",253,295,548,4,401,40106,4010603
401060305,"Nturo",390,455,845,4,401,40106,4010603
401060306,"Nyabisasa",180,238,418,4,401,40106,4010603
401060307,"Sakara",195,290,485,4,401,40106,4010603
401070101,"Akamiyove",224,255,479,4,401,40107,4010701
401070102,"Barayi",246,307,553,4,401,40107,4010701
401070103,"Bunahi",229,292,521,4,401,40107,4010701
401070104,"Gisekuru",251,284,535,4,401,40107,4010701
401070105,"Kinihira",239,248,487,4,401,40107,4010701
401070106,"Ndorandi",281,323,604,4,401,40107,4010701
401070201,"Buhita",341,374,715,4,401,40107,4010702
401070202,"Bwishya",395,373,768,4,401,40107,4010702
401070203,"Gatembe",262,309,571,4,401,40107,4010702
401070204,"Magezi",263,300,563,4,401,40107,4010702
401070205,"Mutoyi",231,234,465,4,401,40107,4010702
401070206,"Ntunguru",311,360,671,4,401,40107,4010702
401070301,"Buhunde",331,371,702,4,401,40107,4010703
401070302,"Cyogo",314,403,717,4,401,40107,4010703
401070303,"Gatare",285,310,595,4,401,40107,4010703
401070304,"Kigali",324,379,703,4,401,40107,4010703
401070305,"Kiyebe",297,349,646,4,401,40107,4010703
401070401,"Kabuga",384,444,828,4,401,40107,4010704
401070402,"Karambi",299,386,685,4,401,40107,4010704
401070403,"Kirwa",373,458,831,4,401,40107,4010704
401070404,"Ndusu",305,327,632,4,401,40107,4010704
401070405,"Rugundu",302,389,691,4,401,40107,4010704
401070406,"Taba",229,255,484,4,401,40107,4010704
401080101,"Kabere",335,342,677,4,401,40108,4010801
401080102,"Ndago",238,278,516,4,401,40108,4010801
401080103,"Ruberano",238,299,537,4,401,40108,4010801
401080104,"Rwili",185,196,381,4,401,40108,4010801
401080201,"Gakenke",353,360,713,4,401,40108,4010802
401080202,"Gatete",277,285,562,4,401,40108,4010802
401080203,"Gatovu",272,336,608,4,401,40108,4010802
401080204,"Kabeza",244,260,504,4,401,40108,4010802
401080205,"Karambi",333,349,682,4,401,40108,4010802
401080206,"Songa",152,163,315,4,401,40108,4010802
401080207,"Wamahoro",271,268,539,4,401,40108,4010802
401080301,"Gaseke",229,283,512,4,401,40108,4010803
401080302,"Gasharu",248,255,503,4,401,40108,4010803
401080303,"Nyantabo",278,331,609,4,401,40108,4010803
401080304,"Runyinya",281,341,622,4,401,40108,4010803
401080305,"Rwintare",327,390,717,4,401,40108,4010803
401080401,"Gako",347,351,698,4,401,40108,4010804
401080402,"Kibuye",302,381,683,4,401,40108,4010804
401080403,"Kirenge",267,278,545,4,401,40108,4010804
401080404,"Murambi",264,284,548,4,401,40108,4010804
401080405,"Nyakarekare",307,311,618,4,401,40108,4010804
401080406,"Rutabo",294,302,596,4,401,40108,4010804
401080501,"Akamanama",281,321,602,4,401,40108,4010805
401080502,"Gishinge",308,307,615,4,401,40108,4010805
401080503,"Karambi",340,381,721,4,401,40108,4010805
401080504,"Kibingwe",178,227,405,4,401,40108,4010805
401080505,"Mugomero",355,410,765,4,401,40108,4010805
401080506,"Ryarubuguza",240,281,521,4,401,40108,4010805
401080601,"Cyasuri",229,284,513,4,401,40108,4010806
401080602,"Kibanda",206,241,447,4,401,40108,4010806
401080603,"Nyamiyaga",174,223,397,4,401,40108,4010806
401080604,"Rugarama",203,239,442,4,401,40108,4010806
401080605,"Rusongati",353,398,751,4,401,40108,4010806
401080606,"Rusumo",213,253,466,4,401,40108,4010806
401090101,"Gisiza",234,256,490,4,401,40109,4010901
401090102,"Kanunga",284,314,598,4,401,40109,4010901
401090103,"Karambi",225,258,483,4,401,40109,4010901
401090104,"Kigarama",300,323,623,4,401,40109,4010901
401090105,"Nyakibande",239,252,491,4,401,40109,4010901
401090106,"Nyakizu",309,343,652,4,401,40109,4010901
401090107,"Rubaya",296,299,595,4,401,40109,4010901
401090201,"Gacyamo",381,407,788,4,401,40109,4010902
401090202,"Marenge",335,401,736,4,401,40109,4010902
401090203,"Nyakabungo",328,459,787,4,401,40109,4010902
401090204,"Rukurazo",372,399,771,4,401,40109,4010902
401090301,"Gasenga",485,539,1024,4,401,40109,4010903
401090302,"Musega",318,349,667,4,401,40109,4010903
401090303,"Nyarurembo",443,624,1067,4,401,40109,4010903
401090304,"Rebero",582,551,1133,4,401,40109,4010903
401090401,"Kabeza",207,231,438,4,401,40109,4010904
401090402,"Kabuga",294,276,570,4,401,40109,4010904
401090403,"Kigomwa",331,373,704,4,401,40109,4010904
401090404,"Marembo",230,279,509,4,401,40109,4010904
401090405,"Rusenyi",243,285,528,4,401,40109,4010904
401090501,"Agasharu",274,318,592,4,401,40109,4010905
401090502,"Amataba",273,324,597,4,401,40109,4010905
401090503,"Nyabinyana",316,361,677,4,401,40109,4010905
401090504,"Rusine",342,393,735,4,401,40109,4010905
401090505,"Umubuga",307,327,634,4,401,40109,4010905
401090506,"Umutagata",199,226,425,4,401,40109,4010905
401100101,"Buhira",135,144,279,4,401,40110,4011001
401100102,"Bukoro",342,356,698,4,401,40110,4011001
401100103,"Gasama",249,276,525,4,401,40110,4011001
401100104,"Gihonga",186,199,385,4,401,40110,4011001
401100105,"Kalindi",217,265,482,4,401,40110,4011001
401100106,"Kibamba",310,382,692,4,401,40110,4011001
401100107,"Kibaya",226,266,492,4,401,40110,4011001
401100108,"Kinini Ya Mbogo",103,131,234,4,401,40110,4011001
401100109,"Ruhanya",214,285,499,4,401,40110,4011001
401100110,"Rwambogo",223,262,485,4,401,40110,4011001
401100201,"Bukongi",311,310,621,4,401,40110,4011002
401100202,"Buraro",256,300,556,4,401,40110,4011002
401100203,"Buyanja",251,261,512,4,401,40110,4011002
401100204,"Gitaba",186,234,420,4,401,40110,4011002
401100205,"Nkurura",221,291,512,4,401,40110,4011002
401100206,"Nyakabuye",240,249,489,4,401,40110,4011002
401100207,"Rwambogo",109,150,259,4,401,40110,4011002
401100301,"Gasovu",168,203,371,4,401,40110,4011003
401100302,"Gikombe",266,318,584,4,401,40110,4011003
401100303,"Gisha",237,273,510,4,401,40110,4011003
401100304,"Kibungo",265,312,577,4,401,40110,4011003
401100305,"Muhora",217,230,447,4,401,40110,4011003
401100306,"Nyakabembe",238,255,493,4,401,40110,4011003
401100307,"Yaramba",219,211,430,4,401,40110,4011003
401100401,"Gakoma",281,299,580,4,401,40110,4011004
401100402,"Gicumbi",264,282,546,4,401,40110,4011004
401100403,"Gitaba",335,396,731,4,401,40110,4011004
401100404,"Karehe",255,287,542,4,401,40110,4011004
401100405,"Munini",226,263,489,4,401,40110,4011004
401100406,"Ruhondo",345,368,713,4,401,40110,4011004
401100407,"Rurenge",244,304,548,4,401,40110,4011004
401100408,"Rutonde",215,243,458,4,401,40110,4011004
401110101,"Gashubi",236,208,444,4,401,40111,4011101
401110102,"Karambo",264,265,529,4,401,40111,4011101
401110103,"Karwa",314,340,654,4,401,40111,4011101
401110104,"Mayange",175,224,399,4,401,40111,4011101
401110105,"Nyagisozi",257,290,547,4,401,40111,4011101
401110106,"Rebero",231,303,534,4,401,40111,4011101
401110107,"Ruhunga",199,238,437,4,401,40111,4011101
401110108,"Taba",309,342,651,4,401,40111,4011101
401110201,"Agatare",255,315,570,4,401,40111,4011102
401110202,"Akarambi",271,301,572,4,401,40111,4011102
401110203,"Amataba",227,233,460,4,401,40111,4011102
401110204,"Gisiza",220,266,486,4,401,40111,4011102
401110205,"Kabeza",233,286,519,4,401,40111,4011102
401110206,"Karambo",340,355,695,4,401,40111,4011102
401110207,"Kigarama",260,330,590,4,401,40111,4011102
401110301,"Amahoro",133,196,329,4,401,40111,4011103
401110302,"Buliza",316,376,692,4,401,40111,4011103
401110303,"Gahama",189,210,399,4,401,40111,4011103
401110304,"Gashinge",359,414,773,4,401,40111,4011103
401110305,"Kigarama",258,314,572,4,401,40111,4011103
401110306,"Nyarurembo",353,323,676,4,401,40111,4011103
401110307,"Ruri",255,371,626,4,401,40111,4011103
401110401,"Iraro",246,291,537,4,401,40111,4011104
401110402,"Kabeza",149,189,338,4,401,40111,4011104
401110403,"Kabuga",327,346,673,4,401,40111,4011104
401110404,"Munyinya",215,232,447,4,401,40111,4011104
401110405,"Mutabo",169,199,368,4,401,40111,4011104
401110406,"Ntyaba",210,246,456,4,401,40111,4011104
401110407,"Rurama",209,267,476,4,401,40111,4011104
401120101,"Gatete",129,147,276,4,401,40112,4011201
401120102,"Kagarama",161,192,353,4,401,40112,4011201
401120103,"Kirambo",236,244,480,4,401,40112,4011201
401120104,"Kiruli",254,274,528,4,401,40112,4011201
401120105,"Nyabuko",227,237,464,4,401,40112,4011201
401120106,"Rubona",221,296,517,4,401,40112,4011201
401120201,"Butare",134,203,337,4,401,40112,4011202
401120202,"Jyambere",211,226,437,4,401,40112,4011202
401120203,"Kagwa",192,223,415,4,401,40112,4011202
401120204,"Karambi",195,216,411,4,401,40112,4011202
401120205,"Marebe",233,271,504,4,401,40112,4011202
401120206,"Nyakagezi",174,234,408,4,401,40112,4011202
401120301,"Cyabasigi",155,206,361,4,401,40112,4011203
401120302,"Kiboha",143,197,340,4,401,40112,4011203
401120303,"Kigina",166,169,335,4,401,40112,4011203
401120304,"Mwishya",126,162,288,4,401,40112,4011203
401120305,"Nyakibyeyi",152,160,312,4,401,40112,4011203
401120306,"Riryi",201,229,430,4,401,40112,4011203
401120307,"Rukoma",170,174,344,4,401,40112,4011203
401120308,"Sakara",172,206,378,4,401,40112,4011203
401120401,"Busizi",189,175,364,4,401,40112,4011204
401120402,"Gaseke",141,155,296,4,401,40112,4011204
401120403,"Kirungu",136,164,300,4,401,40112,4011204
401120404,"Muyange",157,188,345,4,401,40112,4011204
401120405,"Ngaru",155,187,342,4,401,40112,4011204
401120406,"Nyaruvumu",142,171,313,4,401,40112,4011204
401120407,"Rushayu",104,153,257,4,401,40112,4011204
401120408,"Rushubi",123,138,261,4,401,40112,4011204
401130101,"Bikamba",369,381,750,4,401,40113,4011301
401130102,"Cyamutara",385,412,797,4,401,40113,4011301
401130103,"Gitambi",378,432,810,4,401,40113,4011301
401130104,"Kazi",245,290,535,4,401,40113,4011301
401130105,"Nyakambu",286,320,606,4,401,40113,4011301
401130106,"Nyarubuye",322,364,686,4,401,40113,4011301
401130107,"Rukore",232,285,517,4,401,40113,4011301
401130108,"Rusasa",361,423,784,4,401,40113,4011301
401130201,"Gatobotobo",179,216,395,4,401,40113,4011302
401130202,"Kabirizi",254,294,548,4,401,40113,4011302
401130203,"Kivubwe",327,379,706,4,401,40113,4011302
401130204,"Kiyanza I",363,466,829,4,401,40113,4011302
401130205,"Nombe",352,376,728,4,401,40113,4011302
401130206,"Nyagisozi",345,385,730,4,401,40113,4011302
401130207,"Nyamurema",282,282,564,4,401,40113,4011302
401130208,"Nyarurama",254,331,585,4,401,40113,4011302
401130301,"Burambi",242,263,505,4,401,40113,4011303
401130302,"Gitwa",191,240,431,4,401,40113,4011303
401130303,"Kamuhororo",255,274,529,4,401,40113,4011303
401130304,"Karera",276,317,593,4,401,40113,4011303
401130305,"Kayenzi",308,338,646,4,401,40113,4011303
401130306,"Kibeho",396,379,775,4,401,40113,4011303
401130307,"Rugogwe",254,303,557,4,401,40113,4011303
401130308,"Rusekabuye",300,347,647,4,401,40113,4011303
401140101,"Kabgayi",210,245,455,4,401,40114,4011401
401140102,"Kabingo",208,269,477,4,401,40114,4011401
401140103,"Kamiyove",330,371,701,4,401,40114,4011401
401140104,"Kiv0mo",247,302,549,4,401,40114,4011401
401140105,"Murwa",246,276,522,4,401,40114,4011401
401140106,"Nyenyeri",282,306,588,4,401,40114,4011401
401140107,"Rukingu",291,357,648,4,401,40114,4011401
401140108,"Shyondwe",277,327,604,4,401,40114,4011401
401140201,"Bushyana",269,290,559,4,401,40114,4011402
401140202,"Gatiba",266,339,605,4,401,40114,4011402
401140203,"Gatwa",294,371,665,4,401,40114,4011402
401140204,"Kadendegeri",198,225,423,4,401,40114,4011402
401140205,"Kavumo",231,254,485,4,401,40114,4011402
401140206,"Mwana",225,249,474,4,401,40114,4011402
401140301,"Gahwazi",228,294,522,4,401,40114,4011403
401140302,"Gakubo",486,439,925,4,401,40114,4011403
401140303,"Kabera",250,306,556,4,401,40114,4011403
401140304,"Mataba",276,312,588,4,401,40114,4011403
401140305,"Mutungo",308,353,661,4,401,40114,4011403
401140401,"Kibare",337,383,720,4,401,40114,4011404
401140402,"Mujebe",371,384,755,4,401,40114,4011404
401140403,"Musave",321,365,686,4,401,40114,4011404
401140404,"Nyarusebeya",285,326,611,4,401,40114,4011404
401140405,"Ruhanga",285,356,641,4,401,40114,4011404
401150101,"Gifumba",317,368,685,4,401,40115,4011501
401150102,"Kabunigu",317,361,678,4,401,40115,4011501
401150103,"Kabuye",289,354,643,4,401,40115,4011501
401150104,"Nkanga",341,365,706,4,401,40115,4011501
401150105,"Ntakara",201,247,448,4,401,40115,4011501
401150106,"Rwintare",411,459,870,4,401,40115,4011501
401150201,"Kigarama",417,464,881,4,401,40115,4011502
401150202,"Kinini-rusiga",391,424,815,4,401,40115,4011502
401150203,"Ntaruka",326,372,698,4,401,40115,4011502
401150204,"Rebero",291,368,659,4,401,40115,4011502
401150301,"Bitare",224,275,499,4,401,40115,4011503
401150302,"Gahondo",187,238,425,4,401,40115,4011503
401150303,"Karambi",200,203,403,4,401,40115,4011503
401150304,"Karenge",242,261,503,4,401,40115,4011503
401150305,"Kingazi",306,352,658,4,401,40115,4011503
401150306,"Nyakarama",194,237,431,4,401,40115,4011503
401160101,"Gatimba",266,294,560,4,401,40116,4011601
401160102,"Gatwa",516,485,1001,4,401,40116,4011601
401160103,"Gisiza",340,378,718,4,401,40116,4011601
401160104,"Kabaraza",306,550,856,4,401,40116,4011601
401160105,"Kigarama",284,374,658,4,401,40116,4011601
401160106,"Kiziranyenzi",220,265,485,4,401,40116,4011601
401160107,"Nyakaruri",167,192,359,4,401,40116,4011601
401160108,"Nyarushinya",324,374,698,4,401,40116,4011601
401160201,"Gaseke",252,293,545,4,401,40116,4011602
401160202,"Kabagabaga",267,262,529,4,401,40116,4011602
401160203,"Kabakene",145,160,305,4,401,40116,4011602
401160204,"Nyamugari",211,261,472,4,401,40116,4011602
401160205,"Rimwe",182,209,391,4,401,40116,4011602
401160206,"Rugendabari",300,390,690,4,401,40116,4011602
401160301,"Cyikera",111,132,243,4,401,40116,4011603
401160302,"Kagunda",148,157,305,4,401,40116,4011603
401160303,"Karama",185,244,429,4,401,40116,4011603
401160304,"Kavoma",151,163,314,4,401,40116,4011603
401160305,"Kirurumo",166,197,363,4,401,40116,4011603
401160306,"Kivili",214,269,483,4,401,40116,4011603
401160307,"Mukumba",233,233,466,4,401,40116,4011603
401160308,"Muvumu",212,252,464,4,401,40116,4011603
401160309,"Nyabubare",209,219,428,4,401,40116,4011603
401160310,"Ruhanga",132,148,280,4,401,40116,4011603
401160401,"Bwimo",443,496,939,4,401,40116,4011604
401160402,"Gishyita",295,362,657,4,401,40116,4011604
401160403,"Kigali",339,333,672,4,401,40116,4011604
401160404,"Ngona",189,229,418,4,401,40116,4011604
401160405,"Nyabitare",308,421,729,4,401,40116,4011604
401160406,"Nyarunyinya",222,265,487,4,401,40116,4011604
401160407,"Nyarusange",175,190,365,4,401,40116,4011604
401160408,"Rwahi",267,304,571,4,401,40116,4011604
401160501,"Bugarura",202,227,429,4,401,40116,4011605
401160502,"Mwagiro",212,232,444,4,401,40116,4011605
401160503,"Ngendo",158,220,378,4,401,40116,4011605
401160504,"Nyabisindu",182,206,388,4,401,40116,4011605
401160505,"Nyabyondo",215,248,463,4,401,40116,4011605
401160506,"Nyamirembe",235,310,545,4,401,40116,4011605
401160507,"Rutonde",264,289,553,4,401,40116,4011605
401160508,"Rweya",258,259,517,4,401,40116,4011605
401170101,"Gaseke",250,330,580,4,401,40117,4011701
401170102,"Gashoro",291,322,613,4,401,40117,4011701
401170103,"Karambi",249,321,570,4,401,40117,4011701
401170104,"Kigarama",282,366,648,4,401,40117,4011701
401170105,"Rukore",265,330,595,4,401,40117,4011701
401170201,"Kabuga",278,377,655,4,401,40117,4011702
401170202,"Kagusa",279,345,624,4,401,40117,4011702
401170203,"Mafene",303,332,635,4,401,40117,4011702
401170204,"Munyinya",271,301,572,4,401,40117,4011702
401170205,"Rushaki",338,360,698,4,401,40117,4011702
401170301,"Kanaba",367,432,799,4,401,40117,4011703
401170302,"Karambi",279,356,635,4,401,40117,4011703
401170303,"Kavumu",223,275,498,4,401,40117,4011703
401170304,"Marembo",273,340,613,4,401,40117,4011703
401170305,"Misezero",321,271,592,4,401,40117,4011703
401170306,"Rurambo",369,369,738,4,401,40117,4011703
401170307,"Taba",179,254,433,4,401,40117,4011703
401170401,"Bukinga",356,391,747,4,401,40117,4011704
401170402,"Gatare",287,302,589,4,401,40117,4011704
401170403,"Gatsinde",303,333,636,4,401,40117,4011704
401170404,"Gihanga",267,332,599,4,401,40117,4011704
401170405,"Murambi",263,366,629,4,401,40117,4011704
401170406,"Rugando",316,356,672,4,401,40117,4011704
401170407,"Rusura",248,301,549,4,401,40117,4011704
401170501,"Kamuragi",252,322,574,4,401,40117,4011705
401170502,"Mwili",304,317,621,4,401,40117,4011705
401170503,"Nkinda",290,291,581,4,401,40117,4011705
401170504,"Nyirambuga",269,273,542,4,401,40117,4011705
401170505,"Nyirataba",266,334,600,4,401,40117,4011705
401170506,"Ruvumba",238,245,483,4,401,40117,4011705
402010101,"Birambo ",209,267,476,4,402,40201,4020101
402010102,"Gitwa ",216,293,509,4,402,40201,4020101
402010103,"Kirwa ",301,356,657,4,402,40201,4020101
402010104,"Nyarubande ",264,334,598,4,402,40201,4020101
402010201,"Buhuga ",202,248,450,4,402,40201,4020102
402010202,"Butereri ",282,255,537,4,402,40201,4020102
402010203,"Gasakuza ",249,283,532,4,402,40201,4020102
402010204,"Kirwa ",274,304,578,4,402,40201,4020102
402010205,"Rubaga ",268,347,615,4,402,40201,4020102
402010206,"Rugendabari ",253,274,527,4,402,40201,4020102
402010207,"Rwinkuba ",220,213,433,4,402,40201,4020102
402010301,"Gatoke ",318,373,691,4,402,40201,4020103
402010302,"Kamina ",223,220,443,4,402,40201,4020103
402010303,"Karambi ",247,286,533,4,402,40201,4020103
402010304,"Nyagasozi ",311,302,613,4,402,40201,4020103
402010305,"Ruboza ",254,292,546,4,402,40201,4020103
402010401,"Bunyangezi ",263,305,568,4,402,40201,4020104
402010402,"Kajereri ",293,350,643,4,402,40201,4020104
402010403,"Kamina ",342,345,687,4,402,40201,4020104
402010404,"Mwendo ",270,285,555,4,402,40201,4020104
402010405,"Nyarubuye ",309,348,657,4,402,40201,4020104
402010406,"Rwankuba ",290,333,623,4,402,40201,4020104
402010501,"Gasaso ",289,311,600,4,402,40201,4020105
402010502,"Kirabo ",227,258,485,4,402,40201,4020105
402010503,"Munyinya ",237,273,510,4,402,40201,4020105
402010504,"Ngezi ",239,306,545,4,402,40201,4020105
402010505,"Rusebeya ",274,288,562,4,402,40201,4020105
402010506,"Wimfizi ",237,294,531,4,402,40201,4020105
402010601,"Kabuga ",284,336,620,4,402,40201,4020106
402010602,"Kamonyi ",201,224,425,4,402,40201,4020106
402010603,"Karaba ",192,237,429,4,402,40201,4020106
402010604,"Mugunga ",285,296,581,4,402,40201,4020106
402010605,"Rutenga ",276,314,590,4,402,40201,4020106
402010701,"Bukinga ",205,223,428,4,402,40201,4020107
402010702,"Gashirwe ",262,324,586,4,402,40201,4020107
402010703,"Kabaya ",215,245,460,4,402,40201,4020107
402010704,"Kabugiri ",217,247,464,4,402,40201,4020107
402010705,"Rurangara ",201,244,445,4,402,40201,4020107
402020101,"Buhuri ",259,291,550,4,402,40202,4020201
402020102,"Bukamba ",276,322,598,4,402,40202,4020201
402020103,"Bushagashi ",234,241,475,4,402,40202,4020201
402020104,"Gatare ",217,224,441,4,402,40202,4020201
402020105,"Mucumazo ",236,269,505,4,402,40202,4020201
402020106,"Ntarabana ",221,248,469,4,402,40202,4020201
402020107,"Nyamasuka ",197,185,382,4,402,40202,4020201
402020108,"Rubuguma ",149,187,336,4,402,40202,4020201
402020201,"Akanduga ",375,436,811,4,402,40202,4020202
402020202,"Burengo ",216,224,440,4,402,40202,4020202
402020203,"Bushyama ",260,285,545,4,402,40202,4020202
402020204,"Matovu ",148,157,305,4,402,40202,4020202
402020205,"Mbogo ",238,244,482,4,402,40202,4020202
402020206,"Murambi ",258,286,544,4,402,40202,4020202
402020207,"Rwahi ",272,313,585,4,402,40202,4020202
402020208,"Shyunga ",278,311,589,4,402,40202,4020202
402020301,"Buhara ",289,323,612,4,402,40202,4020203
402020302,"Gaseke ",292,316,608,4,402,40202,4020203
402020303,"Karambo ",340,359,699,4,402,40202,4020203
402020304,"Karoli ",431,534,965,4,402,40202,4020203
402020305,"Musasa ",348,373,721,4,402,40202,4020203
402020306,"Ntobwe ",297,289,586,4,402,40202,4020203
402020307,"Vumandi ",242,255,497,4,402,40202,4020203
402020401,"Baramba ",270,312,582,4,402,40202,4020204
402020402,"Gikamba ",251,319,570,4,402,40202,4020204
402020403,"Gitaba ",264,297,561,4,402,40202,4020204
402020404,"Kavumu ",227,260,487,4,402,40202,4020204
402020405,"Tumba ",311,366,677,4,402,40202,4020204
402030101,"Buraza ",196,209,405,4,402,40203,4020301
402030102,"Busoga ",239,308,547,4,402,40203,4020301
402030103,"Karombero ",187,237,424,4,402,40203,4020301
402030104,"Muhaza ",288,332,620,4,402,40203,4020301
402030105,"Mushirarungu ",281,335,616,4,402,40203,4020301
402030106,"Ntaraga ",215,266,481,4,402,40203,4020301
402030107,"Rutaramiro ",254,307,561,4,402,40203,4020301
402030201,"Butaraga ",206,259,465,4,402,40203,4020302
402030202,"Gatoki ",205,216,421,4,402,40203,4020302
402030203,"Gatorero ",215,233,448,4,402,40203,4020302
402030204,"Kabungwe ",325,354,679,4,402,40203,4020302
402030205,"Karenge ",162,162,324,4,402,40203,4020302
402030206,"Muhororo ",302,322,624,4,402,40203,4020302
402030207,"Musebeya ",188,221,409,4,402,40203,4020302
402030208,"Tongoburo ",183,182,365,4,402,40203,4020302
402030301,"Bukuba ",305,339,644,4,402,40203,4020303
402030302,"Gahama ",384,349,733,4,402,40203,4020303
402030303,"Gatare ",205,218,423,4,402,40203,4020303
402030304,"Musebeya ",278,308,586,4,402,40203,4020303
402030305,"Rugaragara ",252,277,529,4,402,40203,4020303
402030306,"Rwobe ",248,284,532,4,402,40203,4020303
402030401,"Cyabingo ",302,280,582,4,402,40203,4020304
402030402,"Gishubi ",244,283,527,4,402,40203,4020304
402030403,"Kambare ",278,295,573,4,402,40203,4020304
402030404,"Kanyamukenke ",307,303,610,4,402,40203,4020304
402030405,"Mucaca ",199,221,420,4,402,40203,4020304
402030406,"Mutanda ",288,331,619,4,402,40203,4020304
402030501,"Kigote ",292,334,626,4,402,40203,4020305
402030502,"Muramba ",226,252,478,4,402,40203,4020305
402030503,"Murehe ",291,298,589,4,402,40203,4020305
402030504,"Nyabisika ",209,278,487,4,402,40203,4020305
402030505,"Nyamugali ",279,341,620,4,402,40203,4020305
402030506,"Rugendabare ",304,357,661,4,402,40203,4020305
402030507,"Rukore ",209,228,437,4,402,40203,4020305
402040101,"Buyagiro ",253,249,502,4,402,40204,4020401
402040102,"Gatwa ",166,202,368,4,402,40204,4020401
402040103,"Gihemba ",186,227,413,4,402,40204,4020401
402040104,"Gikerera ",194,208,402,4,402,40204,4020401
402040105,"Karambi ",246,273,519,4,402,40204,4020401
402040106,"Karorero ",262,310,572,4,402,40204,4020401
402040107,"Mucuro ",188,238,426,4,402,40204,4020401
402040108,"Murambi ",221,257,478,4,402,40204,4020401
402040109,"Ndora ",191,253,444,4,402,40204,4020401
402040110,"Rusebeya ",180,204,384,4,402,40204,4020401
402040201,"Bukanka ",162,201,363,4,402,40204,4020402
402040202,"Cyandago ",260,291,551,4,402,40204,4020402
402040203,"Gitenga ",274,302,576,4,402,40204,4020402
402040204,"Kamatare ",263,372,635,4,402,40204,4020402
402040205,"Murama ",210,271,481,4,402,40204,4020402
402040206,"Murambi ",435,483,918,4,402,40204,4020402
402040207,"Musave ",337,404,741,4,402,40204,4020402
402040208,"Ntobwe ",237,282,519,4,402,40204,4020402
402040209,"Rurambi ",255,276,531,4,402,40204,4020402
402040210,"Rusuri ",181,206,387,4,402,40204,4020402
402040301,"Bwimba ",194,260,454,4,402,40204,4020403
402040302,"Gahondo ",290,331,621,4,402,40204,4020403
402040303,"Gashigwe ",170,191,361,4,402,40204,4020403
402040304,"Gishyinguro ",238,283,521,4,402,40204,4020403
402040305,"Kaniga ",153,192,345,4,402,40204,4020403
402040306,"Kanyiramanyana ",266,281,547,4,402,40204,4020403
402040307,"Karambi ",191,250,441,4,402,40204,4020403
402040308,"Karehe ",222,276,498,4,402,40204,4020403
402040309,"Karuganda",329,385,714,4,402,40204,4020403
402040311,"Mbizi ",220,252,472,4,402,40204,4020403
402040312,"Mbogo ",160,193,353,4,402,40204,4020403
402040313,"Muyira ",274,297,571,4,402,40204,4020403
402040314,"Ryabazungu ",182,202,384,4,402,40204,4020403
402040401,"Akarugamba ",209,258,467,4,402,40204,4020404
402040402,"Busingiryi ",156,182,338,4,402,40204,4020404
402040403,"Kabaya ",191,207,398,4,402,40204,4020404
402040404,"Kageyo ",138,131,269,4,402,40204,4020404
402040405,"Kakinungu ",102,98,200,4,402,40204,4020404
402040406,"Kivumu ",176,198,374,4,402,40204,4020404
402040407,"Mazinga ",208,245,453,4,402,40204,4020404
402040408,"Murambi",113,132,245,4,402,40204,4020404
402040409,"Museke ",214,255,469,4,402,40204,4020404
402040410,"Nyamabuye ",159,167,326,4,402,40204,4020404
402040411,"Ruberano ",165,194,359,4,402,40204,4020404
402040412,"Sitwe ",273,291,564,4,402,40204,4020404
402040413,"Umujyi Wa Gakenke ",235,245,480,4,402,40204,4020404
402050101,"Bwiyando ",251,334,585,4,402,40205,4020501
402050102,"Gashinge ",235,254,489,4,402,40205,4020501
402050103,"Kadehero ",213,290,503,4,402,40205,4020501
402050104,"Masoro ",285,338,623,4,402,40205,4020501
402050105,"Mukira ",224,278,502,4,402,40205,4020501
402050106,"Nyamure ",306,368,674,4,402,40205,4020501
402050107,"Rugarama ",313,377,690,4,402,40205,4020501
402050108,"Rugendabari ",291,318,609,4,402,40205,4020501
402050109,"Ruhore ",213,246,459,4,402,40205,4020501
402050201,"Gahihi ",229,271,500,4,402,40205,4020502
402050202,"Gikoro ",193,232,425,4,402,40205,4020502
402050203,"Kara ",229,260,489,4,402,40205,4020502
402050204,"Kirambo ",388,435,823,4,402,40205,4020502
402050205,"Murandi ",289,345,634,4,402,40205,4020502
402050206,"Nyamataha ",268,292,560,4,402,40205,4020502
402050301,"Buhira ",300,306,606,4,402,40205,4020503
402050302,"Buturuba ",237,289,526,4,402,40205,4020503
402050303,"Gasanzwe ",156,226,382,4,402,40205,4020503
402050304,"Kabwika ",177,199,376,4,402,40205,4020503
402050305,"Kamurambo ",235,279,514,4,402,40205,4020503
402050306,"Kanwa ",238,292,530,4,402,40205,4020503
402050307,"Rubuga ",227,296,523,4,402,40205,4020503
402050401,"Gaseke ",277,307,584,4,402,40205,4020504
402050402,"Gatwa",173,227,400,4,402,40205,4020504
402050403,"Gitaba ",157,196,353,4,402,40205,4020504
402050404,"Kabere ",195,238,433,4,402,40205,4020504
402050405,"Kabugomba ",218,243,461,4,402,40205,4020504
402050406,"Kibara ",191,268,459,4,402,40205,4020504
402050407,"Murambo ",231,274,505,4,402,40205,4020504
402050501,"Busaro ",218,247,465,4,402,40205,4020505
402050502,"Bushita ",220,248,468,4,402,40205,4020505
402050503,"Gasharu ",194,205,399,4,402,40205,4020505
402050504,"Gihanga ",233,256,489,4,402,40205,4020505
402050505,"Kangomba ",221,265,486,4,402,40205,4020505
402050506,"Kanteko ",300,370,670,4,402,40205,4020505
402050507,"Murambi ",183,234,417,4,402,40205,4020505
402050508,"Mwisha ",317,368,685,4,402,40205,4020505
402050509,"Rutenderi ",194,225,419,4,402,40205,4020505
402060101,"Bukerera ",307,336,643,4,402,40206,4020601
402060102,"Bunyironko ",235,289,524,4,402,40206,4020601
402060103,"Kabusoro ",619,493,1112,4,402,40206,4020601
402060104,"Kibonwa ",324,392,716,4,402,40206,4020601
402060105,"Rubona ",348,398,746,4,402,40206,4020601
402060106,"Rurumbya ",253,322,575,4,402,40206,4020601
402060201,"Burega ",290,414,704,4,402,40206,4020602
402060202,"Gatongo ",302,315,617,4,402,40206,4020602
402060203,"Gitovu ",295,344,639,4,402,40206,4020602
402060204,"Nyabikenke ",276,332,608,4,402,40206,4020602
402060205,"Rwampali ",315,394,709,4,402,40206,4020602
402060301,"Buhanga ",215,287,502,4,402,40206,4020603
402060302,"Gitega ",969,640,1609,4,402,40206,4020603
402060303,"Kinoko ",166,213,379,4,402,40206,4020603
402060304,"Murambi ",222,282,504,4,402,40206,4020603
402060305,"Mwanza ",256,312,568,4,402,40206,4020603
402060306,"Nyabushishiri ",248,323,571,4,402,40206,4020603
402060307,"Nyagisozi ",350,388,738,4,402,40206,4020603
402060401,"Buhimbi ",233,272,505,4,402,40206,4020604
402060402,"Cyifuzo ",303,315,618,4,402,40206,4020604
402060403,"Gitaba ",315,348,663,4,402,40206,4020604
402060404,"Karama ",226,242,468,4,402,40206,4020604
402060405,"Mugandu ",312,338,650,4,402,40206,4020604
402060406,"Rugeshi ",250,320,570,4,402,40206,4020604
402060407,"Rusasa ",266,307,573,4,402,40206,4020604
402060408,"Rutake ",318,362,680,4,402,40206,4020604
402070101,"Gasebeya ",223,239,462,4,402,40207,4020701
402070102,"Gashishi ",337,362,699,4,402,40207,4020701
402070103,"Gitwe ",333,382,715,4,402,40207,4020701
402070104,"Kabuye ",335,354,689,4,402,40207,4020701
402070105,"Kanshenge ",236,255,491,4,402,40207,4020701
402070106,"Kanyirantege ",289,339,628,4,402,40207,4020701
402070107,"Marira ",215,283,498,4,402,40207,4020701
402070108,"Nyarungu ",338,431,769,4,402,40207,4020701
402070109,"Raro ",318,339,657,4,402,40207,4020701
402070110,"Rugari ",344,373,717,4,402,40207,4020701
402070111,"Ruhehe ",230,269,499,4,402,40207,4020701
402070112,"Runeka ",261,311,572,4,402,40207,4020701
402070201,"Bucyaba ",179,195,374,4,402,40207,4020702
402070202,"Bugogo ",364,430,794,4,402,40207,4020702
402070203,"Kidomo ",165,207,372,4,402,40207,4020702
402070204,"Kintobo ",292,344,636,4,402,40207,4020702
402070205,"Njugi ",224,272,496,4,402,40207,4020702
402070206,"Nyamusongati ",270,335,605,4,402,40207,4020702
402070207,"Rugeshi ",254,318,572,4,402,40207,4020702
402070208,"Rutagara ",322,404,726,4,402,40207,4020702
402070301,"Buhinda ",219,249,468,4,402,40207,4020703
402070302,"Gatare ",273,316,589,4,402,40207,4020703
402070303,"Horero ",223,257,480,4,402,40207,4020703
402070304,"Kabyaza ",227,252,479,4,402,40207,4020703
402070305,"Karingorera ",289,331,620,4,402,40207,4020703
402070306,"Mbatabata ",287,330,617,4,402,40207,4020703
402070307,"Mwasha ",244,251,495,4,402,40207,4020703
402070308,"Ryabirere ",230,264,494,4,402,40207,4020703
402070401,"Kabutwa ",257,294,551,4,402,40207,4020704
402070402,"Karangara ",240,349,589,4,402,40207,4020704
402070403,"Kinyababa ",220,267,487,4,402,40207,4020704
402070404,"Rungu ",335,429,764,4,402,40207,4020704
402070405,"Rusasa ",233,252,485,4,402,40207,4020704
402070406,"Rusumo ",232,279,511,4,402,40207,4020704
402070407,"Rwata ",333,358,691,4,402,40207,4020704
402070408,"Taba ",247,276,523,4,402,40207,4020704
402080101,"Gatembe ",225,290,515,4,402,40208,4020801
402080102,"Kabuhunu ",191,229,420,4,402,40208,4020801
402080103,"Kabutare ",253,326,579,4,402,40208,4020801
402080104,"Karambi ",188,166,354,4,402,40208,4020801
402080105,"Karenge ",166,177,343,4,402,40208,4020801
402080106,"Marembo ",187,205,392,4,402,40208,4020801
402080107,"Nyiramisabike ",194,250,444,4,402,40208,4020801
402080201,"Bataga ",244,252,496,4,402,40208,4020802
402080202,"Bumbeja ",153,200,353,4,402,40208,4020802
402080203,"Bushuba ",174,246,420,4,402,40208,4020802
402080204,"Cyumba ",204,235,439,4,402,40208,4020802
402080205,"Gasovu ",223,237,460,4,402,40208,4020802
402080206,"Gatare ",250,304,554,4,402,40208,4020802
402080207,"Gatorero ",210,266,476,4,402,40208,4020802
402080208,"Gishingo ",197,259,456,4,402,40208,4020802
402080209,"Kigarama ",157,179,336,4,402,40208,4020802
402080210,"Mugamba ",178,218,396,4,402,40208,4020802
402080211,"Nyiramuhimba ",213,287,500,4,402,40208,4020802
402080212,"Rwamiko ",113,153,266,4,402,40208,4020802
402080213,"Ryarurimbura ",132,152,284,4,402,40208,4020802
402080301,"Bukondo ",233,274,507,4,402,40208,4020803
402080302,"Bukunga ",130,163,293,4,402,40208,4020803
402080303,"Bukweto ",154,189,343,4,402,40208,4020803
402080304,"Kabuye ",182,205,387,4,402,40208,4020803
402080305,"Kavumu ",198,207,405,4,402,40208,4020803
402080306,"Mubuga ",162,194,356,4,402,40208,4020803
402080307,"Mwiyanike ",191,252,443,4,402,40208,4020803
402080308,"Nyabigugu ",174,215,389,4,402,40208,4020803
402090101,"Bigogwe ",294,321,615,4,402,40209,4020901
402090102,"Buhuga ",270,316,586,4,402,40209,4020901
402090103,"Cyintare ",317,378,695,4,402,40209,4020901
402090104,"Nyarubuye ",258,262,520,4,402,40209,4020901
402090201,"Bushoka ",309,396,705,4,402,40209,4020902
402090202,"Kabuhoma ",190,320,510,4,402,40209,4020902
402090203,"Kamwumba ",326,371,697,4,402,40209,4020902
402090204,"Nturo ",219,272,491,4,402,40209,4020902
402090205,"Nyarungu",224,235,459,4,402,40209,4020902
402090301,"Gasave ",244,343,587,4,402,40209,4020903
402090302,"Karuhunge ",247,291,538,4,402,40209,4020903
402090303,"Mugali ",226,245,471,4,402,40209,4020903
402090304,"Rurambo ",308,365,673,4,402,40209,4020903
402090305,"Rutamba ",322,363,685,4,402,40209,4020903
402090306,"Rwamabare ",198,264,462,4,402,40209,4020903
402090401,"Buranga ",360,330,690,4,402,40209,4020904
402090402,"Kamomo ",358,415,773,4,402,40209,4020904
402090403,"Kavumu ",321,360,681,4,402,40209,4020904
402090404,"Kintarure ",316,376,692,4,402,40209,4020904
402090405,"Munyege ",284,344,628,4,402,40209,4020904
402090406,"Rugeshi ",315,347,662,4,402,40209,4020904
402090407,"Rwakirari ",304,352,656,4,402,40209,4020904
402090501,"Buhayo ",354,417,771,4,402,40209,4020905
402090502,"Kabara",372,376,748,4,402,40209,4020905
402090503,"Kivuruga ",287,368,655,4,402,40209,4020905
402090504,"Masoro ",308,396,704,4,402,40209,4020905
402090505,"Musekera ",285,332,617,4,402,40209,4020905
402090506,"Ngarama ",378,399,777,4,402,40209,4020905
402100101,"Gabiro ",291,351,642,4,402,40210,4021001
402100102,"Gashingiro ",201,209,410,4,402,40210,4021001
402100103,"Kabeza ",171,193,364,4,402,40210,4021001
402100104,"Kanamo ",245,237,482,4,402,40210,4021001
402100105,"Karambi ",193,239,432,4,402,40210,4021001
402100106,"Mubuga ",240,275,515,4,402,40210,4021001
402100107,"Nyamiyaga ",222,240,462,4,402,40210,4021001
402100108,"Rugendabari ",193,213,406,4,402,40210,4021001
402100109,"Ryarugema ",198,247,445,4,402,40210,4021001
402100201,"Bugari",211,236,447,4,402,40210,4021002
402100202,"Bweramana ",172,195,367,4,402,40210,4021002
402100203,"Gashyushya ",260,350,610,4,402,40210,4021002
402100204,"Gatovu ",251,269,520,4,402,40210,4021002
402100205,"Muhororo ",305,374,679,4,402,40210,4021002
402100206,"Munini ",219,254,473,4,402,40210,4021002
402100207,"Muyaga ",305,350,655,4,402,40210,4021002
402100208,"Nyangoma ",222,235,457,4,402,40210,4021002
402100209,"Ruganda ",234,243,477,4,402,40210,4021002
402100210,"Ruhanga ",242,271,513,4,402,40210,4021002
402100301,"Gihita ",276,290,566,4,402,40210,4021003
402100302,"Gitaba ",258,320,578,4,402,40210,4021003
402100303,"Kabuyora ",277,339,616,4,402,40210,4021003
402100304,"Kagando ",264,273,537,4,402,40210,4021003
402100305,"Karambi ",221,258,479,4,402,40210,4021003
402100306,"Mataba ",298,366,664,4,402,40210,4021003
402100307,"Mwanza ",236,289,525,4,402,40210,4021003
402100308,"Nkurazo ",299,303,602,4,402,40210,4021003
402110101,"Gahombo ",216,246,462,4,402,40211,4021101
402110102,"Gahunda ",201,215,416,4,402,40211,4021101
402110103,"Gasangwa ",349,404,753,4,402,40211,4021101
402110104,"Gihinga ",215,249,464,4,402,40211,4021101
402110105,"Kabarima ",294,385,679,4,402,40211,4021101
402110106,"Kigeyo ",263,284,547,4,402,40211,4021101
402110107,"Mbogo ",227,255,482,4,402,40211,4021101
402110201,"Gihororo ",287,356,643,4,402,40211,4021102
402110202,"Gitwa ",396,429,825,4,402,40211,4021102
402110203,"Kanka ",145,161,306,4,402,40211,4021102
402110204,"Kivuba ",214,260,474,4,402,40211,4021102
402110205,"Nyabitare ",172,225,397,4,402,40211,4021102
402110301,"Gisovu ",268,280,548,4,402,40211,4021103
402110302,"Kabuga ",396,436,832,4,402,40211,4021103
402110303,"Musave ",275,330,605,4,402,40211,4021103
402110304,"Nyanza ",227,229,456,4,402,40211,4021103
402110305,"Nyarubuye ",250,301,551,4,402,40211,4021103
402110401,"Bukonde ",203,205,408,4,402,40211,4021104
402110402,"Gaharo ",140,189,329,4,402,40211,4021104
402110403,"Gitaragwe ",284,313,597,4,402,40211,4021104
402110404,"Munihi ",182,230,412,4,402,40211,4021104
402110405,"Mutara ",302,382,684,4,402,40211,4021104
402110406,"Ndegamire ",267,375,642,4,402,40211,4021104
402110407,"Sarabuye ",406,458,864,4,402,40211,4021104
402120101,"Cyinama ",206,272,478,4,402,40212,4021201
402120102,"Giheta ",184,192,376,4,402,40212,4021201
402120103,"Nyagahondo ",175,186,361,4,402,40212,4021201
402120104,"Nyakagezi ",269,347,616,4,402,40212,4021201
402120105,"Rwimpiri ",251,261,512,4,402,40212,4021201
402120201,"Cyarubayi ",289,327,616,4,402,40212,4021202
402120202,"Karambi",219,248,467,4,402,40212,4021202
402120203,"Muhororo ",148,177,325,4,402,40212,4021202
402120204,"Nturo ",175,212,387,4,402,40212,4021202
402120205,"Rwezamenyo ",227,261,488,4,402,40212,4021202
402120301,"Kamasanze ",308,347,655,4,402,40212,4021203
402120302,"Kamunyana ",317,360,677,4,402,40212,4021203
402120303,"Karambo ",294,367,661,4,402,40212,4021203
402120304,"Nganzo ",222,279,501,4,402,40212,4021203
402120305,"Rutaraga ",282,312,594,4,402,40212,4021203
402120401,"Kabuga ",295,333,628,4,402,40212,4021204
402120402,"Kanaba ",340,387,727,4,402,40212,4021204
402120403,"Nemba ",342,386,728,4,402,40212,4021204
402120404,"Nyagasozi ",372,410,782,4,402,40212,4021204
402120405,"Rusebeya ",309,390,699,4,402,40212,4021204
402120501,"Gacemeri ",230,251,481,4,402,40212,4021205
402120502,"Gasovu ",283,285,568,4,402,40212,4021205
402120503,"Gatonde ",311,323,634,4,402,40212,4021205
402120504,"Kabuhoro ",160,193,353,4,402,40212,4021205
402120505,"Muhororo ",246,286,532,4,402,40212,4021205
402120601,"Kiraro ",320,361,681,4,402,40212,4021206
402120602,"Nyakazenga ",282,291,573,4,402,40212,4021206
402120603,"Nyundo ",350,396,746,4,402,40212,4021206
402120604,"Rubona ",371,402,773,4,402,40212,4021206
402120701,"Biraro ",149,207,356,4,402,40212,4021207
402120702,"Bushoka ",198,215,413,4,402,40212,4021207
402120703,"Gashubi ",293,313,606,4,402,40212,4021207
402120704,"Kabiganda ",209,204,413,4,402,40212,4021207
402120705,"Kanyinya ",233,227,460,4,402,40212,4021207
402130101,"Busake",229,292,521,4,402,40213,4021301
402130102,"Gikikira",178,206,384,4,402,40213,4021301
402130103,"Kibirizi",249,294,543,4,402,40213,4021301
402130104,"Nyakabanda",210,260,470,4,402,40213,4021301
402130201,"Gahama",221,216,437,4,402,40213,4021302
402130202,"Gatare",201,221,422,4,402,40213,4021302
402130203,"Gitaba",156,170,326,4,402,40213,4021302
402130204,"Kimanama",185,233,418,4,402,40213,4021302
402130205,"Nketsi",238,272,510,4,402,40213,4021302
402130301,"Gahabwa ",219,230,449,4,402,40213,4021303
402130302,"Gahinga ",144,159,303,4,402,40213,4021303
402130303,"Gahondo ",258,284,542,4,402,40213,4021303
402130304,"Gasiza ",245,278,523,4,402,40213,4021303
402130305,"Kabeza ",169,187,356,4,402,40213,4021303
402130401,"Base ",236,244,480,4,402,40213,4021304
402130402,"Gihinga ",170,195,365,4,402,40213,4021304
402130403,"Karehe ",232,266,498,4,402,40213,4021304
402130404,"Samuduha ",244,298,542,4,402,40213,4021304
402130405,"Taba ",190,178,368,4,402,40213,4021304
402130501,"Cura ",243,249,492,4,402,40213,4021305
402130502,"Gitwa",219,278,497,4,402,40213,4021305
402130503,"Huro ",227,235,462,4,402,40213,4021305
402130504,"Kabuga ",175,213,388,4,402,40213,4021305
402130505,"Rubona ",205,238,443,4,402,40213,4021305
402130601,"Akara ",262,278,540,4,402,40213,4021306
402130602,"Cyenda ",336,335,671,4,402,40213,4021306
402130603,"Giteme ",285,356,641,4,402,40213,4021306
402130604,"Karobagire ",191,195,386,4,402,40213,4021306
402130701,"Buhinya ",288,293,581,4,402,40213,4021307
402130702,"Gakuyu ",193,226,419,4,402,40213,4021307
402130703,"Kigali ",280,341,621,4,402,40213,4021307
402130704,"Musenyi ",240,289,529,4,402,40213,4021307
402130801,"Gisozi ",209,235,444,4,402,40213,4021308
402130802,"Kinyonzo ",267,328,595,4,402,40213,4021308
402130803,"Mubuga ",362,478,840,4,402,40213,4021308
402130804,"Ranzi ",104,123,227,4,402,40213,4021308
402130805,"Ruganda ",262,301,563,4,402,40213,4021308
402130901,"Cyimbogo ",238,246,484,4,402,40213,4021309
402130902,"Kanyana ",229,239,468,4,402,40213,4021309
402130903,"Ruhorobero ",228,265,493,4,402,40213,4021309
402140101,"Bumba ",307,377,684,4,402,40214,4021401
402140102,"Buzu ",329,388,717,4,402,40214,4021401
402140103,"Gikoro ",287,362,649,4,402,40214,4021401
402140104,"Gitovu ",348,379,727,4,402,40214,4021401
402140105,"Gitwe ",217,262,479,4,402,40214,4021401
402140106,"Mataba ",330,383,713,4,402,40214,4021401
402140107,"Shiru ",310,371,681,4,402,40214,4021401
402140201,"Gitanda ",242,312,554,4,402,40214,4021402
402140202,"Kabingo ",288,321,609,4,402,40214,4021402
402140203,"Kiyebe ",251,297,548,4,402,40214,4021402
402140204,"Muramba ",353,377,730,4,402,40214,4021402
402140205,"Ruhoko ",328,397,725,4,402,40214,4021402
402140206,"Sanzare",254,286,540,4,402,40214,4021402
402140301,"Gikombe ",212,236,448,4,402,40214,4021403
402140302,"Kibingo ",217,272,489,4,402,40214,4021403
402140303,"Mahaha ",205,228,433,4,402,40214,4021403
402140304,"Mugera ",271,316,587,4,402,40214,4021403
402140401,"Muhororo ",216,249,465,4,402,40214,4021404
402140402,"Nganzo ",285,325,610,4,402,40214,4021404
402140403,"Ngoma ",262,291,553,4,402,40214,4021404
402140404,"Nyarubuye ",223,285,508,4,402,40214,4021404
402140405,"Vugangoma ",262,337,599,4,402,40214,4021404
402140501,"Bukwera ",211,239,450,4,402,40214,4021405
402140502,"Businde ",224,278,502,4,402,40214,4021405
402140503,"Gikombe ",267,270,537,4,402,40214,4021405
402140504,"Mutoyi ",192,237,429,4,402,40214,4021405
402140505,"Ranzi ",142,186,328,4,402,40214,4021405
402150101,"Curugusi ",275,328,603,4,402,40215,4021501
402150102,"Gasave ",256,316,572,4,402,40215,4021501
402150103,"Gitabi ",294,346,640,4,402,40215,4021501
402150104,"Kabatezi ",325,369,694,4,402,40215,4021501
402150105,"Kasheshe ",297,354,651,4,402,40215,4021501
402150106,"Runyinya ",349,373,722,4,402,40215,4021501
402150107,"Rusororo ",337,391,728,4,402,40215,4021501
402150201,"Akamagaju ",252,278,530,4,402,40215,4021502
402150202,"Gahondo ",288,344,632,4,402,40215,4021502
402150203,"Munyinya ",316,375,691,4,402,40215,4021502
402150204,"Murambi ",161,246,407,4,402,40215,4021502
402150205,"Rugarama ",255,270,525,4,402,40215,4021502
402150206,"Rugege ",191,251,442,4,402,40215,4021502
402150207,"Sezuku ",249,329,578,4,402,40215,4021502
402150301,"Butambwe ",370,469,839,4,402,40215,4021503
402150302,"Kanini ",305,343,648,4,402,40215,4021503
402150303,"Kavuza ",354,400,754,4,402,40215,4021503
402150304,"Mubuga ",360,417,777,4,402,40215,4021503
402150305,"Mwirika ",247,290,537,4,402,40215,4021503
402150306,"Mwurire ",257,288,545,4,402,40215,4021503
402150401,"Gitabi ",335,376,711,4,402,40215,4021504
402150402,"Gitoke",242,251,493,4,402,40215,4021504
402150403,"Kagano",275,316,591,4,402,40215,4021504
402150404,"Muguguri ",282,358,640,4,402,40215,4021504
402150405,"Nyagasozi ",347,381,728,4,402,40215,4021504
402150406,"Rubayo ",220,274,494,4,402,40215,4021504
402150407,"Ruhondo ",286,322,608,4,402,40215,4021504
402150501,"Bitaba ",311,381,692,4,402,40215,4021505
402150502,"Cyinturo ",263,265,528,4,402,40215,4021505
402150503,"Gacaca ",195,255,450,4,402,40215,4021505
402150504,"Gihororo ",259,292,551,4,402,40215,4021505
402150505,"Kabere ",147,185,332,4,402,40215,4021505
402150506,"Mafubo ",242,290,532,4,402,40215,4021505
402150507,"Nyagahondo ",220,278,498,4,402,40215,4021505
402150508,"Nyarubande ",206,236,442,4,402,40215,4021505
402160101,"Buranga ",182,191,373,4,402,40216,4021601
402160102,"Burego ",259,320,579,4,402,40216,4021601
402160103,"Butare ",167,212,379,4,402,40216,4021601
402160104,"Kanyansyo",126,149,275,4,402,40216,4021601
402160105,"Muganwa ",189,225,414,4,402,40216,4021601
402160106,"Mukaka ",172,216,388,4,402,40216,4021601
402160107,"Rukoji ",242,275,517,4,402,40216,4021601
402160201,"Bitare ",258,326,584,4,402,40216,4021602
402160202,"Bukurura ",295,289,584,4,402,40216,4021602
402160203,"Kabaya ",310,314,624,4,402,40216,4021602
402160204,"Kilimbi ",191,212,403,4,402,40216,4021602
402160301,"Gisagara ",205,238,443,4,402,40216,4021603
402160302,"Kabushara ",139,182,321,4,402,40216,4021603
402160303,"Kamatete ",213,245,458,4,402,40216,4021603
402160304,"Kanama ",236,298,534,4,402,40216,4021603
402160305,"Kanunga ",197,218,415,4,402,40216,4021603
402160306,"Kanzoka ",676,553,1229,4,402,40216,4021603
402160307,"Karukara ",420,443,863,4,402,40216,4021603
402160308,"Kirehe ",319,373,692,4,402,40216,4021603
402160309,"Mushubi ",165,212,377,4,402,40216,4021603
402160310,"Nyamyumba ",210,250,460,4,402,40216,4021603
402160401,"Cyahafi ",183,195,378,4,402,40216,4021604
402160402,"Gatare ",198,233,431,4,402,40216,4021604
402160403,"Kabingo ",189,246,435,4,402,40216,4021604
402160404,"Kabuye ",227,268,495,4,402,40216,4021604
402160405,"Kamuvunyi ",156,210,366,4,402,40216,4021604
402160406,"Kiruhura ",257,287,544,4,402,40216,4021604
402160407,"Kiryamo ",148,194,342,4,402,40216,4021604
402160408,"Munyege ",238,293,531,4,402,40216,4021604
402160409,"Musange ",184,214,398,4,402,40216,4021604
402160410,"Ntakabavu ",192,239,431,4,402,40216,4021604
402160411,"Nyamiyaga ",183,247,430,4,402,40216,4021604
402170101,"Congoli ",257,316,573,4,402,40217,4021701
402170102,"Cyoganyoni ",260,285,545,4,402,40217,4021701
402170103,"Gitaba ",212,216,428,4,402,40217,4021701
402170104,"Kabare ",226,203,429,4,402,40217,4021701
402170105,"Kibirizi ",257,278,535,4,402,40217,4021701
402170106,"Nkoto ",184,216,400,4,402,40217,4021701
402170107,"Rugaragara ",263,264,527,4,402,40217,4021701
402170201,"Bushoka ",265,301,566,4,402,40217,4021702
402170202,"Gatwa ",286,287,573,4,402,40217,4021702
402170203,"Kabingo ",289,310,599,4,402,40217,4021702
402170204,"Karango ",303,320,623,4,402,40217,4021702
402170205,"Nyamugari ",294,311,605,4,402,40217,4021702
402170206,"Rumasa ",239,233,472,4,402,40217,4021702
402170301,"Gatagara ",199,198,397,4,402,40217,4021703
402170302,"Gihura ",152,150,302,4,402,40217,4021703
402170303,"Gitonde ",326,342,668,4,402,40217,4021703
402170304,"Kinyonzo ",286,332,618,4,402,40217,4021703
402170305,"Mubuga ",346,414,760,4,402,40217,4021703
402170306,"Murehe ",392,403,795,4,402,40217,4021703
402170401,"Bariza ",535,648,1183,4,402,40217,4021704
402170402,"Gahondo ",300,309,609,4,402,40217,4021704
402170403,"Gataba ",444,591,1035,4,402,40217,4021704
402170404,"Mugambazi ",161,166,327,4,402,40217,4021704
402170405,"Ngayake ",241,299,540,4,402,40217,4021704
402170406,"Nyakarambi ",173,186,359,4,402,40217,4021704
402170501,"Gatare ",278,323,601,4,402,40217,4021705
402170502,"Gisizi ",266,325,591,4,402,40217,4021705
402170503,"Mabago ",366,384,750,4,402,40217,4021705
402170504,"Mugwato ",194,193,387,4,402,40217,4021705
402170505,"Nyarunyinya ",248,240,488,4,402,40217,4021705
402180101,"Bumonyo A ",294,346,640,4,402,40218,4021801
402180102,"Gahama ",267,361,628,4,402,40218,4021801
402180103,"Gataba ",333,352,685,4,402,40218,4021801
402180104,"Kebero ",263,351,614,4,402,40218,4021801
402180105,"Kibaya ",240,271,511,4,402,40218,4021801
402180201,"Burinda ",287,368,655,4,402,40218,4021802
402180202,"Gakindo ",300,341,641,4,402,40218,4021802
402180203,"Gapfura ",309,345,654,4,402,40218,4021802
402180204,"Gitwe ",190,227,417,4,402,40218,4021802
402180205,"Kidomo ",249,288,537,4,402,40218,4021802
402180206,"Nyagahama ",279,353,632,4,402,40218,4021802
402180207,"Rurambi ",277,297,574,4,402,40218,4021802
402180301,"Buharabuye ",304,351,655,4,402,40218,4021803
402180302,"Karuhunge ",350,394,744,4,402,40218,4021803
402180303,"Kirehe ",323,319,642,4,402,40218,4021803
402180304,"Nyange ",326,424,750,4,402,40218,4021803
402180401,"Bukingo ",219,258,477,4,402,40218,4021804
402180402,"Bumonyo B ",228,237,465,4,402,40218,4021804
402180403,"Gisovu ",293,293,586,4,402,40218,4021804
402180404,"Nyundo ",233,297,530,4,402,40218,4021804
402180405,"Tane ",134,393,527,4,402,40218,4021804
402180501,"Bukiza ",387,391,778,4,402,40218,4021805
402180502,"Buyora ",223,270,493,4,402,40218,4021805
402180503,"Bwanamo ",414,436,850,4,402,40218,4021805
402180504,"Ninda ",260,300,560,4,402,40218,4021805
402180601,"Bushoka ",330,375,705,4,402,40218,4021806
402180602,"Mazinga ",310,341,651,4,402,40218,4021806
402180603,"Murori ",256,258,514,4,402,40218,4021806
402180604,"Nyakabungo ",282,321,603,4,402,40218,4021806
402180605,"Rugamba ",353,454,807,4,402,40218,4021806
402190101,"Kabuye",275,335,610,4,402,40219,4021901
402190102,"Kara ",263,300,563,4,402,40219,4021901
402190103,"Kivumu ",216,235,451,4,402,40219,4021901
402190201,"Gisenyi ",242,274,516,4,402,40219,4021902
402190202,"Gisiza ",165,183,348,4,402,40219,4021902
402190203,"Kanzuki",245,284,529,4,402,40219,4021902
402190204,"Nyakagezi ",165,188,353,4,402,40219,4021902
402190301,"Kineza ",205,198,403,4,402,40219,4021903
402190302,"Mataba ",158,189,347,4,402,40219,4021903
402190303,"Mwifuzo ",203,230,433,4,402,40219,4021903
402190304,"Nyagasozi ",487,437,924,4,402,40219,4021903
402190305,"Rugarama ",301,365,666,4,402,40219,4021903
402190401,"Kabeza ",178,188,366,4,402,40219,4021904
402190402,"Kabona",154,194,348,4,402,40219,4021904
402190403,"Karambi ",203,218,421,4,402,40219,4021904
402190404,"Murambi ",234,278,512,4,402,40219,4021904
402190405,"Nganzo ",322,426,748,4,402,40219,4021904
402190501,"Bushoka ",275,304,579,4,402,40219,4021905
402190502,"Buzoza ",311,345,656,4,402,40219,4021905
402190503,"Gisanze ",269,283,552,4,402,40219,4021905
402190504,"Gitongo ",152,200,352,4,402,40219,4021905
402190505,"Nyabitare ",93,134,227,4,402,40219,4021905
402190601,"Gahinga ",154,169,323,4,402,40219,4021906
402190602,"Gikongoro ",234,250,484,4,402,40219,4021906
402190603,"Kirwa ",234,246,480,4,402,40219,4021906
402190604,"Nkoto ",189,214,403,4,402,40219,4021906
402190605,"Nyangoyi ",210,234,444,4,402,40219,4021906
402190701,"Giheta ",521,517,1038,4,402,40219,4021907
402190702,"Karushashi ",156,164,320,4,402,40219,4021907
402190703,"Ngambi ",251,261,512,4,402,40219,4021907
402190704,"Ruganda ",245,262,507,4,402,40219,4021907
402190705,"Rwamabega ",176,185,361,4,402,40219,4021907
402190801,"Gatare ",199,252,451,4,402,40219,4021908
402190802,"Gatwa ",217,244,461,4,402,40219,4021908
402190803,"Gihororo ",221,272,493,4,402,40219,4021908
402190804,"Murara ",364,409,773,4,402,40219,4021908
403010101,"Gahanga",1663,1364,3027,4,403,40301,4030101
403010102,"Jabiro",652,680,1332,4,403,40301,4030101
403010103,"Kabaya",915,1058,1973,4,403,40301,4030101
403010104,"Nengo",684,842,1526,4,403,40301,4030101
403010201,"Gatovu",355,379,734,4,403,40301,4030102
403010202,"Karema",196,187,383,4,403,40301,4030102
403010203,"Karuriza",210,252,462,4,403,40301,4030102
403010204,"Mutaboneka",238,301,539,4,403,40301,4030102
403010205,"Rugeshi",233,311,544,4,403,40301,4030102
403010301,"Cyasure",408,474,882,4,403,40301,4030103
403010302,"Gora",428,459,887,4,403,40301,4030103
403010303,"Kabwenge",537,621,1158,4,403,40301,4030103
403010304,"Kirezi",314,350,664,4,403,40301,4030103
403010305,"Rurembo",418,505,923,4,403,40301,4030103
403010401,"Nyarubuye",916,1082,1998,4,403,40301,4030104
403010402,"Nyiragaju",449,486,935,4,403,40301,4030104
403010403,"Rubaya",381,453,834,4,403,40301,4030104
403010404,"Ryamukutsi",471,540,1011,4,403,40301,4030104
403020101,"Bubandu",375,442,817,4,403,40302,4030201
403020102,"Mubwiza",401,522,923,4,403,40302,4030201
403020103,"Murambi",302,345,647,4,403,40302,4030201
403020104,"Mwidagaduro",239,296,535,4,403,40302,4030201
403020105,"Mwirongi",341,400,741,4,403,40302,4030201
403020106,"Rugeshi",371,408,779,4,403,40302,4030201
403020201,"Bazizana",277,349,626,4,403,40302,4030202
403020202,"Kabahama",287,319,606,4,403,40302,4030202
403020203,"Kamenantare",275,297,572,4,403,40302,4030202
403020204,"Ruhindinka",470,520,990,4,403,40302,4030202
403020205,"Rutemba",516,533,1049,4,403,40302,4030202
403020206,"Ruvumu",249,283,532,4,403,40302,4030202
403020301,"Kabaya",200,223,423,4,403,40302,4030203
403020302,"Karugabanya",319,359,678,4,403,40302,4030203
403020303,"Kayange",327,358,685,4,403,40302,4030203
403020304,"Kibande",357,398,755,4,403,40302,4030203
403020305,"Mubari",223,267,490,4,403,40302,4030203
403020306,"Mubuga",271,320,591,4,403,40302,4030203
403020307,"Mugarama",274,325,599,4,403,40302,4030203
403020308,"Rebero",262,287,549,4,403,40302,4030203
403020309,"Ruhehe",327,393,720,4,403,40302,4030203
403020401,"Bucuzi",338,338,676,4,403,40302,4030204
403020402,"Gashangiro",477,517,994,4,403,40302,4030204
403020403,"Kareba",447,597,1044,4,403,40302,4030204
403020404,"Karinzi",542,665,1207,4,403,40302,4030204
403020405,"Karunyura",497,567,1064,4,403,40302,4030204
403020406,"Kungo",596,699,1295,4,403,40302,4030204
403020501,"Buremu",275,387,662,4,403,40302,4030205
403020502,"Gakenke",202,260,462,4,403,40302,4030205
403020503,"Kabaya",409,448,857,4,403,40302,4030205
403020504,"Kamanga",307,380,687,4,403,40302,4030205
403020505,"Kiviriza",298,421,719,4,403,40302,4030205
403020506,"Mugari",264,298,562,4,403,40302,4030205
403020507,"Nyaruyaga",260,367,627,4,403,40302,4030205
403020508,"Rabika",293,362,655,4,403,40302,4030205
403020601,"Marantima",602,728,1330,4,403,40302,4030206
403020602,"Mubuga",582,606,1188,4,403,40302,4030206
403020603,"Nganzo",413,547,960,4,403,40302,4030206
403020604,"Nyarubande",512,611,1123,4,403,40302,4030206
403020605,"Nyiraruhengeri",573,366,939,4,403,40302,4030206
403030101,"Butunda",373,432,805,4,403,40303,4030301
403030102,"Cyiri",392,469,861,4,403,40303,4030301
403030103,"Gahama",546,707,1253,4,403,40303,4030301
403030104,"Murora",466,532,998,4,403,40303,4030301
403030105,"Murundo",400,454,854,4,403,40303,4030301
403030106,"Nkomero",501,633,1134,4,403,40303,4030301
403030201,"Gasenyi",373,408,781,4,403,40303,4030302
403030202,"Gataba",238,317,555,4,403,40303,4030302
403030203,"Karushenyi",282,285,567,4,403,40303,4030302
403030204,"Nyamugari",404,434,838,4,403,40303,4030302
403030205,"Ruhasa",331,386,717,4,403,40303,4030302
403030206,"Rurambo",262,262,524,4,403,40303,4030302
403030301,"Gitovu",529,607,1136,4,403,40303,4030303
403030302,"Kabushanda",561,679,1240,4,403,40303,4030303
403030303,"Kanama",582,623,1205,4,403,40303,4030303
403030304,"Karama",443,552,995,4,403,40303,4030303
403030305,"Mata",739,823,1562,4,403,40303,4030303
403030306,"Mukungwa",403,418,821,4,403,40303,4030303
403030307,"Rungu",571,685,1256,4,403,40303,4030303
403030401,"Burengo",262,349,611,4,403,40303,4030304
403030402,"Kabukende",442,497,939,4,403,40303,4030304
403030403,"Karambi",338,411,749,4,403,40303,4030304
403030404,"Kavumu",577,664,1241,4,403,40303,4030304
403030405,"Sarazi",181,201,382,4,403,40303,4030304
403040101,"Birwa",310,302,612,4,403,40304,4030401
403040102,"Butate",236,267,503,4,403,40304,4030401
403040103,"Buzoza",238,276,514,4,403,40304,4030401
403040104,"Kavumu",202,189,391,4,403,40304,4030401
403040105,"Musekera",279,301,580,4,403,40304,4030401
403040106,"Shanga",229,254,483,4,403,40304,4030401
403040201,"Burango",373,405,778,4,403,40304,4030402
403040202,"Kamatete",328,413,741,4,403,40304,4030402
403040203,"Makara",246,264,510,4,403,40304,4030402
403040204,"Nyakariba",239,268,507,4,403,40304,4030402
403040205,"Ruhehe",181,218,399,4,403,40304,4030402
403040301,"Budiho",329,360,689,4,403,40304,4030403
403040302,"Gatete",398,472,870,4,403,40304,4030403
403040303,"Kamato",323,424,747,4,403,40304,4030403
403040304,"Kanzo",309,400,709,4,403,40304,4030403
403040305,"Ngambi",353,401,754,4,403,40304,4030403
403040306,"Raro",206,242,448,4,403,40304,4030403
403040401,"Bugabo",266,261,527,4,403,40304,4030404
403040402,"Karuganda",335,360,695,4,403,40304,4030404
403040403,"Kibinyogote",394,427,821,4,403,40304,4030404
403040404,"Mucaca",266,272,538,4,403,40304,4030404
403040405,"Murandi",303,309,612,4,403,40304,4030404
403050101,"Gakuku",455,497,952,4,403,40305,4030501
403050102,"Kagongo",454,527,981,4,403,40305,4030501
403050103,"Kararo",398,453,851,4,403,40305,4030501
403050104,"Mikingo",232,295,527,4,403,40305,4030501
403050105,"Rubaka",483,568,1051,4,403,40305,4030501
403050201,"Karurambi",1030,882,1912,4,403,40305,4030502
403050202,"Manjari",458,565,1023,4,403,40305,4030502
403050203,"Rukingo",387,434,821,4,403,40305,4030502
403050204,"Rusambu",396,457,853,4,403,40305,4030502
403050205,"Rwinzovu",543,544,1087,4,403,40305,4030502
403050301,"Butakanyundo",592,647,1239,4,403,40305,4030503
403050302,"Gacondo",425,448,873,4,403,40305,4030503
403050303,"Gataraga",380,513,893,4,403,40305,4030503
403050304,"Kabaya",685,721,1406,4,403,40305,4030503
403050305,"Kaberege",844,857,1701,4,403,40305,4030503
403050401,"Gahira",467,523,990,4,403,40305,4030504
403050402,"Gatondori",835,976,1811,4,403,40305,4030504
403050403,"Gatovu",418,517,935,4,403,40305,4030504
403050404,"Kampande",665,733,1398,4,403,40305,4030504
403050405,"Nyarubande",486,585,1071,4,403,40305,4030504
403060101,"Gakoro",439,504,943,4,403,40306,4030601
403060102,"Kabagoyi",255,329,584,4,403,40306,4030601
403060103,"Kadahenda",371,446,817,4,403,40306,4030601
403060104,"Mbugayera",466,582,1048,4,403,40306,4030601
403060105,"Rurembo",414,465,879,4,403,40306,4030601
403060201,"Kabaya",263,343,606,4,403,40306,4030602
403060202,"Kagwene",454,557,1011,4,403,40306,4030602
403060203,"Kamugeni",416,505,921,4,403,40306,4030602
403060204,"Nyiramuyenzi",527,637,1164,4,403,40306,4030602
403060205,"Ruhinga",527,602,1129,4,403,40306,4030602
403060301,"Masoro",254,303,557,4,403,40306,4030603
403060302,"Muregeya",269,337,606,4,403,40306,4030603
403060303,"Musezero",265,290,555,4,403,40306,4030603
403060304,"Ndorahe",229,305,534,4,403,40306,4030603
403060305,"Nyamugari",265,327,592,4,403,40306,4030603
403060401,"Buhuma",207,259,466,4,403,40306,4030604
403060402,"Bushubi",211,257,468,4,403,40306,4030604
403060403,"Gatumo",284,294,578,4,403,40306,4030604
403060404,"Rugondo",344,439,783,4,403,40306,4030604
403070101,"Bunyenyeri",359,481,840,4,403,40307,4030701
403070102,"Kamata",231,273,504,4,403,40307,4030701
403070103,"Karambi",206,256,462,4,403,40307,4030701
403070104,"Kazi",250,299,549,4,403,40307,4030701
403070105,"Kumazi",359,428,787,4,403,40307,4030701
403070106,"Shonero",227,236,463,4,403,40307,4030701
403070107,"Susa",290,317,607,4,403,40307,4030701
403070201,"Kabeza",273,352,625,4,403,40307,4030702
403070202,"Kaniga",186,243,429,4,403,40307,4030702
403070203,"Mpano",250,256,506,4,403,40307,4030702
403070204,"Musingi",266,361,627,4,403,40307,4030702
403070205,"Myase",236,256,492,4,403,40307,4030702
403070206,"Nyarusizi",216,239,455,4,403,40307,4030702
403070207,"Nyundo",271,284,555,4,403,40307,4030702
403070208,"Rugeshi",184,204,388,4,403,40307,4030702
403070209,"Ruginga",392,281,673,4,403,40307,4030702
403070210,"Rurembo",300,345,645,4,403,40307,4030702
403070301,"Kamakara",214,270,484,4,403,40307,4030703
403070302,"Muhe",382,471,853,4,403,40307,4030703
403070303,"Nyarubande",269,284,553,4,403,40307,4030703
403070304,"Nyejoro",424,378,802,4,403,40307,4030703
403070305,"Rubara",364,387,751,4,403,40307,4030703
403070306,"Rugi",297,356,653,4,403,40307,4030703
403070307,"Rutindo",307,382,689,4,403,40307,4030703
403070401,"Cyabirego",179,182,361,4,403,40307,4030704
403070402,"Gahura",187,245,432,4,403,40307,4030704
403070403,"Gasizi",268,362,630,4,403,40307,4030704
403070404,"Kabatwa",431,296,727,4,403,40307,4030704
403070405,"Karyasenge",371,315,686,4,403,40307,4030704
403070406,"Mitobo",267,310,577,4,403,40307,4030704
403070407,"Nyakagezi",266,318,584,4,403,40307,4030704
403070408,"Nyakigina",327,383,710,4,403,40307,4030704
403070409,"Rebero",295,171,466,4,403,40307,4030704
403070501,"Bazizana",194,242,436,4,403,40307,4030705
403070502,"Butorwa I",446,499,945,4,403,40307,4030705
403070503,"Butorwa Ii",475,574,1049,4,403,40307,4030705
403070504,"Gahisi",251,315,566,4,403,40307,4030705
403070505,"Gasura",303,371,674,4,403,40307,4030705
403070506,"Kansoro",307,388,695,4,403,40307,4030705
403070507,"Kanyampereri",349,376,725,4,403,40307,4030705
403070508,"Nyagisenyi",616,637,1253,4,403,40307,4030705
403080101,"Buhuye",335,375,710,4,403,40308,4030801
403080102,"Bwuzuri",521,534,1055,4,403,40308,4030801
403080103,"Gasanze",809,904,1713,4,403,40308,4030801
403080104,"Gatare",793,896,1689,4,403,40308,4030801
403080105,"Gatorwa",1130,1187,2317,4,403,40308,4030801
403080106,"Kabogobogo",912,1017,1929,4,403,40308,4030801
403080107,"Yorodani",835,915,1750,4,403,40308,4030801
403080201,"Kavumu",518,644,1162,4,403,40308,4030802
403080202,"Kiryi",643,721,1364,4,403,40308,4030802
403080203,"Mugara",344,377,721,4,403,40308,4030802
403080204,"Nduruma",809,808,1617,4,403,40308,4030802
403080205,"Nyamagumba",2153,804,2957,4,403,40308,4030802
403080206,"Nyamuremure",595,611,1206,4,403,40308,4030802
403080207,"Rukereza",663,764,1427,4,403,40308,4030802
403080301,"Gikwege",947,1361,2308,4,403,40308,4030803
403080302,"Giramahoro",1626,1863,3489,4,403,40308,4030803
403080303,"Mpenge",612,727,1339,4,403,40308,4030803
403080304,"Rukoro",1335,1400,2735,4,403,40308,4030803
403080305,"Rusagara",906,1034,1940,4,403,40308,4030803
403080401,"Buhoro",422,490,912,4,403,40308,4030804
403080402,"Burera",991,998,1989,4,403,40308,4030804
403080403,"Bushozi",660,820,1480,4,403,40308,4030804
403080404,"Byimana",702,681,1383,4,403,40308,4030804
403080405,"Kabaya",544,658,1202,4,403,40308,4030804
403080406,"Muhe",659,769,1428,4,403,40308,4030804
403080407,"Susa",549,657,1206,4,403,40308,4030804
403090101,"Gakoro",200,232,432,4,403,40309,4030901
403090102,"Kabudundu",159,156,315,4,403,40309,4030901
403090103,"Kamutara",244,275,519,4,403,40309,4030901
403090104,"Karebero",205,215,420,4,403,40309,4030901
403090105,"Karwabigwi",271,322,593,4,403,40309,4030901
403090106,"Nyagahondo",316,355,671,4,403,40309,4030901
403090107,"Nyakanama",427,496,923,4,403,40309,4030901
403090108,"Nyiramuko",263,320,583,4,403,40309,4030901
403090109,"Sangano",268,339,607,4,403,40309,4030901
403090110,"Susa",222,254,476,4,403,40309,4030901
403090201,"Kabere",324,392,716,4,403,40309,4030902
403090202,"Kadahenda",261,368,629,4,403,40309,4030902
403090203,"Karabiro",243,304,547,4,403,40309,4030902
403090204,"Karuyege",336,403,739,4,403,40309,4030902
403090205,"Nyagasambu",375,414,789,4,403,40309,4030902
403090206,"Rubanga",231,235,466,4,403,40309,4030902
403090301,"Bugese",264,297,561,4,403,40309,4030903
403090302,"Kabindi",189,253,442,4,403,40309,4030903
403090303,"Kigasa",84,94,178,4,403,40309,4030903
403090304,"Musenyi",281,307,588,4,403,40309,4030903
403090305,"Mwanganzara",326,211,537,4,403,40309,4030903
403090306,"Ngabane",248,261,509,4,403,40309,4030903
403090307,"Ntindo",209,231,440,4,403,40309,4030903
403090401,"Buhano",219,236,455,4,403,40309,4030904
403090402,"Butare",239,260,499,4,403,40309,4030904
403090403,"Kamaheke",170,158,328,4,403,40309,4030904
403090404,"Karambo",236,209,445,4,403,40309,4030904
403090405,"Kavumu",335,432,767,4,403,40309,4030904
403090406,"Kibuye",304,388,692,4,403,40309,4030904
403090407,"Mubago",234,280,514,4,403,40309,4030904
403100101,"Bitare",192,222,414,4,403,40310,4031001
403100102,"Bukane",821,1008,1829,4,403,40310,4031001
403100103,"Gaturo",400,595,995,4,403,40310,4031001
403100104,"Gikeri",573,720,1293,4,403,40310,4031001
403100105,"Kabaya",325,398,723,4,403,40310,4031001
403100106,"Kageyo",327,487,814,4,403,40310,4031001
403100107,"Kanyabirayi",336,385,721,4,403,40310,4031001
403100108,"Kiroba",452,558,1010,4,403,40310,4031001
403100109,"Rugeyo",408,495,903,4,403,40310,4031001
403100110,"Ruvumu",306,337,643,4,403,40310,4031001
403100201,"Cyanturo",269,295,564,4,403,40310,4031002
403100202,"Gacinyiro",427,516,943,4,403,40310,4031002
403100203,"Gapfuro",461,565,1026,4,403,40310,4031002
403100204,"Kanganwa",430,486,916,4,403,40310,4031002
403100205,"Kanyaminaba",449,556,1005,4,403,40310,4031002
403100301,"Bihinga",415,464,879,4,403,40310,4031003
403100302,"Kidendezi",340,420,760,4,403,40310,4031003
403100303,"Mufukuro",400,484,884,4,403,40310,4031003
403100304,"Nyabageni",321,338,659,4,403,40310,4031003
403100305,"Rucumu",382,462,844,4,403,40310,4031003
403100306,"Rwunga",335,384,719,4,403,40310,4031003
403100401,"Bannyisuka",274,312,586,4,403,40310,4031004
403100402,"Kareba",407,506,913,4,403,40310,4031004
403100403,"Kavumbu",130,191,321,4,403,40310,4031004
403100404,"Murenzi",307,363,670,4,403,40310,4031004
403100405,"Nturo",147,175,322,4,403,40310,4031004
403100406,"Tero",318,389,707,4,403,40310,4031004
403100501,"Buhunge",293,338,631,4,403,40310,4031005
403100502,"Gakoro",895,797,1692,4,403,40310,4031005
403100503,"Kirerema",509,632,1141,4,403,40310,4031005
403100504,"Nyarubande",436,577,1013,4,403,40310,4031005
403100505,"Runyangwe",335,415,750,4,403,40310,4031005
403100506,"Rwunga",450,590,1040,4,403,40310,4031005
403110101,"Barizo",378,419,797,4,403,40311,4031101
403110102,"Kabaya",259,324,583,4,403,40311,4031101
403110103,"Karambi",309,420,729,4,403,40311,4031101
403110104,"Kindiki",245,268,513,4,403,40311,4031101
403110105,"Kinkrware",255,321,576,4,403,40311,4031101
403110106,"Kiruhura",328,394,722,4,403,40311,4031101
403110107,"Nyakinama",225,259,484,4,403,40311,4031101
403110108,"Rubindi",232,281,513,4,403,40311,4031101
403110201,"Buhanga",197,236,433,4,403,40311,4031102
403110202,"Gitaraga",167,223,390,4,403,40311,4031102
403110203,"Kabasaza",204,265,469,4,403,40311,4031102
403110204,"Musebeya",189,233,422,4,403,40311,4031102
403110301,"Bugugu",159,193,352,4,403,40311,4031103
403110302,"Buhamo",106,151,257,4,403,40311,4031103
403110303,"Musembe",75,122,197,4,403,40311,4031103
403110304,"Nyagahondo",142,212,354,4,403,40311,4031103
403110305,"Nyarubingo",195,254,449,4,403,40311,4031103
403110401,"Bigabiro",192,227,419,4,403,40311,4031104
403110402,"Gahanga",288,313,601,4,403,40311,4031104
403110403,"Gasebeya",192,255,447,4,403,40311,4031104
403110404,"Karambo",248,280,528,4,403,40311,4031104
403110405,"Mucamo",190,227,417,4,403,40311,4031104
403110406,"Mutuzo",144,178,322,4,403,40311,4031104
403110501,"Cyivugiza",271,361,632,4,403,40311,4031105
403110502,"Gasiza",225,248,473,4,403,40311,4031105
403110503,"Kamusheshe",102,109,211,4,403,40311,4031105
403110504,"Murindi",145,186,331,4,403,40311,4031105
403110505,"Nyakigezi",125,139,264,4,403,40311,4031105
403120101,"Gasoroza",200,225,425,4,403,40312,4031201
403120102,"Kagano",286,316,602,4,403,40312,4031201
403120103,"Kageshi",205,278,483,4,403,40312,4031201
403120104,"Mugwati",185,224,409,4,403,40312,4031201
403120105,"Muhe",326,381,707,4,403,40312,4031201
403120106,"Nyabitare",272,358,630,4,403,40312,4031201
403120107,"Rugarama",373,416,789,4,403,40312,4031201
403120108,"Rusenge",260,307,567,4,403,40312,4031201
403120109,"Terimbere",293,331,624,4,403,40312,4031201
403120201,"Gahama",282,378,660,4,403,40312,4031202
403120202,"Kansoro",294,349,643,4,403,40312,4031202
403120203,"Kibingo",348,349,697,4,403,40312,4031202
403120204,"Ntamiziro",283,333,616,4,403,40312,4031202
403120205,"Nyarubuye",297,431,728,4,403,40312,4031202
403120206,"Riboneye",279,350,629,4,403,40312,4031202
403120207,"Rwebeya",309,342,651,4,403,40312,4031202
403120301,"Kabaya",273,320,593,4,403,40312,4031203
403120302,"Kamajaga",182,233,415,4,403,40312,4031203
403120303,"Kamicaca",377,425,802,4,403,40312,4031203
403120304,"Musenyi",272,359,631,4,403,40312,4031203
403120305,"Ntarama",300,390,690,4,403,40312,4031203
403120306,"Rugari",164,202,366,4,403,40312,4031203
403120401,"Bazizana",241,267,508,4,403,40312,4031204
403120402,"Bihinga",166,199,365,4,403,40312,4031204
403120403,"Bukingo",225,252,477,4,403,40312,4031204
403120404,"Buramba",149,163,312,4,403,40312,4031204
403120405,"Jite",298,322,620,4,403,40312,4031204
403120406,"Micaca",158,161,319,4,403,40312,4031204
403120407,"Nkogote",196,219,415,4,403,40312,4031204
403120408,"Ntarama",187,252,439,4,403,40312,4031204
403120409,"Ntebe",253,283,536,4,403,40312,4031204
403120410,"Rugwiro",267,283,550,4,403,40312,4031204
403120501,"Garuka",214,293,507,4,403,40312,4031205
403120502,"Gisigwa",335,382,717,4,403,40312,4031205
403120503,"Kabagorozi",292,329,621,4,403,40312,4031205
403120504,"Kabara",424,444,868,4,403,40312,4031205
403120505,"Kabari",344,386,730,4,403,40312,4031205
403120506,"Kareba",220,244,464,4,403,40312,4031205
403120507,"Nkiriza",187,237,424,4,403,40312,4031205
403120508,"Nyabutaka",234,247,481,4,403,40312,4031205
403120509,"Nyakagezi",256,326,582,4,403,40312,4031205
403120510,"Nyamiyaga",214,249,463,4,403,40312,4031205
403120511,"Nyarubande",293,359,652,4,403,40312,4031205
403130101,"Bukara",296,329,625,4,403,40313,4031301
403130102,"Gitega",319,484,803,4,403,40313,4031301
403130103,"Mugogo",294,487,781,4,403,40313,4031301
403130104,"Nyakibande",220,242,462,4,403,40313,4031301
403130105,"Rususa",262,321,583,4,403,40313,4031301
403130201,"Kabara",218,269,487,4,403,40313,4031302
403130202,"Kamurera",345,395,740,4,403,40313,4031302
403130203,"Mikamo",298,356,654,4,403,40313,4031302
403130204,"Mukinga",271,271,542,4,403,40313,4031302
403130205,"Rugari",288,318,606,4,403,40313,4031302
403130206,"Ryampunga",261,236,497,4,403,40313,4031302
403130301,"Buhogo",304,330,634,4,403,40313,4031303
403130302,"Kabagora",358,381,739,4,403,40313,4031303
403130303,"Karuruma",372,414,786,4,403,40313,4031303
403130304,"Muganda",349,398,747,4,403,40313,4031303
403130305,"Nyirabisekuro",313,367,680,4,403,40313,4031303
403130306,"Nyundo",398,425,823,4,403,40313,4031303
403130401,"Giseke",281,328,609,4,403,40313,4031304
403130402,"Gitwa.",385,402,787,4,403,40313,4031304
403130403,"Kabashima",353,412,765,4,403,40313,4031304
403130404,"Kamanga",480,486,966,4,403,40313,4031304
403130405,"Mwiyandiro",347,384,731,4,403,40313,4031304
403130406,"Ngenzi",386,440,826,4,403,40313,4031304
403130501,"Bitsibo",256,267,523,4,403,40313,4031305
403130502,"Gatare",165,283,448,4,403,40313,4031305
403130503,"Kabusozo",265,265,530,4,403,40313,4031305
403130504,"Kintashya",196,239,435,4,403,40313,4031305
403130505,"Mugeshi",246,251,497,4,403,40313,4031305
403130506,"Nyanza",310,356,666,4,403,40313,4031305
403140101,"Gisorora",292,288,580,4,403,40314,4031401
403140102,"Kabuye",282,314,596,4,403,40314,4031401
403140103,"Kavumu",267,286,553,4,403,40314,4031401
403140104,"Muheta",312,382,694,4,403,40314,4031401
403140105,"Nyakarambi",219,225,444,4,403,40314,4031401
403140201,"Busana",225,235,460,4,403,40314,4031402
403140202,"Gihango",345,382,727,4,403,40314,4031402
403140203,"Kabuga",782,925,1707,4,403,40314,4031402
403140204,"Murambi",201,203,404,4,403,40314,4031402
403140205,"Nyagisozi",256,285,541,4,403,40314,4031402
403140206,"Nyarugando",251,286,537,4,403,40314,4031402
403140207,"Ramba",266,279,545,4,403,40314,4031402
403140208,"Rwamigimbu",361,394,755,4,403,40314,4031402
403140301,"Kamabuye",257,258,515,4,403,40314,4031403
403140302,"Kansenda",270,279,549,4,403,40314,4031403
403140303,"Kibingo",278,344,622,4,403,40314,4031403
403140304,"Kiganda",323,315,638,4,403,40314,4031403
403140305,"Mataba",295,340,635,4,403,40314,4031403
403140306,"Mutara",335,357,692,4,403,40314,4031403
403140307,"Nyakarambi",241,310,551,4,403,40314,4031403
403140401,"Gakenke",402,469,871,4,403,40314,4031404
403140402,"Mugogo",346,363,709,4,403,40314,4031404
403140403,"Rubabi",311,356,667,4,403,40314,4031404
403140404,"Rugari",419,483,902,4,403,40314,4031404
403140405,"Rugogwe",343,360,703,4,403,40314,4031404
403140406,"Ruvumu",302,354,656,4,403,40314,4031404
403140501,"Buhama",241,249,490,4,403,40314,4031405
403140502,"Bukoro",351,373,724,4,403,40314,4031405
403140503,"Kanama",209,210,419,4,403,40314,4031405
403140504,"Murambi",255,279,534,4,403,40314,4031405
403140505,"Ngege",210,266,476,4,403,40314,4031405
403140506,"Rusaki",354,388,742,4,403,40314,4031405
403140507,"Sayo",379,417,796,4,403,40314,4031405
403150101,"Burengo",263,367,630,4,403,40315,4031501
403150102,"Bwamazi",257,274,531,4,403,40315,4031501
403150103,"Gasura",234,297,531,4,403,40315,4031501
403150104,"Kabeza",330,380,710,4,403,40315,4031501
403150105,"Kadahenda",600,683,1283,4,403,40315,4031501
403150106,"Karwesero",454,467,921,4,403,40315,4031501
403150107,"Mutuzo",250,286,536,4,403,40315,4031501
403150108,"Ryambungira",300,327,627,4,403,40315,4031501
403150201,"Bikereri",387,431,818,4,403,40315,4031502
403150202,"Byimana",271,336,607,4,403,40315,4031502
403150203,"Cyimbazi",263,314,577,4,403,40315,4031502
403150204,"Mutuzo",470,555,1025,4,403,40315,4031502
403150205,"Nyundo",202,224,426,4,403,40315,4031502
403150206,"Rwinuma",485,555,1040,4,403,40315,4031502
403150301,"Budasubira",466,496,962,4,403,40315,4031503
403150302,"Nyamiyaga",513,563,1076,4,403,40315,4031503
403150303,"Nyarutembe",415,548,963,4,403,40315,4031503
403150304,"Rubagara",374,413,787,4,403,40315,4031503
403150305,"Rutagara",339,324,663,4,403,40315,4031503
403150306,"Vubiro",203,453,656,4,403,40315,4031503
403150401,"Kabagabo",359,440,799,4,403,40315,4031504
403150402,"Kabeza",406,459,865,4,403,40315,4031504
403150403,"Kimanzi",422,541,963,4,403,40315,4031504
403150404,"Nyakagezi",133,145,278,4,403,40315,4031504
403150405,"Rebero",324,373,697,4,403,40315,4031504
403150406,"Terimbere",447,470,917,4,403,40315,4031504
404010101,"Bungwe",349,412,761,4,404,40401,4040101
404010102,"Gakeri",240,256,496,4,404,40401,4040101
404010103,"Gatenga",221,252,473,4,404,40401,4040101
404010104,"Kinihira",233,258,491,4,404,40401,4040101
404010105,"Nyabyondo",292,326,618,4,404,40401,4040101
404010106,"Rweru",475,427,902,4,404,40401,4040101
404010107,"Zaneza",174,204,378,4,404,40401,4040101
404010201,"Buhinga",260,268,528,4,404,40401,4040102
404010202,"Bushenya",200,253,453,4,404,40401,4040102
404010203,"Gifumba",260,271,531,4,404,40401,4040102
404010204,"Mbuga",314,392,706,4,404,40401,4040102
404010205,"Ryamayaya",322,375,697,4,404,40401,4040102
404010301,"Buzaniro",461,294,755,4,404,40401,4040103
404010302,"Kivumo",147,175,322,4,404,40401,4040103
404010303,"Mubuga",215,245,460,4,404,40401,4040103
404010304,"Rubayo",244,275,519,4,404,40401,4040103
404010305,"Sangabuzi",178,226,404,4,404,40401,4040103
404010306,"Vunga",240,258,498,4,404,40401,4040103
404010401,"Byorera",281,326,607,4,404,40401,4040104
404010402,"Karwema",312,368,680,4,404,40401,4040104
404010403,"Mubuga",323,346,669,4,404,40401,4040104
404010404,"Murambo",306,351,657,4,404,40401,4040104
404010405,"Mutungo",162,195,357,4,404,40401,4040104
404010406,"Nama",239,304,543,4,404,40401,4040104
404010407,"Nyarukore",334,345,679,4,404,40401,4040104
404010408,"Tumba",331,440,771,4,404,40401,4040104
404020101,"Gafumba",173,185,358,4,404,40402,4040201
404020102,"Gahuye",193,227,420,4,404,40402,4040201
404020103,"Gasebeya",221,262,483,4,404,40402,4040201
404020104,"Gatare",272,302,574,4,404,40402,4040201
404020105,"Gatovu",279,301,580,4,404,40402,4040201
404020106,"Kadehero",227,245,472,4,404,40402,4040201
404020107,"Kagano",227,280,507,4,404,40402,4040201
404020108,"Kaniga",221,264,485,4,404,40402,4040201
404020109,"Kanyoni",251,340,591,4,404,40402,4040201
404020110,"Kindoyi",174,223,397,4,404,40402,4040201
404020111,"Murambi",150,200,350,4,404,40402,4040201
404020112,"Rubonobono",220,279,499,4,404,40402,4040201
404020113,"Rwabutama",165,233,398,4,404,40402,4040201
404020114,"Rweru",216,276,492,4,404,40402,4040201
404020201,"Biyove",169,201,370,4,404,40402,4040202
404020202,"Bugeme",259,301,560,4,404,40402,4040202
404020203,"Gacyamo",196,217,413,4,404,40402,4040202
404020204,"Kirwa",219,228,447,4,404,40402,4040202
404020205,"Mulindi",139,206,345,4,404,40402,4040202
404020206,"Murambi",219,299,518,4,404,40402,4040202
404020207,"Musenyi",196,213,409,4,404,40402,4040202
404020208,"Nyanamo",133,148,281,4,404,40402,4040202
404020209,"Rupangu",168,202,370,4,404,40402,4040202
404020210,"Ryakagundu",234,279,513,4,404,40402,4040202
404020211,"Ryanturege",169,381,550,4,404,40402,4040202
404020301,"Bukaragata",187,211,398,4,404,40402,4040203
404020302,"Cyahera",127,146,273,4,404,40402,4040203
404020303,"Gahunge",133,121,254,4,404,40402,4040203
404020304,"Kabere",167,168,335,4,404,40402,4040203
404020305,"Karambi",151,139,290,4,404,40402,4040203
404020306,"Kibande",169,181,350,4,404,40402,4040203
404020307,"Kindege",133,140,273,4,404,40402,4040203
404020308,"Murambo",186,203,389,4,404,40402,4040203
404020309,"Murwa",250,294,544,4,404,40402,4040203
404020310,"Rugandu",91,113,204,4,404,40402,4040203
404020311,"Taba",241,276,517,4,404,40402,4040203
404020401,"Burambira",217,228,445,4,404,40402,4040204
404020402,"Gaceceri",211,290,501,4,404,40402,4040204
404020403,"Gahira",164,158,322,4,404,40402,4040204
404020404,"Gari",162,201,363,4,404,40402,4040204
404020405,"Gasiza",228,278,506,4,404,40402,4040204
404020406,"Gitovu",292,352,644,4,404,40402,4040204
404020407,"Karingorera",222,267,489,4,404,40402,4040204
404020408,"Kibingo",185,233,418,4,404,40402,4040204
404020409,"Kiringa",288,306,594,4,404,40402,4040204
404020410,"Murwa",354,374,728,4,404,40402,4040204
404020411,"Musama",210,232,442,4,404,40402,4040204
404020412,"Nkururo",155,188,343,4,404,40402,4040204
404020413,"Nyamiyaga",193,224,417,4,404,40402,4040204
404020414,"Rubaya",221,249,470,4,404,40402,4040204
404020415,"Rugeshi",140,156,296,4,404,40402,4040204
404020416,"Rwemikore",146,178,324,4,404,40402,4040204
404020501,"Budogoro",168,195,363,4,404,40402,4040205
404020502,"Butaro",334,324,658,4,404,40402,4040205
404020503,"Buyanga",253,303,556,4,404,40402,4040205
404020504,"Cyasenge",385,430,815,4,404,40402,4040205
404020505,"Gitanda",166,162,328,4,404,40402,4040205
404020506,"Kabahura",215,251,466,4,404,40402,4040205
404020507,"Kabaya",213,236,449,4,404,40402,4040205
404020508,"Kabingo",240,221,461,4,404,40402,4040205
404020509,"Kamonyi",237,254,491,4,404,40402,4040205
404020510,"Kanyesogo",277,332,609,4,404,40402,4040205
404020511,"Mugari",236,284,520,4,404,40402,4040205
404020512,"Mugera",291,270,561,4,404,40402,4040205
404020513,"Mukeri",181,203,384,4,404,40402,4040205
404020514,"Musongati",137,135,272,4,404,40402,4040205
404020515,"Nyamiyaga",150,168,318,4,404,40402,4040205
404020516,"Runaba",310,276,586,4,404,40402,4040205
404030101,"Bahimba",229,280,509,4,404,40403,4040301
404030102,"Gahirikiro",287,308,595,4,404,40403,4040301
404030103,"Gashunguru",234,315,549,4,404,40403,4040301
404030104,"Kabona",244,245,489,4,404,40403,4040301
404030105,"Karisimbi",398,427,825,4,404,40403,4040301
404030106,"Kaziguro",224,229,453,4,404,40403,4040301
404030107,"Nyamiyaga",294,309,603,4,404,40403,4040301
404030108,"Rwankongi",355,421,776,4,404,40403,4040301
404030201,"Gisovu",430,419,849,4,404,40403,4040302
404030202,"Hanika",365,435,800,4,404,40403,4040302
404030203,"Kamegeri",248,250,498,4,404,40403,4040302
404030204,"Mataba",227,266,493,4,404,40403,4040302
404030205,"Ruhimbi",281,357,638,4,404,40403,4040302
404030206,"Rusenyi",216,209,425,4,404,40403,4040302
404030207,"Rutango",241,276,517,4,404,40403,4040302
404030208,"Samiro",270,237,507,4,404,40403,4040302
404030301,"Butete",290,342,632,4,404,40403,4040303
404030302,"Kabadari",339,352,691,4,404,40403,4040303
404030303,"Mbonabose",256,276,532,4,404,40403,4040303
404030304,"Mugarama",379,441,820,4,404,40403,4040303
404030305,"Mugeshi",322,378,700,4,404,40403,4040303
404030306,"Nkiriza",395,336,731,4,404,40403,4040303
404030307,"Nyagisenyi",316,356,672,4,404,40403,4040303
404030308,"Zindiro",327,347,674,4,404,40403,4040303
404030401,"Gasebeya",307,334,641,4,404,40403,4040304
404030402,"Kabaya",303,359,662,4,404,40403,4040304
404030403,"Kagerero",334,381,715,4,404,40403,4040304
404030404,"Karambo",293,338,631,4,404,40403,4040304
404030405,"Kidaho",593,544,1137,4,404,40403,4040304
404030406,"Munini",452,454,906,4,404,40403,4040304
404030407,"Ntarama",361,362,723,4,404,40403,4040304
404030408,"Sirwa",330,382,712,4,404,40403,4040304
404030501,"Gasiza",342,364,706,4,404,40403,4040305
404030502,"Gasovu",299,280,579,4,404,40403,4040305
404030503,"Kabira",292,327,619,4,404,40403,4040305
404030504,"Kavunda",230,259,489,4,404,40403,4040305
404030505,"Kibaya",230,283,513,4,404,40403,4040305
404030506,"Majyambere",291,321,612,4,404,40403,4040305
404030507,"Nyarutosho",277,333,610,4,404,40403,4040305
404030508,"Runyenkanda",492,480,972,4,404,40403,4040305
404030509,"Ryabiteyi",295,329,624,4,404,40403,4040305
404030601,"Bisura",249,278,527,4,404,40403,4040306
404030602,"Gahama",254,295,549,4,404,40403,4040306
404030603,"Gahonga",237,267,504,4,404,40403,4040306
404030604,"Gakenke",307,313,620,4,404,40403,4040306
404030605,"Kabande",195,241,436,4,404,40403,4040306
404030606,"Kabyimana",291,304,595,4,404,40403,4040306
404030607,"Kanyabaranzi",313,368,681,4,404,40403,4040306
404030608,"Kebero",292,343,635,4,404,40403,4040306
404030609,"Mashango",365,381,746,4,404,40403,4040306
404030610,"Musave",337,421,758,4,404,40403,4040306
404030611,"Ruko",363,377,740,4,404,40403,4040306
404040101,"Butare",514,463,977,4,404,40404,4040401
404040102,"Gatare",809,566,1375,4,404,40404,4040401
404040103,"Kamata",242,266,508,4,404,40404,4040401
404040104,"Kamonyi",308,360,668,4,404,40404,4040401
404040105,"Musama",189,207,396,4,404,40404,4040401
404040106,"Nyaruyove",301,319,620,4,404,40404,4040401
404040107,"Ryandahagaze",141,221,362,4,404,40404,4040401
404040201,"Kabagenza",267,288,555,4,404,40404,4040402
404040202,"Ntazi",339,439,778,4,404,40404,4040402
404040203,"Nterura",189,244,433,4,404,40404,4040402
404040204,"Nyagisozi",210,289,499,4,404,40404,4040402
404040205,"Nyamusanze",213,288,501,4,404,40404,4040402
404040206,"Rujanja",365,465,830,4,404,40404,4040402
404040207,"Ryaruhirima",425,462,887,4,404,40404,4040402
404040301,"Bitagara",158,164,322,4,404,40404,4040403
404040302,"Burabwa",297,294,591,4,404,40404,4040403
404040303,"Gatagara-jite",263,287,550,4,404,40404,4040403
404040304,"Kabaya",191,205,396,4,404,40404,4040403
404040305,"Ngambi",148,146,294,4,404,40404,4040403
404040306,"Rihiro",152,192,344,4,404,40404,4040403
404040307,"Rugarama",185,189,374,4,404,40404,4040403
404040308,"Runyenyeri",206,205,411,4,404,40404,4040403
404040309,"Susa",145,160,305,4,404,40404,4040403
404050101,"Buramba",302,347,649,4,404,40405,4040501
404050102,"Gafatangwe",230,290,520,4,404,40405,4040501
404050103,"Gasenyi",221,240,461,4,404,40405,4040501
404050104,"Kagoma",310,343,653,4,404,40405,4040501
404050105,"Karuheshyi",264,344,608,4,404,40405,4040501
404050106,"Murambi",358,436,794,4,404,40405,4040501
404050107,"Musanzu",241,306,547,4,404,40405,4040501
404050201,"Gisizi",230,319,549,4,404,40405,4040502
404050202,"Kabagabo",228,263,491,4,404,40405,4040502
404050203,"Kanaba",352,419,771,4,404,40405,4040502
404050204,"Kigote",437,487,924,4,404,40405,4040502
404050205,"Nyagasozi",123,150,273,4,404,40405,4040502
404050206,"Ruri",353,367,720,4,404,40405,4040502
404050301,"Bahenga",287,320,607,4,404,40405,4040503
404050302,"Kabarima",282,311,593,4,404,40405,4040503
404050303,"Kabindi",359,404,763,4,404,40405,4040503
404050304,"Kajevuba",213,260,473,4,404,40405,4040503
404050305,"Kangoma",232,265,497,4,404,40405,4040503
404050306,"Kanyendara",240,220,460,4,404,40405,4040503
404050307,"Kidakama",253,295,548,4,404,40405,4040503
404050308,"Mubuga",363,418,781,4,404,40405,4040503
404050309,"Nangimbibi",162,174,336,4,404,40405,4040503
404050310,"Rusenyi",310,377,687,4,404,40405,4040503
404050311,"Songa",271,338,609,4,404,40405,4040503
404050401,"Bihanga",278,304,582,4,404,40405,4040504
404050402,"Gasagara",300,351,651,4,404,40405,4040504
404050403,"Gikoro",309,332,641,4,404,40405,4040504
404050404,"Kamatanda",233,271,504,4,404,40405,4040504
404050405,"Mubibi",236,289,525,4,404,40405,4040504
404050406,"Ntenyo",312,347,659,4,404,40405,4040504
404050407,"Nyangwe",243,260,503,4,404,40405,4040504
404050408,"Remera",282,293,575,4,404,40405,4040504
404050501,"Gitagata",246,319,565,4,404,40405,4040505
404050502,"Kabanga",267,285,552,4,404,40405,4040505
404050503,"Kangoboka",265,275,540,4,404,40405,4040505
404050504,"Kanyiramusengo",366,385,751,4,404,40405,4040505
404050505,"Mirigari",339,348,687,4,404,40405,4040505
404050506,"Mutara",494,501,995,4,404,40405,4040505
404050507,"Nyangezi",279,349,628,4,404,40405,4040505
404060101,"Gatebe",243,263,506,4,404,40406,4040601
404060102,"Ginga",225,297,522,4,404,40406,4040601
404060103,"Kabuga",255,299,554,4,404,40406,4040601
404060104,"Kagano",134,189,323,4,404,40406,4040601
404060105,"Kajerijeri",220,275,495,4,404,40406,4040601
404060106,"Nyakabungo",257,311,568,4,404,40406,4040601
404060107,"Rugarama",277,322,599,4,404,40406,4040601
404060108,"Ryaruyumbu",209,278,487,4,404,40406,4040601
404060109,"Zihare",113,161,274,4,404,40406,4040601
404060201,"Bikumba",390,436,826,4,404,40406,4040602
404060202,"Cyankaranka",302,354,656,4,404,40406,4040602
404060203,"Kabayoboke",308,350,658,4,404,40406,4040602
404060204,"Kabuga",340,383,723,4,404,40406,4040602
404060205,"Muremure",281,305,586,4,404,40406,4040602
404060206,"Nyamahunge",199,239,438,4,404,40406,4040602
404060207,"Rushaki",307,341,648,4,404,40406,4040602
404060208,"Sabukima",298,346,644,4,404,40406,4040602
404060209,"Sunzu",308,367,675,4,404,40406,4040602
404060301,"Cyili",325,357,682,4,404,40406,4040603
404060302,"Mubuga",267,296,563,4,404,40406,4040603
404060303,"Murambo",181,234,415,4,404,40406,4040603
404060304,"Ruhinga",228,309,537,4,404,40406,4040603
404060305,"Rutete",327,372,699,4,404,40406,4040603
404060306,"Taba",290,331,621,4,404,40406,4040603
404060401,"Karambi",159,184,343,4,404,40406,4040604
404060402,"Kiyogera",155,202,357,4,404,40406,4040604
404060403,"Murambo",192,226,418,4,404,40406,4040604
404060404,"Nganzo",234,265,499,4,404,40406,4040604
404060405,"Rugarama",335,385,720,4,404,40406,4040604
404060406,"Rutovu",314,385,699,4,404,40406,4040604
404070101,"Buhembe",177,181,358,4,404,40407,4040701
404070102,"Cyogo",197,234,431,4,404,40407,4040701
404070103,"Kiboga",198,213,411,4,404,40407,4040701
404070104,"Mariba",181,209,390,4,404,40407,4040701
404070105,"Musekera",189,231,420,4,404,40407,4040701
404070106,"Mwungura",117,138,255,4,404,40407,4040701
404070107,"Rusuzuma",197,241,438,4,404,40407,4040701
404070201,"Butanga",197,217,414,4,404,40407,4040702
404070202,"Gashiru",275,288,563,4,404,40407,4040702
404070203,"Gicura",229,239,468,4,404,40407,4040702
404070204,"Kamusaba",242,249,491,4,404,40407,4040702
404070205,"Kibumbiro",220,244,464,4,404,40407,4040702
404070206,"Murore",191,194,385,4,404,40407,4040702
404070207,"Mutara",131,112,243,4,404,40407,4040702
404070208,"Ruhombo",247,284,531,4,404,40407,4040702
404070209,"Shyamba",238,274,512,4,404,40407,4040702
404070210,"Sina",180,193,373,4,404,40407,4040702
404070301,"Gitwe",189,257,446,4,404,40407,4040703
404070302,"Kiraro",257,303,560,4,404,40407,4040703
404070303,"Mubuga",236,283,519,4,404,40407,4040703
404070304,"Musekera",292,366,658,4,404,40407,4040703
404070305,"Mutungu",324,394,718,4,404,40407,4040703
404070306,"Siganiro",209,263,472,4,404,40407,4040703
404080101,"Bihanga",232,258,490,4,404,40408,4040801
404080102,"Butare",229,248,477,4,404,40408,4040801
404080103,"Kanaba",244,262,506,4,404,40408,4040801
404080104,"Murambi",219,254,473,4,404,40408,4040801
404080105,"Rukenke",187,197,384,4,404,40408,4040801
404080201,"Gatare",303,380,683,4,404,40408,4040802
404080202,"Kaguriro",309,360,669,4,404,40408,4040802
404080203,"Kiyira",240,280,520,4,404,40408,4040802
404080204,"Mubaya",196,199,395,4,404,40408,4040802
404080205,"Ngobori",235,224,459,4,404,40408,4040802
404080206,"Rukoro",309,337,646,4,404,40408,4040802
404080207,"Rusisiro",307,339,646,4,404,40408,4040802
404080208,"Rwitongo",232,296,528,4,404,40408,4040802
404080301,"Gisanze",155,200,355,4,404,40408,4040803
404080302,"Karambi",177,176,353,4,404,40408,4040803
404080303,"Kariba",210,265,475,4,404,40408,4040803
404080304,"Karombero",233,274,507,4,404,40408,4040803
404080305,"Kigote",166,220,386,4,404,40408,4040803
404080306,"Kirigari",263,261,524,4,404,40408,4040803
404080307,"Musangabo",602,387,989,4,404,40408,4040803
404080308,"Nyamuha",197,210,407,4,404,40408,4040803
404080309,"Rusenyi",197,201,398,4,404,40408,4040803
404080310,"Rwabageni",281,354,635,4,404,40408,4040803
404080311,"Ryangarama",140,178,318,4,404,40408,4040803
404080401,"Gitare",247,239,486,4,404,40408,4040804
404080402,"Kabana",251,262,513,4,404,40408,4040804
404080403,"Kabashotsi",349,361,710,4,404,40408,4040804
404080404,"Kikubo",337,349,686,4,404,40408,4040804
404080405,"Mfashe",322,393,715,4,404,40408,4040804
404080406,"Musarara",348,379,727,4,404,40408,4040804
404080407,"Nyamabuye",109,132,241,4,404,40408,4040804
404080408,"Nyarubuye",363,358,721,4,404,40408,4040804
404080409,"Nyarugina",303,323,626,4,404,40408,4040804
404090101,"Basumba",274,337,611,4,404,40409,4040901
404090102,"Bugeyo",385,422,807,4,404,40409,4040901
404090103,"Buharo",235,254,489,4,404,40409,4040901
404090104,"Kabeza",416,487,903,4,404,40409,4040901
404090105,"Kanoni",321,368,689,4,404,40409,4040901
404090106,"Ntwana",400,447,847,4,404,40409,4040901
404090107,"Nyagafunzo",287,306,593,4,404,40409,4040901
404090201,"Birwa",193,215,408,4,404,40409,4040902
404090202,"Kigina",314,351,665,4,404,40409,4040902
404090203,"Kigugu",316,333,649,4,404,40409,4040902
404090204,"Nyagatoki",252,281,533,4,404,40409,4040902
404090205,"Sunzu",263,303,566,4,404,40409,4040902
404090301,"Cyanya",273,302,575,4,404,40409,4040903
404090302,"Cyivugiza",504,449,953,4,404,40409,4040903
404090303,"Kabaguma",338,368,706,4,404,40409,4040903
404090304,"Karambo",207,259,466,4,404,40409,4040903
404090305,"Mbaya",385,428,813,4,404,40409,4040903
404090306,"Mubuga",256,273,529,4,404,40409,4040903
404090307,"Mutabo",359,358,717,4,404,40409,4040903
404090401,"Cyamabuye",253,291,544,4,404,40409,4040904
404090402,"Gikoro",670,429,1099,4,404,40409,4040904
404090403,"Kabaya",236,256,492,4,404,40409,4040904
404090404,"Karuganda",359,225,584,4,404,40409,4040904
404090405,"Nyabagenzi",164,174,338,4,404,40409,4040904
404090406,"Nyarubuye",160,186,346,4,404,40409,4040904
404090407,"Nyarurembo",256,284,540,4,404,40409,4040904
404090408,"Ryamakoro",398,460,858,4,404,40409,4040904
404090409,"Shenyi",177,202,379,4,404,40409,4040904
404100101,"Cyogo",277,297,574,4,404,40410,4041001
404100102,"Gacaca",232,307,539,4,404,40410,4041001
404100103,"Gako",315,337,652,4,404,40410,4041001
404100104,"Gatare",296,341,637,4,404,40410,4041001
404100105,"Kabingo",315,354,669,4,404,40410,4041001
404100106,"Kirwa",326,348,674,4,404,40410,4041001
404100107,"Matyazo",258,296,554,4,404,40410,4041001
404100108,"Ndabizi",199,245,444,4,404,40410,4041001
404100109,"Rukore",176,202,378,4,404,40410,4041001
404100201,"Gisirwe",325,339,664,4,404,40410,4041002
404100202,"Kiraro",257,300,557,4,404,40410,4041002
404100203,"Mariko",417,502,919,4,404,40410,4041002
404100204,"Murambo",293,340,633,4,404,40410,4041002
404100205,"Ruhinga",274,339,613,4,404,40410,4041002
404100206,"Rusebeya",261,316,577,4,404,40410,4041002
404100207,"Rwahondo",305,355,660,4,404,40410,4041002
404100301,"Gitoma",299,375,674,4,404,40410,4041003
404100302,"Kabarore",284,352,636,4,404,40410,4041003
404100303,"Kanyaminyinya",356,396,752,4,404,40410,4041003
404100304,"Murambo",378,396,774,4,404,40410,4041003
404100305,"Rukaya",304,320,624,4,404,40410,4041003
404100401,"Gisiriri",199,235,434,4,404,40410,4041004
404100402,"Gitenge",288,342,630,4,404,40410,4041004
404100403,"Karambo",219,241,460,4,404,40410,4041004
404100404,"Kavumu",331,335,666,4,404,40410,4041004
404100405,"Musaga",327,373,700,4,404,40410,4041004
404100406,"Nyabizi I",292,297,589,4,404,40410,4041004
404100407,"Nyabizi Ii",224,276,500,4,404,40410,4041004
404100408,"Nyabizi Iii",232,320,552,4,404,40410,4041004
404100409,"Rubayu",324,364,688,4,404,40410,4041004
404100410,"Ryatamba",249,262,511,4,404,40410,4041004
404100411,"Shaga",290,342,632,4,404,40410,4041004
404110101,"Buhita",287,354,641,4,404,40411,4041101
404110102,"Gitovu",202,266,468,4,404,40411,4041101
404110103,"Murambo",221,282,503,4,404,40411,4041101
404110104,"Nyakira",271,289,560,4,404,40411,4041101
404110105,"Nyamisare",210,219,429,4,404,40411,4041101
404110106,"Nyarutovu",238,285,523,4,404,40411,4041101
404110201,"Bitukura",215,281,496,4,404,40411,4041102
404110202,"Burango",327,356,683,4,404,40411,4041102
404110203,"Gafumba",254,312,566,4,404,40411,4041102
404110204,"Gashiru",148,193,341,4,404,40411,4041102
404110205,"Karambo",219,256,475,4,404,40411,4041102
404110206,"Nyakabungo",250,331,581,4,404,40411,4041102
404110207,"Rugarambiro",298,346,644,4,404,40411,4041102
404110301,"Gasiza",312,367,679,4,404,40411,4041103
404110302,"Gatare",334,383,717,4,404,40411,4041103
404110303,"Kabaya",269,289,558,4,404,40411,4041103
404110304,"Muhambo",219,257,476,4,404,40411,4041103
404110305,"Rubara",251,270,521,4,404,40411,4041103
404110306,"Rucyamo",246,320,566,4,404,40411,4041103
404110307,"Rusasa",408,408,816,4,404,40411,4041103
404110308,"Vumage",189,179,368,4,404,40411,4041103
404110401,"Buganza",321,424,745,4,404,40411,4041104
404110402,"Bukumbi",167,200,367,4,404,40411,4041104
404110403,"Kabasha",310,384,694,4,404,40411,4041104
404110404,"Kanyenzugi",242,285,527,4,404,40411,4041104
404110405,"Kivumo",298,332,630,4,404,40411,4041104
404110406,"Mushunga",356,426,782,4,404,40411,4041104
404110407,"Shanja",150,186,336,4,404,40411,4041104
404120101,"Gashushura",576,685,1261,4,404,40412,4041201
404120102,"Kigeyo",417,428,845,4,404,40412,4041201
404120103,"Mugano",385,464,849,4,404,40412,4041201
404120104,"Nyamusanze",305,376,681,4,404,40412,4041201
404120105,"Songorero",408,471,879,4,404,40412,4041201
404120201,"Cyabami",327,439,766,4,404,40412,4041202
404120202,"Kagihanga",295,425,720,4,404,40412,4041202
404120203,"Karyango",371,455,826,4,404,40412,4041202
404120204,"Muhondo",242,265,507,4,404,40412,4041202
404120205,"Nyagahondo",279,375,654,4,404,40412,4041202
404120206,"Nyiraruhuha",343,372,715,4,404,40412,4041202
404120207,"Ryaruhirima",345,390,735,4,404,40412,4041202
404120208,"Shorezo",238,300,538,4,404,40412,4041202
404120301,"Bugarigari",269,335,604,4,404,40412,4041203
404120302,"Bukenyeye",192,270,462,4,404,40412,4041203
404120303,"Butunda",185,231,416,4,404,40412,4041203
404120304,"Cyabarenge",221,272,493,4,404,40412,4041203
404120305,"Kadehero",225,258,483,4,404,40412,4041203
404120306,"Kanyaru",315,354,669,4,404,40412,4041203
404120307,"Murandamo",105,118,223,4,404,40412,4041203
404120308,"Ngongwe",159,179,338,4,404,40412,4041203
404120309,"Nyantweri",141,166,307,4,404,40412,4041203
404120310,"Rebero",180,211,391,4,404,40412,4041203
404120401,"Bishingwe",208,271,479,4,404,40412,4041204
404120402,"Bugondo",219,244,463,4,404,40412,4041204
404120403,"Cyave",341,390,731,4,404,40412,4041204
404120404,"Kagesera",329,383,712,4,404,40412,4041204
404120405,"Mugomero",265,297,562,4,404,40412,4041204
404120406,"Nyabitare",206,226,432,4,404,40412,4041204
404130101,"Busura",383,450,833,4,404,40413,4041301
404130102,"Gakore",359,433,792,4,404,40413,4041301
404130103,"Hanika",263,300,563,4,404,40413,4041301
404130104,"Karutwe",209,263,472,4,404,40413,4041301
404130105,"Nguri",275,329,604,4,404,40413,4041301
404130106,"Nyabiho",468,551,1019,4,404,40413,4041301
404130107,"Rubeja",256,277,533,4,404,40413,4041301
404130108,"Ruganda ",149,166,315,4,404,40413,4041301
404130109,"Tatiro",497,584,1081,4,404,40413,4041301
404130201,"Bambiro",251,251,502,4,404,40413,4041302
404130202,"Basumba",172,171,343,4,404,40413,4041302
404130203,"Gacyogo",352,372,724,4,404,40413,4041302
404130204,"Gahunga",569,546,1115,4,404,40413,4041302
404130205,"Kabaya",137,131,268,4,404,40413,4041302
404130206,"Kanyangezi",285,279,564,4,404,40413,4041302
404130207,"Muturirwa",236,237,473,4,404,40413,4041302
404130208,"Nyarwondo",379,350,729,4,404,40413,4041302
404130209,"Rugarama",263,304,567,4,404,40413,4041302
404130210,"Rutamba",306,335,641,4,404,40413,4041302
404130301,"Gahama",297,327,624,4,404,40413,4041303
404130302,"Gasiza",317,372,689,4,404,40413,4041303
404130303,"Kabaya",375,437,812,4,404,40413,4041303
404130304,"Kanyamugezi",307,333,640,4,404,40413,4041303
404130305,"Maya",373,388,761,4,404,40413,4041303
404130306,"Muhabura",319,381,700,4,404,40413,4041303
404130307,"Rugwiro",256,257,513,4,404,40413,4041303
404130308,"Rukiko",353,335,688,4,404,40413,4041303
404130309,"Sasa",396,464,860,4,404,40413,4041303
404130401,"Birwa",195,210,405,4,404,40413,4041304
404130402,"Gashore",348,346,694,4,404,40413,4041304
404130403,"Mpinga",211,217,428,4,404,40413,4041304
404130404,"Nyakiriba",287,326,613,4,404,40413,4041304
404130405,"Rwambeho",262,259,521,4,404,40413,4041304
404130406,"Rwinkuba",297,397,694,4,404,40413,4041304
404140101,"Bushima",332,356,688,4,404,40414,4041401
404140102,"Cyogo",213,241,454,4,404,40414,4041401
404140103,"Murungu",243,300,543,4,404,40414,4041401
404140104,"Musheke",314,365,679,4,404,40414,4041401
404140105,"Remera",286,314,600,4,404,40414,4041401
404140106,"Taba",319,392,711,4,404,40414,4041401
404140201,"Burago",168,181,349,4,404,40414,4041402
404140202,"Burande",284,288,572,4,404,40414,4041402
404140203,"Gahinga",288,379,667,4,404,40414,4041402
404140204,"Kamonyi",207,186,393,4,404,40414,4041402
404140205,"Karubamba",208,244,452,4,404,40414,4041402
404140206,"Mugina",200,259,459,4,404,40414,4041402
404140207,"Nkoto",279,300,579,4,404,40414,4041402
404140208,"Nyabikungu",212,234,446,4,404,40414,4041402
404140209,"Rihiro",390,493,883,4,404,40414,4041402
404140301,"Bwenjeli",279,340,619,4,404,40414,4041403
404140302,"Kabira",277,242,519,4,404,40414,4041403
404140303,"Kabukoko",188,206,394,4,404,40414,4041403
404140304,"Kabuyenge",384,470,854,4,404,40414,4041403
404140305,"Kamonyi",283,349,632,4,404,40414,4041403
404140306,"Kiziba",329,396,725,4,404,40414,4041403
404140307,"Murambo",337,398,735,4,404,40414,4041403
404140308,"Taba",189,235,424,4,404,40414,4041403
404140401,"Gatenga",296,315,611,4,404,40414,4041404
404140402,"Kinyefurwe",281,297,578,4,404,40414,4041404
404140403,"Mubuga",204,251,455,4,404,40414,4041404
404140404,"Murambo",124,146,270,4,404,40414,4041404
404140405,"Ngoma",223,258,481,4,404,40414,4041404
404140406,"Nyansyo",233,247,480,4,404,40414,4041404
404140407,"Remya",259,435,694,4,404,40414,4041404
404140408,"Rugandu",255,278,533,4,404,40414,4041404
404140409,"Seta",284,368,652,4,404,40414,4041404
404150101,"Gahe",207,252,459,4,404,40415,4041501
404150102,"Gatare",223,274,497,4,404,40415,4041501
404150103,"Kanyoni",237,265,502,4,404,40415,4041501
404150104,"Kintobo",185,212,397,4,404,40415,4041501
404150105,"Mukaka",194,229,423,4,404,40415,4041501
404150106,"Murambo",197,268,465,4,404,40415,4041501
404150107,"Rugaragara",184,216,400,4,404,40415,4041501
404150108,"Rukiniro",203,251,454,4,404,40415,4041501
404150109,"Rukwavu",167,212,379,4,404,40415,4041501
404150201,"Gashinge",220,257,477,4,404,40415,4041502
404150202,"Gashishori",331,427,758,4,404,40415,4041502
404150203,"Gatete",202,277,479,4,404,40415,4041502
404150204,"Gitwe",236,242,478,4,404,40415,4041502
404150205,"Nganzo",138,133,271,4,404,40415,4041502
404150206,"Ruganda",183,213,396,4,404,40415,4041502
404150207,"Rukingu",302,331,633,4,404,40415,4041502
404150208,"Terimbere",283,283,566,4,404,40415,4041502
404150301,"Cyasuri",344,395,739,4,404,40415,4041503
404150302,"Genda",321,363,684,4,404,40415,4041503
404150303,"Kaberano",314,325,639,4,404,40415,4041503
404150304,"Kamonyi",221,303,524,4,404,40415,4041503
404150305,"Muremure",229,264,493,4,404,40415,4041503
404150306,"Mweru",202,254,456,4,404,40415,4041503
404150307,"Ngoma",220,231,451,4,404,40415,4041503
404150308,"Tetero",280,321,601,4,404,40415,4041503
404150401,"Bugambanyoni",255,293,548,4,404,40415,4041504
404150402,"Gasura",350,394,744,4,404,40415,4041504
404150403,"Gatokezo",217,253,470,4,404,40415,4041504
404150404,"Matyazo",345,397,742,4,404,40415,4041504
404150405,"Rubyiniro",264,306,570,4,404,40415,4041504
404150406,"Rusenge",199,197,396,4,404,40415,4041504
404150407,"Tarasi",256,294,550,4,404,40415,4041504
404160101,"Bucyaba",230,315,545,4,404,40416,4041601
404160102,"Busutamo",274,317,591,4,404,40416,4041601
404160103,"Buzamuye",243,292,535,4,404,40416,4041601
404160104,"Gahinga",209,222,431,4,404,40416,4041601
404160105,"Gasongati",155,176,331,4,404,40416,4041601
404160106,"Gikore ",208,232,440,4,404,40416,4041601
404160107,"Karambo",283,355,638,4,404,40416,4041601
404160108,"Muharuro",234,240,474,4,404,40416,4041601
404160109,"Munanira",195,223,418,4,404,40416,4041601
404160110,"Murambo",139,161,300,4,404,40416,4041601
404160111,"Musebeya",222,222,444,4,404,40416,4041601
404160112,"Ntagara",282,314,596,4,404,40416,4041601
404160113,"Rutuku",276,303,579,4,404,40416,4041601
404160201,"Burehe",292,249,541,4,404,40416,4041602
404160202,"Gacaca",315,302,617,4,404,40416,4041602
404160203,"Gaseke",241,251,492,4,404,40416,4041602
404160204,"Gitovu",553,583,1136,4,404,40416,4041602
404160205,"Kajerijeri",400,443,843,4,404,40416,4041602
404160206,"Karorero",288,281,569,4,404,40416,4041602
404160207,"Kirambo",373,369,742,4,404,40416,4041602
404160208,"Ndago",342,383,725,4,404,40416,4041602
404160209,"Nyarungu",401,447,848,4,404,40416,4041602
404160301,"Bisayu I",104,128,232,4,404,40416,4041603
404160302,"Bisayu Ii",280,322,602,4,404,40416,4041603
404160303,"Bumba",345,380,725,4,404,40416,4041603
404160304,"Kamukondo",148,189,337,4,404,40416,4041603
404160305,"Kanigo",124,147,271,4,404,40416,4041603
404160306,"Karuhanga",181,209,390,4,404,40416,4041603
404160307,"Kibuye",185,242,427,4,404,40416,4041603
404160308,"Ngundu",124,160,284,4,404,40416,4041603
404160309,"Ruhanga",155,168,323,4,404,40416,4041603
404160310,"Ruhurura I",369,382,751,4,404,40416,4041603
404160311,"Ruhurura Ii",98,120,218,4,404,40416,4041603
404160312,"Rutoro",305,327,632,4,404,40416,4041603
404170101,"Burindwa",313,348,661,4,404,40417,4041701
404170102,"Gacundura",374,421,795,4,404,40417,4041701
404170103,"Kanigo",239,292,531,4,404,40417,4041701
404170104,"Karegamazi",256,335,591,4,404,40417,4041701
404170105,"Moma",321,328,649,4,404,40417,4041701
404170106,"Rugaragara",262,281,543,4,404,40417,4041701
404170107,"Rugarambiro",144,171,315,4,404,40417,4041701
404170108,"Sarambwe",335,384,719,4,404,40417,4041701
404170201,"Bisaga",474,475,949,4,404,40417,4041702
404170202,"Cyapa",179,247,426,4,404,40417,4041702
404170203,"Gashoro",307,370,677,4,404,40417,4041702
404170204,"Kibuye",215,285,500,4,404,40417,4041702
404170205,"Ngonya",393,514,907,4,404,40417,4041702
404170206,"Rugezi",313,348,661,4,404,40417,4041702
404170207,"Rwerere",224,288,512,4,404,40417,4041702
404170301,"Buhore",317,378,695,4,404,40417,4041703
404170302,"Gakenke",125,157,282,4,404,40417,4041703
404170303,"Kamatengu",330,375,705,4,404,40417,4041703
404170304,"Kinkware",325,423,748,4,404,40417,4041703
404170305,"Mugera",217,237,454,4,404,40417,4041703
404170306,"Ngoma",391,472,863,4,404,40417,4041703
404170307,"Ruconsho",388,437,825,4,404,40417,4041703
404170401,"Gacyamu",317,322,639,4,404,40417,4041704
404170402,"Gatovu",262,354,616,4,404,40417,4041704
404170403,"Mucaca",318,345,663,4,404,40417,4041704
404170404,"Murambo",279,359,638,4,404,40417,4041704
404170405,"Mushubi",234,281,515,4,404,40417,4041704
404170406,"Tangata",286,340,626,4,404,40417,4041704
405010101,"Gasharu",483,542,1025,4,405,40501,4050101
405010102,"Kabuga",297,206,503,4,405,40501,4050101
405010103,"Kagarama",303,402,705,4,405,40501,4050101
405010104,"Karenge",496,478,974,4,405,40501,4050101
405010105,"Muguruka",391,368,759,4,405,40501,4050101
405010106,"Nyarutovu",576,532,1108,4,405,40501,4050101
405010107,"Rebero",277,380,657,4,405,40501,4050101
405010201,"Gabiro",231,256,487,4,405,40501,4050102
405010202,"Kanyogote",237,237,474,4,405,40501,4050102
405010203,"Rugogwe",422,483,905,4,405,40501,4050102
405010204,"Rurama",251,254,505,4,405,40501,4050102
405010205,"Rwarenga",414,417,831,4,405,40501,4050102
405010301,"Butare",367,379,746,4,405,40501,4050103
405010302,"Karambo",298,335,633,4,405,40501,4050103
405010303,"Karushya ",279,346,625,4,405,40501,4050103
405010304,"Kivugiza",278,305,583,4,405,40501,4050103
405010305,"Kivumu",285,290,575,4,405,40501,4050103
405010306,"Ruyange",367,392,759,4,405,40501,4050103
405010401,"Gicaca",503,339,842,4,405,40501,4050104
405010402,"Karagari",342,375,717,4,405,40501,4050104
405010403,"Mugorore",225,265,490,4,405,40501,4050104
405010404,"Ntarama",277,287,564,4,405,40501,4050104
405010405,"Nyarubira",325,367,692,4,405,40501,4050104
405020101,"Kabuye",432,328,760,4,405,40502,4050201
405020102,"Kavuruga",220,234,454,4,405,40502,4050201
405020103,"Kidandali",173,204,377,4,405,40502,4050201
405020104,"Ndoha",209,213,422,4,405,40502,4050201
405020105,"Nyakabungo",171,209,380,4,405,40502,4050201
405020106,"Nyarubuye",268,268,536,4,405,40502,4050201
405020107,"Nyarwina",220,248,468,4,405,40502,4050201
405020108,"Rutoma",129,137,266,4,405,40502,4050201
405020109,"Rwarurema",147,155,302,4,405,40502,4050201
405020201,"Cyamukanya",237,280,517,4,405,40502,4050202
405020202,"Kumana",326,354,680,4,405,40502,4050202
405020203,"Kumunini",336,382,718,4,405,40502,4050202
405020204,"Kuwindenge",217,237,454,4,405,40502,4050202
405020205,"Muneke",134,137,271,4,405,40502,4050202
405020206,"Murehe",162,226,388,4,405,40502,4050202
405020207,"Nyagakizi",230,228,458,4,405,40502,4050202
405020208,"Nyakagera",311,358,669,4,405,40502,4050202
405020209,"Nyamugari",208,234,442,4,405,40502,4050202
405020210,"Rurenge",143,186,329,4,405,40502,4050202
405020301,"Akavuza",247,221,468,4,405,40502,4050203
405020302,"Murambi",313,346,659,4,405,40502,4050203
405020303,"Nyarumba",168,183,351,4,405,40502,4050203
405020304,"Nyirantungu",254,242,496,4,405,40502,4050203
405020305,"Rwebisheke",210,230,440,4,405,40502,4050203
405020306,"Rwondo",218,226,444,4,405,40502,4050203
405020307,"Ryakirayi",156,170,326,4,405,40502,4050203
405020401,"Gahondo",240,243,483,4,405,40502,4050204
405020402,"Musayo",231,263,494,4,405,40502,4050204
405020403,"Ndayabana",268,289,557,4,405,40502,4050204
405020404,"Nyagatoma",256,284,540,4,405,40502,4050204
405020405,"Ruhuha",243,244,487,4,405,40502,4050204
405020406,"Warufu",220,249,469,4,405,40502,4050204
405030101,"Gacurabwenge",623,638,1261,4,405,40503,4050301
405030102,"Gasharu",411,511,922,4,405,40503,4050301
405030103,"Gashirwe",559,595,1154,4,405,40503,4050301
405030104,"Rubyiniro",366,424,790,4,405,40503,4050301
405030105,"Ruyaga",487,582,1069,4,405,40503,4050301
405030106,"Rwasama",579,653,1232,4,405,40503,4050301
405030201,"Bereshi",169,221,390,4,405,40503,4050302
405030202,"Gatare",224,252,476,4,405,40503,4050302
405030203,"Gisuna",926,522,1448,4,405,40503,4050302
405030204,"Kinihira I",255,366,621,4,405,40503,4050302
405030205,"Kinihira Ii",179,253,432,4,405,40503,4050302
405030206,"Rebero",199,230,429,4,405,40503,4050302
405030207,"Ruhashya",256,290,546,4,405,40503,4050302
405030208,"Rwiri",162,152,314,4,405,40503,4050302
405030301,"Gakenke",246,267,513,4,405,40503,4050303
405030302,"Mugorore",239,291,530,4,405,40503,4050303
405030303,"Rugarama",318,341,659,4,405,40503,4050303
405030304,"Ruzo",264,286,550,4,405,40503,4050303
405030401,"Kabingo",326,378,704,4,405,40503,4050304
405030402,"Karambi",270,341,611,4,405,40503,4050304
405030403,"Kivugiza",346,420,766,4,405,40503,4050304
405030404,"Mugandu",213,269,482,4,405,40503,4050304
405030501,"Gacaca",325,199,524,4,405,40503,4050305
405030502,"Rukereza",413,461,874,4,405,40503,4050305
405030503,"Rurambi",325,524,849,4,405,40503,4050305
405030504,"Taba",262,328,590,4,405,40503,4050305
405030601,"Bukamba",519,509,1028,4,405,40503,4050306
405030602,"Gitovu",188,207,395,4,405,40503,4050306
405030603,"Karambo",143,173,316,4,405,40503,4050306
405030604,"Kimirimo",296,343,639,4,405,40503,4050306
405030701,"Gacyamo",324,356,680,4,405,40503,4050307
405030702,"Kabuga",284,321,605,4,405,40503,4050307
405030703,"Kanunga",181,181,362,4,405,40503,4050307
405030704,"Rugaragara",192,268,460,4,405,40503,4050307
405030801,"Gasiza",274,273,547,4,405,40503,4050308
405030802,"Gatete",200,257,457,4,405,40503,4050308
405030803,"Kumana",211,237,448,4,405,40503,4050308
405030804,"Mugomero",284,346,630,4,405,40503,4050308
405030805,"Nyiragasuruba",867,1302,2169,4,405,40503,4050308
405030806,"Rwabukoko",247,287,534,4,405,40503,4050308
405030807,"Umurara",190,174,364,4,405,40503,4050308
405030901,"Kagarama",237,261,498,4,405,40503,4050309
405030902,"Mukeri",334,396,730,4,405,40503,4050309
405030903,"Muriza",293,296,589,4,405,40503,4050309
405030904,"Nyamiyaga",276,355,631,4,405,40503,4050309
405030905,"Nyamugali",223,214,437,4,405,40503,4050309
405030906,"Nyande",302,368,670,4,405,40503,4050309
405030907,"Nyarubande",208,219,427,4,405,40503,4050309
405030908,"Rugandu",283,308,591,4,405,40503,4050309
405030909,"Rugarama",273,377,650,4,405,40503,4050309
405030910,"Rwamuhuba",247,260,507,4,405,40503,4050309
405040101,"Mubuga",268,306,574,4,405,40504,4050401
405040102,"Mugera",242,262,504,4,405,40504,4050401
405040103,"Ryamuromba",188,231,419,4,405,40504,4050401
405040104,"Zihare",165,194,359,4,405,40504,4050401
405040201,"Kiliba",228,273,501,4,405,40504,4050402
405040202,"Nyamabare",247,293,540,4,405,40504,4050402
405040203,"Rugerero",329,302,631,4,405,40504,4050402
405040301,"Burambira",316,395,711,4,405,40504,4050403
405040302,"Gashija",255,301,556,4,405,40504,4050403
405040303,"Gatoki",148,163,311,4,405,40504,4050403
405040304,"Kabare",163,216,379,4,405,40504,4050403
405040305,"Kigombe",118,130,248,4,405,40504,4050403
405040306,"Remera",275,343,618,4,405,40504,4050403
405040307,"Ryaruhumba",167,197,364,4,405,40504,4050403
405040401,"Burambira",237,310,547,4,405,40504,4050404
405040402,"Gipandi",205,238,443,4,405,40504,4050404
405040403,"Remera",164,182,346,4,405,40504,4050404
405040404,"Rusebeya",244,263,507,4,405,40504,4050404
405040501,"Burindi",198,210,408,4,405,40504,4050405
405040502,"Humura",205,231,436,4,405,40504,4050405
405040503,"Maya",197,230,427,4,405,40504,4050405
405040504,"Murore",225,241,466,4,405,40504,4050405
405040505,"Rusambya",161,182,343,4,405,40504,4050405
405040601,"Gatuna",422,374,796,4,405,40504,4050406
405040602,"Kagera",207,236,443,4,405,40504,4050406
405040603,"Keyebe",193,226,419,4,405,40504,4050406
405040604,"Kivuruga",153,205,358,4,405,40504,4050406
405040605,"Rukizi",386,452,838,4,405,40504,4050406
405050101,"Kababito",428,486,914,4,405,40505,4050501
405050102,"Kabacuzi",354,387,741,4,405,40505,4050501
405050103,"Kagahumbi",273,304,577,4,405,40505,4050501
405050104,"Matyazo",311,324,635,4,405,40505,4050501
405050105,"Nyamirambo",322,370,692,4,405,40505,4050501
405050106,"Rugarama",249,273,522,4,405,40505,4050501
405050201,"Bisika",286,296,582,4,405,40505,4050502
405050202,"Bushiranyota",287,340,627,4,405,40505,4050502
405050203,"Butare",352,383,735,4,405,40505,4050502
405050204,"Cyamabano",373,379,752,4,405,40505,4050502
405050205,"Gatare",285,307,592,4,405,40505,4050502
405050206,"Kabeza",330,348,678,4,405,40505,4050502
405050207,"Kigabiro",316,329,645,4,405,40505,4050502
405050301,"Gasharu",342,333,675,4,405,40505,4050503
405050302,"Mashyoza",259,239,498,4,405,40505,4050503
405050303,"Nganwa",439,494,933,4,405,40505,4050503
405050304,"Nyakabungo",313,357,670,4,405,40505,4050503
405050305,"Ruzizi",317,430,747,4,405,40505,4050503
405050306,"Tanda",332,356,688,4,405,40505,4050503
405060101,"Gitaba",520,510,1030,4,405,40506,4050601
405060102,"Karihira",476,580,1056,4,405,40506,4050601
405060103,"Munini",569,644,1213,4,405,40506,4050601
405060104,"Muyange",307,449,756,4,405,40506,4050601
405060105,"Nyaruvumu",377,414,791,4,405,40506,4050601
405060106,"Nyirabadugu",362,406,768,4,405,40506,4050601
405060201,"Kigoma",292,308,600,4,405,40506,4050602
405060202,"Musetsa",472,545,1017,4,405,40506,4050602
405060203,"Nyirangoga",290,343,633,4,405,40506,4050602
405060204,"Rukongi",319,359,678,4,405,40506,4050602
405060301,"Gatobotobo",239,246,485,4,405,40506,4050603
405060302,"Gicumbi",251,305,556,4,405,40506,4050603
405060303,"Maya",245,246,491,4,405,40506,4050603
405060304,"Mukenke",260,296,556,4,405,40506,4050603
405060305,"Murama",250,261,511,4,405,40506,4050603
405060401,"Kagwa",234,260,494,4,405,40506,4050604
405060402,"Kamanyundo",243,354,597,4,405,40506,4050604
405060403,"Kamwumba",268,249,517,4,405,40506,4050604
405060404,"Mwange",316,346,662,4,405,40506,4050604
405060501,"Gatare",485,549,1034,4,405,40506,4050605
405060502,"Gatiba",255,345,600,4,405,40506,4050605
405060503,"Kabare",306,364,670,4,405,40506,4050605
405060504,"Kageyo",313,345,658,4,405,40506,4050605
405060505,"Mugomero",412,561,973,4,405,40506,4050605
405060506,"Musura",227,304,531,4,405,40506,4050605
405060507,"Mutobo",284,376,660,4,405,40506,4050605
405060508,"Rukomo",420,500,920,4,405,40506,4050605
405070101,"Gatare",164,167,331,4,405,40507,4050701
405070102,"Kabungo",181,239,420,4,405,40507,4050701
405070103,"Kajevuba",402,358,760,4,405,40507,4050701
405070104,"Nyaruhanga",202,236,438,4,405,40507,4050701
405070105,"Rugarama",212,265,477,4,405,40507,4050701
405070106,"Rugari",123,152,275,4,405,40507,4050701
405070107,"Ryakabanda",193,238,431,4,405,40507,4050701
405070201,"Gashiru",256,281,537,4,405,40507,4050702
405070202,"Kamabare",248,204,452,4,405,40507,4050702
405070203,"Nyakagera",230,280,510,4,405,40507,4050702
405070204,"Nyakara",325,363,688,4,405,40507,4050702
405070205,"Nyakibande",193,237,430,4,405,40507,4050702
405070206,"Rugarama",182,231,413,4,405,40507,4050702
405070301,"Centre Mulindi",162,128,290,4,405,40507,4050703
405070302,"Gisunzu",176,192,368,4,405,40507,4050703
405070303,"Kagorogoro",163,192,355,4,405,40507,4050703
405070304,"Kigwene",158,166,324,4,405,40507,4050703
405070305,"Nyakabungo",159,56,215,4,405,40507,4050703
405070306,"Rugenda",166,184,350,4,405,40507,4050703
405070307,"Ruhita",128,146,274,4,405,40507,4050703
405070308,"Rukizi",243,255,498,4,405,40507,4050703
405070309,"Runyinya",189,186,375,4,405,40507,4050703
405070310,"Taba",191,204,395,4,405,40507,4050703
405070401,"Cyasaku",158,169,327,4,405,40507,4050704
405070402,"Kabeza",179,213,392,4,405,40507,4050704
405070403,"Kanyaruyonga",161,178,339,4,405,40507,4050704
405070404,"Kinnyogo",175,200,375,4,405,40507,4050704
405070405,"Mushunga",166,213,379,4,405,40507,4050704
405070406,"Nyamabare",137,158,295,4,405,40507,4050704
405070501,"Kabare",243,269,512,4,405,40507,4050705
405070502,"Kamushure",205,248,453,4,405,40507,4050705
405070503,"Karambo",347,446,793,4,405,40507,4050705
405070504,"Ngabira",279,258,537,4,405,40507,4050705
405070505,"Nyagatare",299,398,697,4,405,40507,4050705
405080101,"Gabiro",247,252,499,4,405,40508,4050801
405080102,"Kigarama",391,377,768,4,405,40508,4050801
405080103,"Mugera",209,231,440,4,405,40508,4050801
405080104,"Murehe",220,252,472,4,405,40508,4050801
405080105,"Mutara",227,252,479,4,405,40508,4050801
405080106,"Rubindi",271,331,602,4,405,40508,4050801
405080201,"Agacyamo",345,437,782,4,405,40508,4050802
405080202,"Kiyovu",252,276,528,4,405,40508,4050802
405080203,"Murambo",223,222,445,4,405,40508,4050802
405080204,"Rurambi",103,110,213,4,405,40508,4050802
405080205,"Rwamazi",215,227,442,4,405,40508,4050802
405080301,"Bugibwa",289,330,619,4,405,40508,4050803
405080302,"Kajevuba",332,336,668,4,405,40508,4050803
405080303,"Rurembo",289,340,629,4,405,40508,4050803
405080304,"Rusebeya",171,181,352,4,405,40508,4050803
405080401,"Busa",207,246,453,4,405,40508,4050804
405080402,"Bushinga",197,224,421,4,405,40508,4050804
405080403,"Gasiza",278,333,611,4,405,40508,4050804
405080404,"Gitaba",173,213,386,4,405,40508,4050804
405080405,"Kabeza",143,172,315,4,405,40508,4050804
405080406,"Rugasa",237,284,521,4,405,40508,4050804
405080407,"Sangano",206,224,430,4,405,40508,4050804
405080408,"Shyigura",352,384,736,4,405,40508,4050804
405080501,"Gakubo",268,311,579,4,405,40508,4050805
405080502,"Kavure",187,179,366,4,405,40508,4050805
405080503,"Kiyovu",327,334,661,4,405,40508,4050805
405080504,"Nyamyumba",303,432,735,4,405,40508,4050805
405080505,"Rebero",274,323,597,4,405,40508,4050805
405080601,"Gatsyata",207,242,449,4,405,40508,4050806
405080602,"Gatungo",208,235,443,4,405,40508,4050806
405080603,"Muturirwa",224,242,466,4,405,40508,4050806
405080604,"Nyantarure",285,307,592,4,405,40508,4050806
405080605,"Nyarukombe",170,170,340,4,405,40508,4050806
405080606,"Rugasa",257,261,518,4,405,40508,4050806
405080607,"Rusabira",210,256,466,4,405,40508,4050806
405080608,"Taba",176,209,385,4,405,40508,4050806
405090101,"Gisiza",292,315,607,4,405,40509,4050901
405090102,"Karwanira",298,388,686,4,405,40509,4050901
405090103,"Kirwa",320,385,705,4,405,40509,4050901
405090104,"Kivomo",304,340,644,4,405,40509,4050901
405090105,"Museke",372,437,809,4,405,40509,4050901
405090106,"Nyarurambi",265,317,582,4,405,40509,4050901
405090107,"Rugandu",261,304,565,4,405,40509,4050901
405090201,"Kamonyi",225,264,489,4,405,40509,4050902
405090202,"Karambo",233,278,511,4,405,40509,4050902
405090203,"Mpinga",234,250,484,4,405,40509,4050902
405090204,"Mukaka",246,303,549,4,405,40509,4050902
405090205,"Murambo",207,222,429,4,405,40509,4050902
405090206,"Murehe",208,242,450,4,405,40509,4050902
405090207,"Nyamiyaga",197,240,437,4,405,40509,4050902
405090208,"Nyarubuye",187,195,382,4,405,40509,4050902
405090209,"Rebero",223,257,480,4,405,40509,4050902
405090210,"Remera",245,278,523,4,405,40509,4050902
405090301,"Gatare",203,256,459,4,405,40509,4050903
405090302,"Gitsimbura",214,250,464,4,405,40509,4050903
405090303,"Kabuga",254,325,579,4,405,40509,4050903
405090304,"Kacyiru",386,443,829,4,405,40509,4050903
405090305,"Kagote",258,315,573,4,405,40509,4050903
405090306,"Kaje",275,310,585,4,405,40509,4050903
405090307,"Kirwa",277,346,623,4,405,40509,4050903
405090308,"Kivumu",274,312,586,4,405,40509,4050903
405090309,"Mubuga",282,318,600,4,405,40509,4050903
405090310,"Murambo",181,178,359,4,405,40509,4050903
405090311,"Rutovu",248,323,571,4,405,40509,4050903
405090312,"Tetero",163,192,355,4,405,40509,4050903
405100101,"Burambira",316,328,644,4,405,40510,4051001
405100102,"Ndarama",304,357,661,4,405,40510,4051001
405100103,"Nyakabungo",247,262,509,4,405,40510,4051001
405100104,"Rugarama",325,369,694,4,405,40510,4051001
405100201,"Ibereshi",310,340,650,4,405,40510,4051002
405100202,"Kagunga",252,283,535,4,405,40510,4051002
405100203,"Kiyorwa",254,276,530,4,405,40510,4051002
405100204,"Mugina",241,233,474,4,405,40510,4051002
405100205,"Nyacyoroma",233,250,483,4,405,40510,4051002
405100206,"Nyange",191,246,437,4,405,40510,4051002
405100301,"Burembo",277,310,587,4,405,40510,4051003
405100302,"Gacwamba",251,269,520,4,405,40510,4051003
405100303,"Kariba",327,386,713,4,405,40510,4051003
405100304,"Nyamutoko",224,260,484,4,405,40510,4051003
405100401,"Gikore",220,274,494,4,405,40510,4051004
405100402,"Kaziba",272,276,548,4,405,40510,4051004
405100403,"Mafumirwa",293,290,583,4,405,40510,4051004
405100404,"Murara",238,264,502,4,405,40510,4051004
405100405,"Rugeshi",173,241,414,4,405,40510,4051004
405100501,"Gakizi",254,322,576,4,405,40510,4051005
405100502,"Kagarama",213,241,454,4,405,40510,4051005
405100503,"Kinnyogo",184,244,428,4,405,40510,4051005
405100504,"Munyege",151,205,356,4,405,40510,4051005
405100505,"Rurembo",238,243,481,4,405,40510,4051005
405100506,"Rushasha",188,209,397,4,405,40510,4051005
405100507,"Ruziku",284,339,623,4,405,40510,4051005
405100601,"Kabungo",159,162,321,4,405,40510,4051006
405100602,"Kagane",254,288,542,4,405,40510,4051006
405100603,"Nyagakizi",277,296,573,4,405,40510,4051006
405100604,"Rusambya ",247,274,521,4,405,40510,4051006
405110101,"Gicuregenya",219,215,434,4,405,40511,4051101
405110102,"Ntonyanga",211,216,427,4,405,40511,4051101
405110103,"Rugaragara",241,281,522,4,405,40511,4051101
405110104,"Rukazire",355,420,775,4,405,40511,4051101
405110105,"Rwamitembe",232,233,465,4,405,40511,4051101
405110201,"Cyerere",290,335,625,4,405,40511,4051102
405110202,"Gatobotobo",277,330,607,4,405,40511,4051102
405110203,"Karambi",289,384,673,4,405,40511,4051102
405110204,"Karumuli",407,457,864,4,405,40511,4051102
405110205,"Ryarwoga",394,406,800,4,405,40511,4051102
405110301,"Gikumba",241,295,536,4,405,40511,4051103
405110302,"Kabuye",351,370,721,4,405,40511,4051103
405110303,"Kagogo",204,221,425,4,405,40511,4051103
405110304,"Kirengo",365,356,721,4,405,40511,4051103
405110401,"Gasharu",308,377,685,4,405,40511,4051104
405110402,"Kabare",319,365,684,4,405,40511,4051104
405110403,"Kimpongo",163,228,391,4,405,40511,4051104
405110404,"Mayora",204,242,446,4,405,40511,4051104
405110405,"Rudogo",210,273,483,4,405,40511,4051104
405110501,"Gasizi",197,215,412,4,405,40511,4051105
405110502,"Karundi",269,309,578,4,405,40511,4051105
405110503,"Kirara",415,495,910,4,405,40511,4051105
405110504,"Kirwanirwa",265,331,596,4,405,40511,4051105
405110505,"Mayogi",259,288,547,4,405,40511,4051105
405110506,"Nyampundu",384,412,796,4,405,40511,4051105
405110507,"Ryagashaka",262,313,575,4,405,40511,4051105
405120101,"Gasharu",216,294,510,4,405,40512,4051201
405120102,"Gihira",219,248,467,4,405,40512,4051201
405120103,"Irasaniro",256,302,558,4,405,40512,4051201
405120104,"Ngando",321,270,591,4,405,40512,4051201
405120105,"Nyamabuye",279,353,632,4,405,40512,4051201
405120106,"Nyamiryango",131,141,272,4,405,40512,4051201
405120107,"Nyamugari",141,171,312,4,405,40512,4051201
405120108,"Runyinya",208,236,444,4,405,40512,4051201
405120201,"Busabira",279,323,602,4,405,40512,4051202
405120202,"Kabasega",262,319,581,4,405,40512,4051202
405120203,"Kagarama",261,320,581,4,405,40512,4051202
405120204,"Merezo",240,313,553,4,405,40512,4051202
405120205,"Minanire",173,193,366,4,405,40512,4051202
405120206,"Nyagasozi",214,272,486,4,405,40512,4051202
405120207,"Rusebeya",248,306,554,4,405,40512,4051202
405120301,"Gataba",232,265,497,4,405,40512,4051203
405120302,"Karambi",440,496,936,4,405,40512,4051203
405120303,"Kimisugi",352,374,726,4,405,40512,4051203
405120304,"Muhororo",332,412,744,4,405,40512,4051203
405120305,"Rukondo",258,290,548,4,405,40512,4051203
405120306,"Rurama",235,273,508,4,405,40512,4051203
405120307,"Rutongo",230,270,500,4,405,40512,4051203
405120401,"Gatare",258,267,525,4,405,40512,4051204
405120402,"Gihangara",276,260,536,4,405,40512,4051204
405120403,"Kamaganga",277,308,585,4,405,40512,4051204
405120404,"Karama",246,315,561,4,405,40512,4051204
405120405,"Karambi",214,233,447,4,405,40512,4051204
405120406,"Kariku",196,228,424,4,405,40512,4051204
405120407,"Muhengeri",289,360,649,4,405,40512,4051204
405120408,"Nyarubande",198,241,439,4,405,40512,4051204
405120501,"Gitega",255,252,507,4,405,40512,4051205
405120502,"Kajwejwe",247,274,521,4,405,40512,4051205
405120503,"Kavumu",214,277,491,4,405,40512,4051205
405120504,"Mataba",203,246,449,4,405,40512,4051205
405120505,"Nkenzi",325,351,676,4,405,40512,4051205
405120506,"Rugarama",214,230,444,4,405,40512,4051205
405120507,"Ruhondo",266,287,553,4,405,40512,4051205
405120508,"Rusumo",272,309,581,4,405,40512,4051205
405130101,"Majyambere",244,298,542,4,405,40513,4051301
405130102,"Maya",265,318,583,4,405,40513,4051301
405130103,"Ruhango",259,277,536,4,405,40513,4051301
405130201,"Byimana",263,279,542,4,405,40513,4051302
405130202,"Kamabuye",348,386,734,4,405,40513,4051302
405130203,"Kumuremure",327,394,721,4,405,40513,4051302
405130204,"Rugarama",266,275,541,4,405,40513,4051302
405130301,"Karambo",298,358,656,4,405,40513,4051303
405130302,"Mataba",323,375,698,4,405,40513,4051303
405130303,"Mugorore",341,374,715,4,405,40513,4051303
405130304,"Rugari",388,430,818,4,405,40513,4051303
405130401,"Kabeza",244,283,527,4,405,40513,4051304
405130402,"Kaduha",292,270,562,4,405,40513,4051304
405130403,"Mubuga",276,299,575,4,405,40513,4051304
405130404,"Nyarubuye",291,281,572,4,405,40513,4051304
405130501,"Gaseke",375,383,758,4,405,40513,4051305
405130502,"Gatare",242,276,518,4,405,40513,4051305
405130503,"Kinyinya",272,330,602,4,405,40513,4051305
405130504,"Murama",325,341,666,4,405,40513,4051305
405130601,"Gasave",329,369,698,4,405,40513,4051306
405130602,"Karambi",260,306,566,4,405,40513,4051306
405130603,"Nyirakagamba",349,374,723,4,405,40513,4051306
405130604,"Rwingwe",312,350,662,4,405,40513,4051306
405130701,"Mataba",252,310,562,4,405,40513,4051307
405130702,"Miyange",285,327,612,4,405,40513,4051307
405130703,"Rugarama",266,295,561,4,405,40513,4051307
405130704,"Ruyaga",267,308,575,4,405,40513,4051307
405140101,"Gikombe",272,276,548,4,405,40514,4051401
405140102,"Kabere",2063,371,2434,4,405,40514,4051401
405140103,"Rwambeho",244,284,528,4,405,40514,4051401
405140104,"Rwirute",239,300,539,4,405,40514,4051401
405140105,"Ryabishanga",303,321,624,4,405,40514,4051401
405140201,"Gakoma",243,323,566,4,405,40514,4051402
405140202,"Gasake",254,285,539,4,405,40514,4051402
405140203,"Gatare",247,276,523,4,405,40514,4051402
405140204,"Kiyovu",202,212,414,4,405,40514,4051402
405140205,"Ntabangira",233,292,525,4,405,40514,4051402
405140206,"Rusayu",253,277,530,4,405,40514,4051402
405140301,"Gashiru",226,262,488,4,405,40514,4051403
405140302,"Kabuga",206,287,493,4,405,40514,4051403
405140303,"Nyagafunzo",220,277,497,4,405,40514,4051403
405140304,"Nyirantarengwa",197,250,447,4,405,40514,4051403
405140305,"Rwata",214,261,475,4,405,40514,4051403
405140401,"Birumba",280,290,570,4,405,40514,4051404
405140402,"Mashyiga",238,281,519,4,405,40514,4051404
405140403,"Nyangezi",271,259,530,4,405,40514,4051404
405140404,"Rembero",316,362,678,4,405,40514,4051404
405140405,"Ruhoho",226,242,468,4,405,40514,4051404
405140501,"Kabingo",224,280,504,4,405,40514,4051405
405140502,"Kageje",244,281,525,4,405,40514,4051405
405140503,"Nyamugali",262,321,583,4,405,40514,4051405
405140504,"Ruhinga",289,302,591,4,405,40514,4051405
405140505,"Ryanterura",270,273,543,4,405,40514,4051405
405140506,"Shokero",213,248,461,4,405,40514,4051405
405140601,"Gacaca",298,337,635,4,405,40514,4051406
405140602,"Kabahura",226,268,494,4,405,40514,4051406
405140603,"Kagogo",279,302,581,4,405,40514,4051406
405140604,"Mwendo",245,240,485,4,405,40514,4051406
405140605,"Rwagihura",253,288,541,4,405,40514,4051406
405140701,"Cyankaranka",249,312,561,4,405,40514,4051407
405140702,"Mwenyi",220,266,486,4,405,40514,4051407
405140703,"Nturo",204,247,451,4,405,40514,4051407
405140704,"Nyarubuye",219,268,487,4,405,40514,4051407
405140705,"Nyirakazo",215,268,483,4,405,40514,4051407
405150101,"Gomba",263,284,547,4,405,40515,4051501
405150102,"Kirimbi",229,259,488,4,405,40515,4051501
405150103,"Nkurura",217,281,498,4,405,40515,4051501
405150104,"Runaba",313,352,665,4,405,40515,4051501
405150105,"Rusambya",271,337,608,4,405,40515,4051501
405150201,"Gashiru",277,301,578,4,405,40515,4051502
405150202,"Karambo",199,272,471,4,405,40515,4051502
405150301,"Kabaya",231,274,505,4,405,40515,4051503
405150302,"Kagugo",364,409,773,4,405,40515,4051503
405150303,"Mugote",244,250,494,4,405,40515,4051503
405150304,"Nyakesha",230,255,485,4,405,40515,4051503
405150401,"Centre Rubaya",303,364,667,4,405,40515,4051504
405150402,"Gasheke",207,217,424,4,405,40515,4051504
405150403,"Mabare",299,319,618,4,405,40515,4051504
405150404,"Ngange",271,317,588,4,405,40515,4051504
405150501,"Kabeza",209,269,478,4,405,40515,4051505
405150502,"Kiriba",226,290,516,4,405,40515,4051505
405150503,"Mariba",264,275,539,4,405,40515,4051505
405160101,"Birambo",282,307,589,4,405,40516,4051601
405160102,"Bisika",253,244,497,4,405,40516,4051601
405160103,"Bwuhira",252,269,521,4,405,40516,4051601
405160104,"Gateke",315,314,629,4,405,40516,4051601
405160105,"Kanombe",304,333,637,4,405,40516,4051601
405160106,"Rwambungo",287,323,610,4,405,40516,4051601
405160201,"Bukamba",226,248,474,4,405,40516,4051602
405160202,"Kabuga",205,228,433,4,405,40516,4051602
405160203,"Karengo",164,218,382,4,405,40516,4051602
405160204,"Kimiko",214,240,454,4,405,40516,4051602
405160205,"Muhama",265,292,557,4,405,40516,4051602
405160206,"Nyamutezi",473,699,1172,4,405,40516,4051602
405160207,"Sabiro",334,390,724,4,405,40516,4051602
405160301,"Gatare",267,181,448,4,405,40516,4051603
405160302,"Gitaba",288,274,562,4,405,40516,4051603
405160303,"Karambi",237,278,515,4,405,40516,4051603
405160304,"Nyarubuye",231,264,495,4,405,40516,4051603
405160305,"Rushubi",386,388,774,4,405,40516,4051603
405160306,"Rusumo",251,224,475,4,405,40516,4051603
405160401,"Gahondo",251,299,550,4,405,40516,4051604
405160402,"Gasharara",314,335,649,4,405,40516,4051604
405160403,"Kariba",264,280,544,4,405,40516,4051604
405160404,"Kivugiza",256,294,550,4,405,40516,4051604
405160405,"Meshero",278,315,593,4,405,40516,4051604
405160406,"Rukomo",354,400,754,4,405,40516,4051604
405160407,"Ryarubanza",259,291,550,4,405,40516,4051604
405160501,"Cyingoma",320,343,663,4,405,40516,4051605
405160502,"Kanyiramana",310,353,663,4,405,40516,4051605
405160503,"Kararama",309,323,632,4,405,40516,4051605
405160504,"Kayungwe",311,319,630,4,405,40516,4051605
405160505,"Mburamazi",316,303,619,4,405,40516,4051605
405160506,"Murambo",247,310,557,4,405,40516,4051605
405160507,"Ryandinda",292,302,594,4,405,40516,4051605
405160601,"Kabeza",256,279,535,4,405,40516,4051606
405160602,"Kabuga",367,383,750,4,405,40516,4051606
405160603,"Mataba",319,353,672,4,405,40516,4051606
405160604,"Munyinya",331,359,690,4,405,40516,4051606
405160605,"Nyankokoma",273,320,593,4,405,40516,4051606
405160606,"Rwamushumba",299,307,606,4,405,40516,4051606
405170101,"Bugwe",292,337,629,4,405,40517,4051701
405170102,"Gisiza",195,244,439,4,405,40517,4051701
405170103,"Gitega",216,216,432,4,405,40517,4051701
405170104,"Kabo",292,277,569,4,405,40517,4051701
405170105,"Karambi",339,361,700,4,405,40517,4051701
405170106,"Karambo",337,387,724,4,405,40517,4051701
405170107,"Rubyiro",275,273,548,4,405,40517,4051701
405170108,"Ryaruganzu",183,201,384,4,405,40517,4051701
405170201,"Gashinge",262,258,520,4,405,40517,4051702
405170202,"Kabuga",372,398,770,4,405,40517,4051702
405170203,"Kamutora",218,247,465,4,405,40517,4051702
405170204,"Karwoga",142,156,298,4,405,40517,4051702
405170205,"Mabare",234,279,513,4,405,40517,4051702
405170206,"Nkamba",558,482,1040,4,405,40517,4051702
405170207,"Nyamyumba",175,187,362,4,405,40517,4051702
405170208,"Remera",216,257,473,4,405,40517,4051702
405170301,"C. Rushaki",197,203,400,4,405,40517,4051703
405170302,"Gatonde",214,249,463,4,405,40517,4051703
405170303,"Izinga",232,223,455,4,405,40517,4051703
405170304,"Mbuga",262,347,609,4,405,40517,4051703
405170305,"Ngabira",248,299,547,4,405,40517,4051703
405170306,"Nyaruhanga",210,240,450,4,405,40517,4051703
405170307,"Rumuri",226,276,502,4,405,40517,4051703
405170308,"Rwaranda",172,211,383,4,405,40517,4051703
405180101,"Karugeyo",369,446,815,4,405,40518,4051801
405180102,"Kintaganirwa",397,474,871,4,405,40518,4051801
405180103,"Marembo",524,583,1107,4,405,40518,4051801
405180104,"Matyazo",388,487,875,4,405,40518,4051801
405180105,"Nyabisindu",488,532,1020,4,405,40518,4051801
405180201,"Buyegero",190,209,399,4,405,40518,4051802
405180202,"Kabagabo",232,266,498,4,405,40518,4051802
405180203,"Kabusunzu",142,186,328,4,405,40518,4051802
405180204,"Kagarama",212,266,478,4,405,40518,4051802
405180205,"Rwimbogo",311,349,660,4,405,40518,4051802
405180206,"Yogi",164,177,341,4,405,40518,4051802
405180301,"Bureranyana",238,260,498,4,405,40518,4051803
405180302,"Gashinya",403,468,871,4,405,40518,4051803
405180303,"Kabira",534,487,1021,4,405,40518,4051803
405180304,"Kanaba",215,273,488,4,405,40518,4051803
405180401,"Kabuye",392,413,805,4,405,40518,4051804
405180402,"Munini",374,432,806,4,405,40518,4051804
405180403,"Nyakabingo",340,347,687,4,405,40518,4051804
405180404,"Nyakavunga",302,322,624,4,405,40518,4051804
405180405,"Rugarama",283,330,613,4,405,40518,4051804
405180501,"Bushokanyambo",360,379,739,4,405,40518,4051805
405180502,"Gasharu",370,409,779,4,405,40518,4051805
405180503,"Kirwa",339,417,756,4,405,40518,4051805
405180504,"Mataba",387,459,846,4,405,40518,4051805
405180505,"Ruti",238,276,514,4,405,40518,4051805
405180601,"Bariza",425,452,877,4,405,40518,4051806
405180602,"Bwangamwanda",431,479,910,4,405,40518,4051806
405180603,"Murehe",394,437,831,4,405,40518,4051806
405180604,"Nyagatoma",518,514,1032,4,405,40518,4051806
405180605,"Nyansenge",438,498,936,4,405,40518,4051806
405190101,"Karambo",277,317,594,4,405,40519,4051901
405190102,"Kigarama",243,288,531,4,405,40519,4051901
405190103,"Mushesho",279,315,594,4,405,40519,4051901
405190104,"Nyankokoma",180,189,369,4,405,40519,4051901
405190105,"Rugarama",228,255,483,4,405,40519,4051901
405190201,"Karambi",198,255,453,4,405,40519,4051902
405190202,"Kirara",172,157,329,4,405,40519,4051902
405190203,"Mataba",173,205,378,4,405,40519,4051902
405190204,"Nyamirama",189,210,399,4,405,40519,4051902
405190205,"Ruhete",294,313,607,4,405,40519,4051902
405190206,"Ryasunzu",202,204,406,4,405,40519,4051902
405190301,"Kagasha",231,269,500,4,405,40519,4051903
405190302,"Nyarubuye",273,305,578,4,405,40519,4051903
405190303,"Nyarurama",241,262,503,4,405,40519,4051903
405190304,"Nyarwina",271,296,567,4,405,40519,4051903
405190305,"Remera",232,268,500,4,405,40519,4051903
405190306,"Rugerero",260,266,526,4,405,40519,4051903
405190401,"Buyanja",223,260,483,4,405,40519,4051904
405190402,"Murehe",187,206,393,4,405,40519,4051904
405190403,"Nyarusange",188,283,471,4,405,40519,4051904
405190404,"Taba",297,325,622,4,405,40519,4051904
405190501,"Bitoma",284,294,578,4,405,40519,4051905
405190502,"Burambo",172,174,346,4,405,40519,4051905
405190503,"Gatare",427,341,768,4,405,40519,4051905
405190504,"Kirwa",205,196,401,4,405,40519,4051905
405190505,"Mwanza",205,221,426,4,405,40519,4051905
405190506,"Rwaburegeya",163,152,315,4,405,40519,4051905
405190507,"Rwamiko",279,314,593,4,405,40519,4051905
405190508,"Sunzu",139,182,321,4,405,40519,4051905
405190601,"Gatoki",258,243,501,4,405,40519,4051906
405190602,"Karambo",352,357,709,4,405,40519,4051906
405190603,"Kirwa",134,162,296,4,405,40519,4051906
405190604,"Mugorore",223,250,473,4,405,40519,4051906
405190605,"Nyagakizi",303,377,680,4,405,40519,4051906
405190606,"Nyakaju",204,222,426,4,405,40519,4051906
405190607,"Rwinyana",199,178,377,4,405,40519,4051906
405200101,"Bugarura",226,250,476,4,405,40520,4052001
405200102,"Gabiro",233,268,501,4,405,40520,4052001
405200103,"Kamurenzi",213,239,452,4,405,40520,4052001
405200104,"Karika",321,322,643,4,405,40520,4052001
405200105,"Mukuyu",193,246,439,4,405,40520,4052001
405200106,"Murambi",213,265,478,4,405,40520,4052001
405200107,"Nyagasozi",241,270,511,4,405,40520,4052001
405200108,"Rugarama",174,219,393,4,405,40520,4052001
405200201,"Cyiri",438,479,917,4,405,40520,4052002
405200202,"Kabira",368,421,789,4,405,40520,4052002
405200203,"Kanyove",392,419,811,4,405,40520,4052002
405200204,"Karangara",332,361,693,4,405,40520,4052002
405200205,"Mutambiko",240,288,528,4,405,40520,4052002
405200206,"Rubuye",262,312,574,4,405,40520,4052002
405200301,"Kabusunzu",257,275,532,4,405,40520,4052003
405200302,"Kibiraro",315,300,615,4,405,40520,4052003
405200303,"Kigaga",357,441,798,4,405,40520,4052003
405200304,"Ntaremba",315,301,616,4,405,40520,4052003
405200305,"Rugarama",217,260,477,4,405,40520,4052003
405210101,"Bushara",294,322,616,4,405,40521,4052101
405210102,"Gasura",387,411,798,4,405,40521,4052101
405210103,"Gatare",279,314,593,4,405,40521,4052101
405210104,"Nganzo",214,244,458,4,405,40521,4052101
405210201,"Gacyamo",172,187,359,4,405,40521,4052102
405210202,"Iharama",318,364,682,4,405,40521,4052102
405210203,"Mubuga",283,296,579,4,405,40521,4052102
405210204,"Ntomvu",232,241,473,4,405,40521,4052102
405210205,"Rugarama",289,300,589,4,405,40521,4052102
405210301,"Gasiza",320,364,684,4,405,40521,4052103
405210302,"Kagali",232,231,463,4,405,40521,4052103
405210303,"Karambo",231,265,496,4,405,40521,4052103
405210304,"Matyazo",221,241,462,4,405,40521,4052103
405210305,"Murambo",288,331,619,4,405,40521,4052103
405210306,"Rukiniro",222,209,431,4,405,40521,4052103
405210307,"Rutete",237,254,491,4,405,40521,4052103
405210401,"Bikumba",240,288,528,4,405,40521,4052104
405210402,"Irembo",241,272,513,4,405,40521,4052104
405210403,"Karuhanga",217,229,446,4,405,40521,4052104
405210404,"Nyakabingo",338,369,707,4,405,40521,4052104
405210405,"Nyamiyaga",253,317,570,4,405,40521,4052104
405210501,"Ituze",234,247,481,4,405,40521,4052105
405210502,"Kabeza",330,377,707,4,405,40521,4052105
405210503,"Kajyanjyali",246,307,553,4,405,40521,4052105
405210504,"Rugali",269,327,596,4,405,40521,4052105
405210505,"Runaba",290,353,643,4,405,40521,4052105
405210506,"Ryamatebura",354,360,714,4,405,40521,4052105
501010101,"Cyingara",293,317,610,5,501,50101,5010101
501010102,"Janjagiro",348,379,727,5,501,50101,5010101
501010103,"Kabeza",226,252,478,5,501,50101,5010101
501010104,"Kabuga",180,205,385,5,501,50101,5010101
501010105,"Ndinda",150,162,312,5,501,50101,5010101
501010106,"Nyirabiteri",237,270,507,5,501,50101,5010101
501010201,"Mataba",245,323,568,5,501,50101,5010102
501010202,"Rambura",357,469,826,5,501,50101,5010102
501010203,"Rebero",300,306,606,5,501,50101,5010102
501010204,"Rugarama",106,129,235,5,501,50101,5010102
501010205,"Rugenge ",107,152,259,5,501,50101,5010102
501010301,"Akabeza",326,332,658,5,501,50101,5010103
501010302,"Kibaza",225,265,490,5,501,50101,5010103
501010303,"Kirehe",222,254,476,5,501,50101,5010103
501010304,"Rugarama",117,139,256,5,501,50101,5010103
501010401,"Agatare",205,246,451,5,501,50101,5010104
501010402,"Akagarama",203,179,382,5,501,50101,5010104
501010403,"Bigarama",204,242,446,5,501,50101,5010104
501010404,"Cyarutabana",211,238,449,5,501,50101,5010104
501010405,"Makwandi",125,156,281,5,501,50101,5010104
501010406,"Ntungamo",222,255,477,5,501,50101,5010104
501010407,"Shenga",159,168,327,5,501,50101,5010104
501010501,"Gihima",234,257,491,5,501,50101,5010105
501010502,"Gitwe",276,276,552,5,501,50101,5010105
501010503,"Kabirizi",226,280,506,5,501,50101,5010105
501010504,"Kivugiza",144,200,344,5,501,50101,5010105
501010505,"Murambi",303,349,652,5,501,50101,5010105
501010506,"Rurembo",227,245,472,5,501,50101,5010105
501010601,"Birembo",254,261,515,5,501,50101,5010106
501010602,"Byimana",200,246,446,5,501,50101,5010106
501010603,"Irukwaya",268,305,573,5,501,50101,5010106
501010604,"Karambo",257,217,474,5,501,50101,5010106
501010605,"Munini",339,362,701,5,501,50101,5010106
501020101,"Cyanga",153,183,336,5,501,50102,5010201
501020102,"Gatare",501,424,925,5,501,50102,5010201
501020103,"Kabeza",256,295,551,5,501,50102,5010201
501020104,"Kajevuba",182,202,384,5,501,50102,5010201
501020105,"Nyirabujari",198,216,414,5,501,50102,5010201
501020106,"Rebero",171,179,350,5,501,50102,5010201
501020201,"Akabuga",197,243,440,5,501,50102,5010202
501020202,"Kabonero",232,272,504,5,501,50102,5010202
501020203,"Rwarugaju",202,229,431,5,501,50102,5010202
501020204,"Samatare",207,246,453,5,501,50102,5010202
501020301,"Agakari",123,150,273,5,501,50102,5010203
501020302,"Gatenderi",132,144,276,5,501,50102,5010203
501020303,"Ruhita",139,149,288,5,501,50102,5010203
501020304,"Umunini",123,126,249,5,501,50102,5010203
501020401,"Iramiro",165,209,374,5,501,50102,5010204
501020402,"Kabuye ",172,234,406,5,501,50102,5010204
501020403,"Kanserege",180,216,396,5,501,50102,5010204
501020404,"Karutimbo",276,258,534,5,501,50102,5010204
501020405,"Kinyovi",168,205,373,5,501,50102,5010204
501020406,"Rurambi",171,185,356,5,501,50102,5010204
501020501,"Agasharu",128,141,269,5,501,50102,5010205
501020502,"Kamugasa",118,121,239,5,501,50102,5010205
501020503,"Nyabagaza",141,159,300,5,501,50102,5010205
501020504,"Nyirarwirungu",140,151,291,5,501,50102,5010205
501020505,"Rubonobono",213,206,419,5,501,50102,5010205
501020506,"Rugagi",117,155,272,5,501,50102,5010205
501020507,"Ryasenteteri",136,129,265,5,501,50102,5010205
501020601,"Amatafari",166,196,362,5,501,50102,5010206
501020602,"Byimana",177,204,381,5,501,50102,5010206
501020603,"Mataba",132,182,314,5,501,50102,5010206
501020604,"Nyakiri",121,130,251,5,501,50102,5010206
501020605,"Nyarucyamo",122,145,267,5,501,50102,5010206
501020606,"Rebero",99,120,219,5,501,50102,5010206
501020701,"Akamasasa",101,158,259,5,501,50102,5010207
501020702,"Cyeru",200,189,389,5,501,50102,5010207
501020703,"Gacunshu",155,196,351,5,501,50102,5010207
501020704,"Kabarore",138,168,306,5,501,50102,5010207
501020705,"Karambo",109,146,255,5,501,50102,5010207
501020706,"Kiyovu",114,134,248,5,501,50102,5010207
501020707,"Ruyumba",164,173,337,5,501,50102,5010207
501020708,"Ryamuzuka",177,202,379,5,501,50102,5010207
501020801,"Kabigondo",181,195,376,5,501,50102,5010208
501020802,"Kamurindi",272,229,501,5,501,50102,5010208
501020803,"Kinteko",305,344,649,5,501,50102,5010208
501020804,"Kiruruma",262,372,634,5,501,50102,5010208
501020805,"Mataba",230,261,491,5,501,50102,5010208
501020806,"Nyamugari",386,399,785,5,501,50102,5010208
501030101,"Busharu",308,368,676,5,501,50103,5010301
501030102,"Nyakivomo",255,253,508,5,501,50103,5010301
501030103,"Rurindimura",305,323,628,5,501,50103,5010301
501030201,"Akanogo",370,403,773,5,501,50103,5010302
501030202,"Mugusha",305,388,693,5,501,50103,5010302
501030203,"Nyakabungo",356,411,767,5,501,50103,5010302
501030204,"Shaburondo",2560,930,3490,5,501,50103,5010302
501030301,"Nyagacyamo",368,424,792,5,501,50103,5010303
501030302,"Nyakagarama",365,416,781,5,501,50103,5010303
501030303,"Rurembo",326,353,679,5,501,50103,5010303
501030401,"Agatare",309,363,672,5,501,50103,5010304
501030402,"Nyamabuye",226,242,468,5,501,50103,5010304
501030403,"Umunanira",343,393,736,5,501,50103,5010304
501030404,"Uruhuha",257,289,546,5,501,50103,5010304
501030501,"Akabuga",243,316,559,5,501,50103,5010305
501030502,"Ingeyo",364,403,767,5,501,50103,5010305
501030503,"Kibonde",336,410,746,5,501,50103,5010305
501030504,"Uruyenzi",329,372,701,5,501,50103,5010305
501030601,"Abakina",338,365,703,5,501,50103,5010306
501030602,"Byimana",201,237,438,5,501,50103,5010306
501030603,"Cyiri",426,506,932,5,501,50103,5010306
501030604,"Rwagahaya",320,351,671,5,501,50103,5010306
501030605,"Umunini",392,476,868,5,501,50103,5010306
501030701,"Mpungwe",357,442,799,5,501,50103,5010307
501030702,"Nyagahinga",699,680,1379,5,501,50103,5010307
501030703,"Nyagakombe",397,434,831,5,501,50103,5010307
501040101,"Bicaca Centre",238,278,516,5,501,50104,5010401
501040102,"Cyanyirampazi",195,201,396,5,501,50104,5010401
501040103,"Cyarugaju",208,224,432,5,501,50104,5010401
501040104,"Kabeza",207,276,483,5,501,50104,5010401
501040105,"Kajevuba",241,241,482,5,501,50104,5010401
501040106,"Karuyenzi",232,256,488,5,501,50104,5010401
501040107,"Runzenze",257,315,572,5,501,50104,5010401
501040201,"Byimana",220,261,481,5,501,50104,5010402
501040202,"Karambo",259,206,465,5,501,50104,5010402
501040203,"Kiyaya",161,156,317,5,501,50104,5010402
501040204,"Rukori",257,271,528,5,501,50104,5010402
501040301,"Ipide",387,393,780,5,501,50104,5010403
501040302,"Kabasore",223,219,442,5,501,50104,5010403
501040303,"Migamba",350,370,720,5,501,50104,5010403
501040304,"Nyagatovu",281,310,591,5,501,50104,5010403
501040305,"Ruvomo",235,251,486,5,501,50104,5010403
501040401,"Byimana",315,305,620,5,501,50104,5010404
501040402,"Kagese",230,260,490,5,501,50104,5010404
501040403,"Kangamba",202,196,398,5,501,50104,5010404
501040404,"Kimarambasa",309,360,669,5,501,50104,5010404
501040405,"Nkongi",340,390,730,5,501,50104,5010404
501040501,"Bwiza",203,211,414,5,501,50104,5010405
501040502,"Karenge",480,575,1055,5,501,50104,5010405
501040503,"Ntebe",238,296,534,5,501,50104,5010405
501040504,"Rebero",482,497,979,5,501,50104,5010405
501040601,"Feri",123,139,262,5,501,50104,5010406
501040602,"Kanyangese",336,378,714,5,501,50104,5010406
501040603,"Nyabubare",299,338,637,5,501,50104,5010406
501040604,"Rwinka",261,272,533,5,501,50104,5010406
501040605,"Ryamugabo",307,349,656,5,501,50104,5010406
501040701,"Cyerwa",267,294,561,5,501,50104,5010407
501040702,"Mutabo",294,320,614,5,501,50104,5010407
501040703,"Ndengo",216,204,420,5,501,50104,5010407
501040704,"Nyagasenyi",161,180,341,5,501,50104,5010407
501040705,"Nyakabuye",250,255,505,5,501,50104,5010407
501040706,"Nyamatete",179,173,352,5,501,50104,5010407
501050101,"Gitega",169,256,425,5,501,50105,5010501
501050102,"Kagererao",125,164,289,5,501,50105,5010501
501050103,"Munini",206,276,482,5,501,50105,5010501
501050104,"Nyakabande",160,186,346,5,501,50105,5010501
501050105,"Rutaka",485,487,972,5,501,50105,5010501
501050106,"Rutonde",234,322,556,5,501,50105,5010501
501050107,"Rweza",111,140,251,5,501,50105,5010501
501050201,"Bigabiro",525,538,1063,5,501,50105,5010502
501050202,"Biraro",369,352,721,5,501,50105,5010502
501050203,"Busanza",419,417,836,5,501,50105,5010502
501050204,"Cyahafi",245,256,501,5,501,50105,5010502
501050205,"Kabeza",425,304,729,5,501,50105,5010502
501050206,"Kabuye",666,704,1370,5,501,50105,5010502
501050207,"Kamata",513,549,1062,5,501,50105,5010502
501050208,"Karuhayi",470,589,1059,5,501,50105,5010502
501050209,"Karutimbo",506,567,1073,5,501,50105,5010502
501050210,"Rurembo",476,457,933,5,501,50105,5010502
501050301,"Gahonogo",223,234,457,5,501,50105,5010503
501050302,"Kavura",250,233,483,5,501,50105,5010503
501050303,"Kayenzi",277,357,634,5,501,50105,5010503
501050304,"Kigega",311,357,668,5,501,50105,5010503
501050305,"Kirehe",244,275,519,5,501,50105,5010503
501050306,"Ramba",334,438,772,5,501,50105,5010503
501050307,"Rusave",1114,984,2098,5,501,50105,5010503
501050308,"Umuganura",280,267,547,5,501,50105,5010503
501050401,"Bacyoro",295,364,659,5,501,50105,5010504
501050402,"Bugugu",157,213,370,5,501,50105,5010504
501050403,"Cyimpima",156,221,377,5,501,50105,5010504
501050404,"Gasharu",181,217,398,5,501,50105,5010504
501050405,"Kabuga",210,224,434,5,501,50105,5010504
501050406,"Kamanga",279,320,599,5,501,50105,5010504
501050407,"Miyange",254,248,502,5,501,50105,5010504
501050501,"Cyaruhogo",196,234,430,5,501,50105,5010505
501050502,"Gatare",241,285,526,5,501,50105,5010505
501050503,"Kiruhura",249,231,480,5,501,50105,5010505
501050504,"Nyabishunzi",139,199,338,5,501,50105,5010505
501050505,"Rugobagoba",224,250,474,5,501,50105,5010505
501050506,"Rushangara",180,239,419,5,501,50105,5010505
501060101,"Gatobotobo",249,310,559,5,501,50106,5010601
501060102,"Kabeza",221,280,501,5,501,50106,5010601
501060103,"Nyarukombe",202,239,441,5,501,50106,5010601
501060201,"Birembo",285,323,608,5,501,50106,5010602
501060202,"Ubwiza",254,318,572,5,501,50106,5010602
501060203,"Umunini",221,288,509,5,501,50106,5010602
501060204,"Uwimanzi",417,519,936,5,501,50106,5010602
501060301,"Gahengeri",208,248,456,5,501,50106,5010603
501060302,"Kayenzi",226,293,519,5,501,50106,5010603
501060303,"Kinunga",177,211,388,5,501,50106,5010603
501060304,"Ragwe",314,309,623,5,501,50106,5010603
501060401,"Agatare",431,510,941,5,501,50106,5010604
501060403,"Cyeru",178,213,391,5,501,50106,5010604
501060404,"Karambo",153,215,368,5,501,50106,5010604
501060405,"Kingondo",9106,911,10017,5,501,50106,5010604
501060406,"Nyarugarama",202,210,412,5,501,50106,5010604
501060501,"Byimana",190,227,417,5,501,50106,5010605
501060502,"Gasharu",184,236,420,5,501,50106,5010605
501060503,"Kabirizi",158,216,374,5,501,50106,5010605
501060504,"Karwiru",199,256,455,5,501,50106,5010605
501060601,"Gasharu",214,265,479,5,501,50106,5010606
501060602,"Kabusunzu",143,159,302,5,501,50106,5010606
501060603,"Nyendo",225,242,467,5,501,50106,5010606
501060604,"Yabaranda",119,161,280,5,501,50106,5010606
501060701,"Akabeza",273,287,560,5,501,50106,5010607
501060702,"Kibare",304,316,620,5,501,50106,5010607
501060703,"Rubirizi",241,255,496,5,501,50106,5010607
501060801,"Amagaju",254,261,515,5,501,50106,5010608
501060802,"Urugero",173,172,345,5,501,50106,5010608
501060803,"Urugwiro",274,305,579,5,501,50106,5010608
501060901,"Akagarama",225,263,488,5,501,50106,5010609
501060902,"Akatorero",216,250,466,5,501,50106,5010609
501060903,"Gahondo",168,172,340,5,501,50106,5010609
501060904,"Kanywiriri",206,224,430,5,501,50106,5010609
501060905,"Kavura",102,116,218,5,501,50106,5010609
501060906,"Kidogo",173,209,382,5,501,50106,5010609
501060907,"Mpinga",243,251,494,5,501,50106,5010609
501060908,"Plage",476,452,928,5,501,50106,5010609
501060909,"Umubuga",204,225,429,5,501,50106,5010609
501070101,"Gishike",296,331,627,5,501,50107,5010701
501070102,"Kababero",220,293,513,5,501,50107,5010701
501070103,"Kabare",285,359,644,5,501,50107,5010701
501070104,"Kamamana",256,375,631,5,501,50107,5010701
501070105,"Kangabo",237,303,540,5,501,50107,5010701
501070106,"Kigabiro",140,185,325,5,501,50107,5010701
501070107,"Rwakigara ",104,136,240,5,501,50107,5010701
501070108,"Rwimbogo",174,205,379,5,501,50107,5010701
501070201,"Kabuye",307,378,685,5,501,50107,5010702
501070202,"Kiryango",222,230,452,5,501,50107,5010702
501070203,"Mataba",376,465,841,5,501,50107,5010702
501070204,"Nyagakombe",190,231,421,5,501,50107,5010702
501070205,"Rudashya",349,366,715,5,501,50107,5010702
501070206,"Rushangara",275,345,620,5,501,50107,5010702
501070301,"Birayi",340,401,741,5,501,50107,5010703
501070302,"Gatare",241,316,557,5,501,50107,5010703
501070303,"Kabingo",295,326,621,5,501,50107,5010703
501070304,"Kanyegera",321,330,651,5,501,50107,5010703
501070305,"Mubuga",283,354,637,5,501,50107,5010703
501070401,"Cyinganzwa",219,252,471,5,501,50107,5010704
501070402,"Kabazeyi",218,252,470,5,501,50107,5010704
501070403,"Karambo",344,409,753,5,501,50107,5010704
501070404,"Rwisange",235,304,539,5,501,50107,5010704
501080101,"Irebero",136,153,289,5,501,50108,5010801
501080102,"Isangano",198,248,446,5,501,50108,5010801
501080103,"Kabeza",162,205,367,5,501,50108,5010801
501080104,"Umuhumuro",106,115,221,5,501,50108,5010801
501080105,"Urugwiza",179,234,413,5,501,50108,5010801
501080201,"Akabuye",165,169,334,5,501,50108,5010802
501080202,"Kiruhura",103,106,209,5,501,50108,5010802
501080203,"Rutembo",109,122,231,5,501,50108,5010802
501080204,"Rwagahigi",121,131,252,5,501,50108,5010802
501080205,"Rwamugurusu",176,228,404,5,501,50108,5010802
501080206,"Rweza",113,142,255,5,501,50108,5010802
501080207,"Umurinzi",98,101,199,5,501,50108,5010802
501080301,"Kabenda",211,268,479,5,501,50108,5010803
501080302,"Kagarama",217,253,470,5,501,50108,5010803
501080303,"Ndago",149,162,311,5,501,50108,5010803
501080304,"Rweza",189,208,397,5,501,50108,5010803
501080401,"Agatare",153,146,299,5,501,50108,5010804
501080402,"Akabuye",182,253,435,5,501,50108,5010804
501080403,"Ntunga",232,241,473,5,501,50108,5010804
501080404,"Nyagakombe",214,284,498,5,501,50108,5010804
501080501,"Bakannyi",288,367,655,5,501,50108,5010805
501080502,"Kabuye ",236,285,521,5,501,50108,5010805
501080503,"Karubisha",321,435,756,5,501,50108,5010805
501080504,"Nyagahanga",198,237,435,5,501,50108,5010805
501080505,"Ryamirenge",310,363,673,5,501,50108,5010805
501080601,"Babasha",289,322,611,5,501,50108,5010806
501080602,"Buyanja",271,299,570,5,501,50108,5010806
501080603,"Kabeza",334,281,615,5,501,50108,5010806
501080604,"Kimara",322,341,663,5,501,50108,5010806
501080605,"Kiyovu",287,298,585,5,501,50108,5010806
501080606,"Mazinga",263,267,530,5,501,50108,5010806
501080607,"Nkindi",288,345,633,5,501,50108,5010806
501090101,"Akabare",292,337,629,5,501,50109,5010901
501090102,"Binunga",249,328,577,5,501,50109,5010901
501090103,"Budahigwa",119,133,252,5,501,50109,5010901
501090104,"Duha",193,209,402,5,501,50109,5010901
501090105,"Gashikiri",253,251,504,5,501,50109,5010901
501090106,"Rugabano",212,247,459,5,501,50109,5010901
501090107,"Rukombe",282,316,598,5,501,50109,5010901
501090201,"Karambo",344,365,709,5,501,50109,5010902
501090202,"Nyantoki",473,543,1016,5,501,50109,5010902
501090203,"Rwabiyange",393,408,801,5,501,50109,5010902
501090301,"Kagarama",200,200,400,5,501,50109,5010903
501090302,"Kiruhura",246,265,511,5,501,50109,5010903
501090303,"Muhogoto",195,198,393,5,501,50109,5010903
501090304,"Nyagacyamo",468,473,941,5,501,50109,5010903
501090305,"Nyamigano",175,193,368,5,501,50109,5010903
501090401,"Gatika",344,472,816,5,501,50109,5010904
501090402,"Kadasumbwa",307,372,679,5,501,50109,5010904
501090403,"Karifuru",251,286,537,5,501,50109,5010904
501090404,"Nyakiriba",733,616,1349,5,501,50109,5010904
501090405,"Rugarama",209,240,449,5,501,50109,5010904
501090501,"Agashuhe",151,186,337,5,501,50109,5010905
501090502,"Busanza",187,221,408,5,501,50109,5010905
501090503,"Bwiza",173,257,430,5,501,50109,5010905
501090504,"Nyabisindu",235,291,526,5,501,50109,5010905
501090505,"Rujumbura",222,250,472,5,501,50109,5010905
501090506,"Rwamivu",213,250,463,5,501,50109,5010905
501090507,"Umunini",169,183,352,5,501,50109,5010905
501090601,"Bitsibo",368,419,787,5,501,50109,5010906
501090602,"Ruhita",413,457,870,5,501,50109,5010906
501090603,"Rutoma",307,334,641,5,501,50109,5010906
501100101,"Akubugingo",268,270,538,5,501,50110,5011001
501100102,"Kampigika",253,260,513,5,501,50110,5011001
501100103,"Rugarama",322,338,660,5,501,50110,5011001
501100104,"Ryabaheshwa",281,273,554,5,501,50110,5011001
501100201,"Gatare",257,300,557,5,501,50110,5011002
501100202,"Gishaka",176,194,370,5,501,50110,5011002
501100203,"Kabeza",215,230,445,5,501,50110,5011002
501100204,"Kagona",171,173,344,5,501,50110,5011002
501100205,"Karama",208,242,450,5,501,50110,5011002
501100206,"Rebero",184,189,373,5,501,50110,5011002
501100207,"Rubaza",190,196,386,5,501,50110,5011002
501100208,"Rusave",175,218,393,5,501,50110,5011002
501100209,"Yeruzalemu",228,229,457,5,501,50110,5011002
501100301,"Bitega",382,423,805,5,501,50110,5011003
501100302,"Kajororo",362,400,762,5,501,50110,5011003
501100303,"Kayigi",288,311,599,5,501,50110,5011003
501100304,"Miyove",328,325,653,5,501,50110,5011003
501100305,"Murehe",290,303,593,5,501,50110,5011003
501100306,"Ruvomo",203,243,446,5,501,50110,5011003
501100401,"Gakomeye",165,199,364,5,501,50110,5011004
501100402,"Gasave",326,365,691,5,501,50110,5011004
501100403,"Gisenyi",239,274,513,5,501,50110,5011004
501100404,"Kabagabo",177,225,402,5,501,50110,5011004
501100405,"Kajevuba",206,201,407,5,501,50110,5011004
501100406,"Kanyinya",279,282,561,5,501,50110,5011004
501100407,"Nyarubambo",124,146,270,5,501,50110,5011004
501100408,"Samuramba",431,464,895,5,501,50110,5011004
501100501,"Gatuza",198,220,418,5,501,50110,5011005
501100502,"Gitaraga",142,146,288,5,501,50110,5011005
501100503,"Gituza",160,226,386,5,501,50110,5011005
501100504,"Kinunga",143,166,309,5,501,50110,5011005
501100505,"Marembo",189,169,358,5,501,50110,5011005
501100506,"Mugogo",120,129,249,5,501,50110,5011005
501100507,"Mumena",242,248,490,5,501,50110,5011005
501100508,"Rubona",196,256,452,5,501,50110,5011005
501110101,"Bicumbi",327,347,674,5,501,50111,5011101
501110102,"Gasharu",237,295,532,5,501,50111,5011101
501110103,"Karama",236,284,520,5,501,50111,5011101
501110104,"Manene",273,269,542,5,501,50111,5011101
501110105,"Nyagihanga",336,324,660,5,501,50111,5011101
501110106,"Rwimbogo",300,343,643,5,501,50111,5011101
501110107,"Sabusaro",312,350,662,5,501,50111,5011101
501110201,"Byange",251,348,599,5,501,50111,5011102
501110202,"Kabahima",403,425,828,5,501,50111,5011102
501110203,"Kangaruye",226,286,512,5,501,50111,5011102
501110204,"Rebero",322,384,706,5,501,50111,5011102
501110205,"Rubiha",400,437,837,5,501,50111,5011102
501110206,"Ruseke",219,231,450,5,501,50111,5011102
501110301,"Cyome",209,254,463,5,501,50111,5011103
501110302,"Gisanza",206,241,447,5,501,50111,5011103
501110303,"Akagarama",144,189,333,5,501,50111,5011103
501110304,"Kigabiro",218,279,497,5,501,50111,5011103
501110305,"Mpinga",118,140,258,5,501,50111,5011103
501110306,"Munini I",80,106,186,5,501,50111,5011103
501110307,"Munini Ii",287,306,593,5,501,50111,5011103
501110308,"Rebero",154,165,319,5,501,50111,5011103
501110401,"Cyimbazi",248,279,527,5,501,50111,5011104
501110402,"Kabacuzi",263,322,585,5,501,50111,5011104
501110403,"Kadasumbwa",337,369,706,5,501,50111,5011104
501110404,"Karuzingura",403,441,844,5,501,50111,5011104
501110405,"Kiyovu",342,353,695,5,501,50111,5011104
501110406,"Nkira",233,241,474,5,501,50111,5011104
501110407,"Ntunga",175,174,349,5,501,50111,5011104
501110408,"Rugarama",216,240,456,5,501,50111,5011104
501110409,"Rugenge",203,217,420,5,501,50111,5011104
501120101,"Bihembe",223,189,412,5,501,50112,5011201
501120102,"Busimbuzi",324,343,667,5,501,50112,5011201
501120103,"Butare",179,179,358,5,501,50112,5011201
501120104,"Kabere",118,150,268,5,501,50112,5011201
501120105,"Kanyangese",130,203,333,5,501,50112,5011201
501120106,"Mubumbwe",183,223,406,5,501,50112,5011201
501120107,"Ngarama",168,199,367,5,501,50112,5011201
501120108,"Rusheshe",327,384,711,5,501,50112,5011201
501120201,"Gatare",323,380,703,5,501,50112,5011202
501120202,"Karogo",241,260,501,5,501,50112,5011202
501120203,"Kigina",153,157,310,5,501,50112,5011202
501120204,"Runzenze",172,179,351,5,501,50112,5011202
501120205,"Samuduha",302,294,596,5,501,50112,5011202
501120301,"Gishore",239,232,471,5,501,50112,5011203
501120302,"Kagarama",168,170,338,5,501,50112,5011203
501120303,"Matyazo",235,264,499,5,501,50112,5011203
501120304,"Nyirabuhene",146,163,309,5,501,50112,5011203
501120305,"Rugende",220,226,446,5,501,50112,5011203
501120306,"Ruhanika",151,151,302,5,501,50112,5011203
501120307,"Rusagara",179,228,407,5,501,50112,5011203
501120308,"Rusave",121,134,255,5,501,50112,5011203
501120309,"Rususa",165,165,330,5,501,50112,5011203
501120401,"Akamasatura",177,203,380,5,501,50112,5011204
501120402,"Munini",280,326,606,5,501,50112,5011204
501120403,"Nyakagarama",328,312,640,5,501,50112,5011204
501120404,"Nyarurembo",166,211,377,5,501,50112,5011204
501120405,"Nyarutovu",240,275,515,5,501,50112,5011204
501120406,"Nyiramitemeri",196,250,446,5,501,50112,5011204
501120407,"Rwamibungo",166,199,365,5,501,50112,5011204
501120408,"Rwankacari",141,156,297,5,501,50112,5011204
501120501,"Cyaruhinda",135,183,318,5,501,50112,5011205
501120502,"Kamashaza",258,314,572,5,501,50112,5011205
501120503,"Kasemanyana",189,182,371,5,501,50112,5011205
501120504,"Kimicanga",220,256,476,5,501,50112,5011205
501120505,"Nduba",161,180,341,5,501,50112,5011205
501120506,"Nduhuye",175,276,451,5,501,50112,5011205
501120507,"Rwimbogo",262,243,505,5,501,50112,5011205
501120508,"Ryarurindo",265,288,553,5,501,50112,5011205
501130101,"Akanzige",182,186,368,5,501,50113,5011301
501130102,"Akanzu",277,315,592,5,501,50113,5011301
501130103,"Cyahafi",126,136,262,5,501,50113,5011301
501130104,"Cyerwa",499,385,884,5,501,50113,5011301
501130105,"Gikoni",277,304,581,5,501,50113,5011301
501130106,"Gitanu",159,193,352,5,501,50113,5011301
501130107,"Kiyovu",210,217,427,5,501,50113,5011301
501130108,"Nyarugenge",271,264,535,5,501,50113,5011301
501130201,"Gisenyi",222,288,510,5,501,50113,5011302
501130202,"Kajevuba",312,352,664,5,501,50113,5011302
501130203,"Kamabuye",133,148,281,5,501,50113,5011302
501130204,"Karukannyi",215,218,433,5,501,50113,5011302
501130205,"Mikoni",217,241,458,5,501,50113,5011302
501130206,"Mubuga",233,219,452,5,501,50113,5011302
501130207,"Nyarutovu",219,288,507,5,501,50113,5011302
501130208,"Rugunga",185,225,410,5,501,50113,5011302
501130301,"Agasharu",268,309,577,5,501,50113,5011303
501130302,"Gatoki",229,272,501,5,501,50113,5011303
501130303,"Kabeza",228,225,453,5,501,50113,5011303
501130304,"Kamakuka",202,217,419,5,501,50113,5011303
501130305,"Kibabara",236,279,515,5,501,50113,5011303
501130306,"Ndinda",218,243,461,5,501,50113,5011303
501130307,"Nyarusange",225,230,455,5,501,50113,5011303
501130401,"Bicaca",178,201,379,5,501,50113,5011304
501130402,"Bitega",224,210,434,5,501,50113,5011304
501130403,"Kayibanda",289,316,605,5,501,50113,5011304
501130404,"Nyabugogo",238,295,533,5,501,50113,5011304
501130405,"Ruvomo",181,223,404,5,501,50113,5011304
501130406,"Rwagatsama",216,253,469,5,501,50113,5011304
501140101,"Bidudu",172,239,411,5,501,50114,5011401
501140102,"Gitwa",176,215,391,5,501,50114,5011401
501140103,"Kabayange I",263,284,547,5,501,50114,5011401
501140104,"Kabayange Ii",194,228,422,5,501,50114,5011401
501140105,"Mumahoro",210,243,453,5,501,50114,5011401
501140106,"Munini",169,194,363,5,501,50114,5011401
501140107,"Umumeyu",211,239,450,5,501,50114,5011401
501140108,"Uwadesa",213,210,423,5,501,50114,5011401
501140201,"Agasharu",275,322,597,5,501,50114,5011402
501140202,"Gitaraga",243,310,553,5,501,50114,5011402
501140203,"Kabuye",282,340,622,5,501,50114,5011402
501140204,"Kibabara",265,308,573,5,501,50114,5011402
501140205,"Kiboha",140,167,307,5,501,50114,5011402
501140206,"Midahandwa",345,415,760,5,501,50114,5011402
501140207,"Mitari",169,268,437,5,501,50114,5011402
501140208,"Nyagatare",239,298,537,5,501,50114,5011402
501140209,"Rusenyi",223,278,501,5,501,50114,5011402
501140210,"Umurehe",293,291,584,5,501,50114,5011402
501140301,"Agatare",302,330,632,5,501,50114,5011403
501140302,"Cyamuyango",243,243,486,5,501,50114,5011403
501140303,"Rubumba",143,171,314,5,501,50114,5011403
501140304,"Rutare",258,287,545,5,501,50114,5011403
501140401,"Bigaga",160,193,353,5,501,50114,5011404
501140402,"Byobo",242,336,578,5,501,50114,5011404
501140403,"Karambi",408,450,858,5,501,50114,5011404
501140404,"Mataba",257,296,553,5,501,50114,5011404
501140405,"Rugarama",340,380,720,5,501,50114,5011404
501140501,"Amarimba",241,296,537,5,501,50114,5011405
501140502,"Bitare",182,208,390,5,501,50114,5011405
501140503,"Gasharu",234,279,513,5,501,50114,5011405
501140504,"Nyamabuye",276,311,587,5,501,50114,5011405
501140505,"Rubirizi",211,232,443,5,501,50114,5011405
501140506,"Rusanza",244,320,564,5,501,50114,5011405
501140507,"Umubuga",216,292,508,5,501,50114,5011405
501140508,"Urugwiro",275,316,591,5,501,50114,5011405
501140601,"Cyiri",224,232,456,5,501,50114,5011406
501140602,"Gaseke",346,403,749,5,501,50114,5011406
501140603,"Rudashya",310,350,660,5,501,50114,5011406
502010101,"Hanganyundo",227,289,516,5,502,50201,5020101
502010102,"Iramiro",267,323,590,5,502,50201,5020101
502010103,"Isangano",228,279,507,5,502,50201,5020101
502010104,"Kabeza",262,306,568,5,502,50201,5020101
502010105,"Kibisabo",203,279,482,5,502,50201,5020101
502010201,"Huriro",402,421,823,5,502,50201,5020102
502010202,"Kabeza ",171,231,402,5,502,50201,5020102
502010203,"Muvumba",303,338,641,5,502,50201,5020102
502010204,"Muyenzi",224,230,454,5,502,50201,5020102
502010205,"Nyamirambo",194,200,394,5,502,50201,5020102
502010206,"Rebero",351,395,746,5,502,50201,5020102
502010301,"Byimana",231,251,482,5,502,50201,5020103
502010302,"Gikunyu",141,186,327,5,502,50201,5020103
502010303,"Gitega",112,125,237,5,502,50201,5020103
502010304,"Gitovu",202,249,451,5,502,50201,5020103
502010305,"Kaburimbo",251,279,530,5,502,50201,5020103
502010306,"Kibuye",210,234,444,5,502,50201,5020103
502010307,"Nyamikamba",254,237,491,5,502,50201,5020103
502010308,"Rwebare",268,277,545,5,502,50201,5020103
502010309,"Ryabuvara",292,322,614,5,502,50201,5020103
502010310,"Ryarukabura",224,259,483,5,502,50201,5020103
502010401,"Byimana",242,303,545,5,502,50201,5020104
502010402,"Huriro",332,346,678,5,502,50201,5020104
502010403,"Kajevuba",231,298,529,5,502,50201,5020104
502010404,"Kirindimure",256,255,511,5,502,50201,5020104
502010405,"Mabare",300,343,643,5,502,50201,5020104
502010501,"Bugarama",235,223,458,5,502,50201,5020105
502010502,"Kabeza",242,254,496,5,502,50201,5020105
502010503,"Mugomero",358,382,740,5,502,50201,5020105
502010504,"Muhambo",168,199,367,5,502,50201,5020105
502010505,"Mutumba",355,409,764,5,502,50201,5020105
502010506,"Rwimbogo",335,331,666,5,502,50201,5020105
502010507,"Ryanyabugwende",217,256,473,5,502,50201,5020105
502010601,"Bubare",215,237,452,5,502,50201,5020106
502010602,"Buguma",247,267,514,5,502,50201,5020106
502010603,"Butimba",268,277,545,5,502,50201,5020106
502010604,"Kabeza",273,281,554,5,502,50201,5020106
502010605,"Muhabura",189,225,414,5,502,50201,5020106
502010606,"Nyarurema",149,149,298,5,502,50201,5020106
502010607,"Shabana",278,300,578,5,502,50201,5020106
502010701,"Kabuye",281,305,586,5,502,50201,5020107
502010702,"Kamate",147,186,333,5,502,50201,5020107
502010703,"Nyiraburunga",262,264,526,5,502,50201,5020107
502010704,"Rwensheke",338,394,732,5,502,50201,5020107
502020101,"Bushara Centre",171,204,375,5,502,50202,5020201
502020102,"Ihuriro",295,317,612,5,502,50202,5020201
502020103,"Isangano",250,277,527,5,502,50202,5020201
502020104,"Kadendegeri",169,188,357,5,502,50202,5020201
502020105,"Meshero",320,374,694,5,502,50202,5020201
502020106,"Rurembo",141,142,283,5,502,50202,5020201
502020107,"Uruyenzi",184,201,385,5,502,50202,5020201
502020201,"Cyenkwanzi Centre",393,424,817,5,502,50202,5020202
502020202,"Kabeza",278,342,620,5,502,50202,5020202
502020203,"Kiyovu",279,320,599,5,502,50202,5020202
502020204,"Rurembo",258,268,526,5,502,50202,5020202
502020301,"Bigega",150,148,298,5,502,50202,5020203
502020302,"Gataba",104,140,244,5,502,50202,5020203
502020303,"Gikagati Centre",133,129,262,5,502,50202,5020203
502020304,"Gishenyi",118,112,230,5,502,50202,5020203
502020305,"Kanunga",118,132,250,5,502,50202,5020203
502020306,"Nyabitare",95,113,208,5,502,50202,5020203
502020307,"Nyakibande",95,112,207,5,502,50202,5020203
502020308,"Rurembo",115,119,234,5,502,50202,5020203
502020309,"Rutegamatwi",87,122,209,5,502,50202,5020203
502020401,"Fene",120,138,258,5,502,50202,5020204
502020402,"Gikundamvura I",119,158,277,5,502,50202,5020204
502020403,"Gikundamvura Ii",152,167,319,5,502,50202,5020204
502020404,"Irebero",173,172,345,5,502,50202,5020204
502020405,"Isangano",116,132,248,5,502,50202,5020204
502020406,"Kukibuye",134,146,280,5,502,50202,5020204
502020407,"Kukimpundu",122,134,256,5,502,50202,5020204
502020408,"Musenyi",107,119,226,5,502,50202,5020204
502020409,"Nyabitare",126,119,245,5,502,50202,5020204
502020410,"Nyagasharara",121,155,276,5,502,50202,5020204
502020411,"Umutara",127,134,261,5,502,50202,5020204
502020412,"Urugwiro",105,127,232,5,502,50202,5020204
502020501,"Gakukuru",303,333,636,5,502,50202,5020205
502020502,"Kabeza",276,289,565,5,502,50202,5020205
502020503,"Kabuga",281,311,592,5,502,50202,5020205
502020504,"Kizunguruko",296,346,642,5,502,50202,5020205
502020505,"Nyakibande",216,277,493,5,502,50202,5020205
502020506,"Nyamirama",279,371,650,5,502,50202,5020205
502020507,"Rukamba",235,282,517,5,502,50202,5020205
502020508,"Rwebishirira",388,396,784,5,502,50202,5020205
502020509,"Rwubuzizi",275,306,581,5,502,50202,5020205
502020601,"Gakirage",137,140,277,5,502,50202,5020206
502020602,"Kababanda",193,202,395,5,502,50202,5020206
502020603,"Kanyami",202,234,436,5,502,50202,5020206
502020604,"Matereza",157,219,376,5,502,50202,5020206
502020605,"Mishasha",138,117,255,5,502,50202,5020206
502020606,"Murambi",181,195,376,5,502,50202,5020206
502020607,"Mutete",162,179,341,5,502,50202,5020206
502020608,"Ndego",175,205,380,5,502,50202,5020206
502020609,"Rubanda",178,198,376,5,502,50202,5020206
502020610,"Rusoroza",181,185,366,5,502,50202,5020206
502020611,"Rutoma",137,138,275,5,502,50202,5020206
502020701,"Humure",256,296,552,5,502,50202,5020207
502020702,"Kabeza",337,361,698,5,502,50202,5020207
502020703,"Kanunga",246,264,510,5,502,50202,5020207
502020704,"Karama Centre",316,356,672,5,502,50202,5020207
502020705,"Kavumu",295,321,616,5,502,50202,5020207
502020706,"Kentarama",254,289,543,5,502,50202,5020207
502020707,"Mabare",230,239,469,5,502,50202,5020207
502030101,"Bugarama",158,165,323,5,502,50203,5020301
502030102,"Buhongoro",162,151,313,5,502,50203,5020301
502030103,"Kamate",169,170,339,5,502,50203,5020301
502030104,"Kigazi",152,127,279,5,502,50203,5020301
502030105,"Muzehe",91,74,165,5,502,50203,5020301
502030201,"Karama",204,263,467,5,502,50203,5020302
502030202,"Makomo",193,217,410,5,502,50203,5020302
502030203,"Rundiro",267,240,507,5,502,50203,5020302
502030301,"Kageyo",124,143,267,5,502,50203,5020303
502030302,"Kahi",146,166,312,5,502,50203,5020303
502030303,"Kizirakome",188,234,422,5,502,50203,5020303
502030304,"Rurebe",124,117,241,5,502,50203,5020303
502030401,"Kabirizi",460,491,951,5,502,50203,5020304
502030402,"Kajumo",216,207,423,5,502,50203,5020304
502030403,"Karohoza",188,185,373,5,502,50203,5020304
502030404,"Mbare",348,359,707,5,502,50203,5020304
502030405,"Rwarucura",159,168,327,5,502,50203,5020304
502030406,"Ryabega",372,427,799,5,502,50203,5020304
502030501,"Bwanga",240,230,470,5,502,50203,5020305
502030502,"Gacungiro",265,246,511,5,502,50203,5020305
502030503,"Kabeza",210,195,405,5,502,50203,5020305
502030504,"Musenyi I",191,192,383,5,502,50203,5020305
502030505,"Musenyi Ii",117,113,230,5,502,50203,5020305
502030506,"Nyamirama Ii",54,30,84,5,502,50203,5020305
502030507,"Rugarama",176,196,372,5,502,50203,5020305
502030508,"Ruziranyenzi",298,297,595,5,502,50203,5020305
502030601,"Akayange",147,102,249,5,502,50203,5020306
502030602,"Ndama",501,349,850,5,502,50203,5020306
502030603,"Rwabiharamba",317,324,641,5,502,50203,5020306
502030701,"Bidudu",242,272,514,5,502,50203,5020307
502030702,"Bwera",152,168,320,5,502,50203,5020307
502030703,"Kabare",145,151,296,5,502,50203,5020307
502030704,"Ruhita",237,254,491,5,502,50203,5020307
502030801,"Kayange I",329,318,647,5,502,50203,5020308
502030802,"Kayange Ii",202,218,420,5,502,50203,5020308
502030803,"Nkoma I",267,308,575,5,502,50203,5020308
502030804,"Nkoma Ii",294,294,588,5,502,50203,5020308
502030805,"Nyamirama I ",286,272,558,5,502,50203,5020308
502030806,"Nyamirama Ii",221,251,472,5,502,50203,5020308
502030901,"Iraba",239,228,467,5,502,50203,5020309
502030902,"Nkuna",308,324,632,5,502,50203,5020309
502030903,"Nyarutovu",170,171,341,5,502,50203,5020309
502030904,"Rebero",374,377,751,5,502,50203,5020309
502031001,"Bwera",293,313,606,5,502,50203,5020310
502031002,"Imishongi",322,305,627,5,502,50203,5020310
502031003,"Kayishunika",192,207,399,5,502,50203,5020310
502031004,"Kigirakome",142,191,333,5,502,50203,5020310
502031005,"Rwenyana",232,226,458,5,502,50203,5020310
502031006,"Rwenyemera",144,178,322,5,502,50203,5020310
502031007,"Rwimirama",325,317,642,5,502,50203,5020310
502031101,"Gakoma",245,277,522,5,502,50203,5020311
502031102,"Humure",167,187,354,5,502,50203,5020311
502031103,"Karangazi",303,322,625,5,502,50203,5020311
502031104,"Rubona",145,154,299,5,502,50203,5020311
502031105,"Rukundo",275,329,604,5,502,50203,5020311
502040101,"Agasasa",253,283,536,5,502,50204,5020401
502040102,"Bingaro",218,234,452,5,502,50204,5020401
502040103,"Byimana",277,278,555,5,502,50204,5020401
502040104,"Gikandura",292,319,611,5,502,50204,5020401
502040105,"Igikorosi",199,221,420,5,502,50204,5020401
502040106,"Kibuye",255,296,551,5,502,50204,5020401
502040107,"Nyagahandagaza",239,257,496,5,502,50204,5020401
502040201,"Kaduha I",453,510,963,5,502,50204,5020402
502040202,"Kaduha Ii",371,410,781,5,502,50204,5020402
502040203,"Kanyinya ",289,332,621,5,502,50204,5020402
502040204,"Nyabiyonza",235,240,475,5,502,50204,5020402
502040205,"Urumuri",342,373,715,5,502,50204,5020402
502040301,"Kabaya",227,229,456,5,502,50204,5020403
502040302,"Kabeza",243,272,515,5,502,50204,5020403
502040303,"Kanyeganyege",371,411,782,5,502,50204,5020403
502040304,"Rebero",258,240,498,5,502,50204,5020403
502040401,"Gashenyi",203,200,403,5,502,50204,5020404
502040402,"Kagogo",120,159,279,5,502,50204,5020404
502040403,"Kajevuba",362,373,735,5,502,50204,5020404
502040404,"Kigarama",306,298,604,5,502,50204,5020404
502040405,"Nyabwunyu",190,207,397,5,502,50204,5020404
502040406,"Umunanira",346,397,743,5,502,50204,5020404
502040501,"Kanguka",298,363,661,5,502,50204,5020405
502040502,"Kibuye",361,346,707,5,502,50204,5020405
502040503,"Kigarama",372,393,765,5,502,50204,5020405
502040504,"Rebero",307,353,660,5,502,50204,5020405
502040505,"Shirimpumu",375,382,757,5,502,50204,5020405
502040601,"Byimana",287,252,539,5,502,50204,5020406
502040602,"Kabeza",527,543,1070,5,502,50204,5020406
502040603,"Kamutara",343,377,720,5,502,50204,5020406
502040604,"Ntoma",451,462,913,5,502,50204,5020406
502040605,"Nyakigando I",528,594,1122,5,502,50204,5020406
502040606,"Nyakigando Ii",423,420,843,5,502,50204,5020406
502040607,"Rebero",373,388,761,5,502,50204,5020406
502040701,"Igitego",471,491,962,5,502,50204,5020407
502040702,"Isangano",378,419,797,5,502,50204,5020407
502040703,"Kanyesunzu",259,275,534,5,502,50204,5020407
502040704,"Rubira",227,310,537,5,502,50204,5020407
502040801,"Akabira",290,372,662,5,502,50204,5020408
502040802,"Burera",232,236,468,5,502,50204,5020408
502040803,"Ishyirahamwe",376,366,742,5,502,50204,5020408
502040804,"Rwagisangangabo",283,318,601,5,502,50204,5020408
502040901,"Buyugi",288,357,645,5,502,50204,5020409
502040902,"Kabeza",285,299,584,5,502,50204,5020409
502040903,"Mahoro",305,336,641,5,502,50204,5020409
502040904,"Rutoma",246,271,517,5,502,50204,5020409
502040905,"Ryaruganzu",266,311,577,5,502,50204,5020409
502050101,"Cyemiyaga",77,86,163,5,502,50205,5020501
502050102,"Gahama",100,127,227,5,502,50205,5020501
502050103,"Gicuba",123,124,247,5,502,50205,5020501
502050104,"Kwiperu",107,135,242,5,502,50205,5020501
502050105,"Nyakabungo",178,133,311,5,502,50205,5020501
502050106,"Nyamiyaga",159,142,301,5,502,50205,5020501
502050107,"Ruhonwa",147,155,302,5,502,50205,5020501
502050108,"Ruhuha",130,131,261,5,502,50205,5020501
502050109,"Rutete",104,120,224,5,502,50205,5020501
502050110,"Rwabashanja",101,118,219,5,502,50205,5020501
502050111,"Rwakikunengwa",132,146,278,5,502,50205,5020501
502050112,"Rwebare",126,118,244,5,502,50205,5020501
502050201,"Gitenga",92,94,186,5,502,50205,5020502
502050202,"Izinga",118,125,243,5,502,50205,5020502
502050203,"Kabingo",110,110,220,5,502,50205,5020502
502050204,"Kibuye",119,132,251,5,502,50205,5020502
502050205,"Muhambo",102,117,219,5,502,50205,5020502
502050206,"Mukasha",116,127,243,5,502,50205,5020502
502050207,"Nyabubare",121,118,239,5,502,50205,5020502
502050208,"Rwagakuba",103,123,226,5,502,50205,5020502
502050301,"Bitare",135,125,260,5,502,50205,5020503
502050302,"Cyondo",139,137,276,5,502,50205,5020503
502050303,"Gatoki",147,143,290,5,502,50205,5020503
502050304,"Gorora",135,169,304,5,502,50205,5020503
502050305,"Kindege",166,194,360,5,502,50205,5020503
502050306,"Manombe",175,180,355,5,502,50205,5020503
502050307,"Mataba",131,167,298,5,502,50205,5020503
502050308,"Murambi",111,127,238,5,502,50205,5020503
502050309,"Nyakabungo",143,143,286,5,502,50205,5020503
502050310,"Rugarama",163,163,326,5,502,50205,5020503
502050311,"Rwamiko",187,217,404,5,502,50205,5020503
502050312,"Rwamushe",99,129,228,5,502,50205,5020503
502050401,"Bureka",82,101,183,5,502,50205,5020504
502050402,"Butehe",113,96,209,5,502,50205,5020504
502050403,"Kakagaju",116,117,233,5,502,50205,5020504
502050404,"Karujanga",106,112,218,5,502,50205,5020504
502050405,"Kinoga",99,126,225,5,502,50205,5020504
502050406,"Kitaburimbi",84,101,185,5,502,50205,5020504
502050407,"Nkana",124,124,248,5,502,50205,5020504
502050408,"Nyakabungo",109,112,221,5,502,50205,5020504
502050409,"Rugarama",92,102,194,5,502,50205,5020504
502050410,"Rwakashande",94,80,174,5,502,50205,5020504
502050411,"Rwemisavu",109,141,250,5,502,50205,5020504
502050412,"Rwengugwe",83,115,198,5,502,50205,5020504
502050501,"Gishoro",248,239,487,5,502,50205,5020505
502050502,"Kabare",135,155,290,5,502,50205,5020505
502050503,"Kagorogoro",154,180,334,5,502,50205,5020505
502050504,"Kajevuba",90,125,215,5,502,50205,5020505
502050505,"Karujumba Centre",119,125,244,5,502,50205,5020505
502050506,"Katoma",117,124,241,5,502,50205,5020505
502050507,"Kenzizi",105,112,217,5,502,50205,5020505
502050508,"Mushesha",100,98,198,5,502,50205,5020505
502050509,"Mweneno",96,106,202,5,502,50205,5020505
502050510,"Ngangare",101,114,215,5,502,50205,5020505
502050511,"Nyabwongoroka",106,119,225,5,502,50205,5020505
502050512,"Nyange",123,134,257,5,502,50205,5020505
502050513,"Rukongoro",96,127,223,5,502,50205,5020505
502050601,"Cyerero",105,103,208,5,502,50205,5020506
502050602,"Gashuro",104,114,218,5,502,50205,5020506
502050603,"Gasyata",110,114,224,5,502,50205,5020506
502050604,"Gatyazo",99,121,220,5,502,50205,5020506
502050605,"Nyagatete",93,112,205,5,502,50205,5020506
502050606,"Nyakigera",108,138,246,5,502,50205,5020506
502050607,"Nyamirima",123,146,269,5,502,50205,5020506
502050608,"Nyaruziba",110,146,256,5,502,50205,5020506
502050609,"Rugarama",102,140,242,5,502,50205,5020506
502050610,"Rutunga",104,150,254,5,502,50205,5020506
502060101,"Bwera",165,164,329,5,502,50206,5020601
502060102,"Ntoma",255,252,507,5,502,50206,5020601
502060103,"Rugaga",204,184,388,5,502,50206,5020601
502060201,"Byimana I",203,215,418,5,502,50206,5020602
502060202,"Byimana Ii",208,205,413,5,502,50206,5020602
502060203,"Byimana Iii",223,205,428,5,502,50206,5020602
502060204,"Kabuga I",304,303,607,5,502,50206,5020602
502060205,"Kabuga Ii",220,228,448,5,502,50206,5020602
502060301,"Byimana",280,318,598,5,502,50206,5020603
502060302,"Kabeza",217,247,464,5,502,50206,5020603
502060303,"Kamahoro",197,199,396,5,502,50206,5020603
502060304,"Kiyovu",304,294,598,5,502,50206,5020603
502060401,"Gishara",99,120,219,5,502,50206,5020604
502060402,"Kagera",130,120,250,5,502,50206,5020604
502060403,"Kagitumba",126,145,271,5,502,50206,5020604
502060404,"Kamabuye",113,128,241,5,502,50206,5020604
502060405,"Munini",131,116,247,5,502,50206,5020604
502060406,"Musenyi",121,143,264,5,502,50206,5020604
502060407,"Muvumba",200,199,399,5,502,50206,5020604
502060408,"Nziranziza",109,132,241,5,502,50206,5020604
502060501,"Gakoma",236,251,487,5,502,50206,5020605
502060502,"Musebeya",100,110,210,5,502,50206,5020605
502060503,"Musha",159,196,355,5,502,50206,5020605
502060504,"Nyampeke",225,241,466,5,502,50206,5020605
502060505,"Rukundo",192,192,384,5,502,50206,5020605
502060601,"Umudugudu Wa I",181,187,368,5,502,50206,5020606
502060602,"Umudugudu Wa Ii",187,213,400,5,502,50206,5020606
502060603,"Umudugudu Wa Iii",315,345,660,5,502,50206,5020606
502060604,"Umudugudu Wa Iv",221,237,458,5,502,50206,5020606
502060605,"Umudugudu Wa V",104,107,211,5,502,50206,5020606
502060606,"Umudugudu Wa Vi",117,101,218,5,502,50206,5020606
502060607,"Umudugudu Wa Vii",140,147,287,5,502,50206,5020606
502060701,"Nyabwishongwezi I",197,201,398,5,502,50206,5020607
502060702,"Nyabwishongwezi Ii",640,526,1166,5,502,50206,5020607
502060703,"Nyabwishongwezi Iii",376,378,754,5,502,50206,5020607
502060801,"Kagezi I",368,378,746,5,502,50206,5020608
502060802,"Kagezi Ii",190,200,390,5,502,50206,5020608
502060803,"Mitayayo I",216,238,454,5,502,50206,5020608
502060804,"Mitayayo Ii",434,493,927,5,502,50206,5020608
502060805,"Rwentanga",316,357,673,5,502,50206,5020608
502070101,"Bibare",205,226,431,5,502,50207,5020701
502070102,"Karukwanzi",188,187,375,5,502,50207,5020701
502070103,"Nyakagenge",247,281,528,5,502,50207,5020701
502070104,"Nyamafura",162,185,347,5,502,50207,5020701
502070105,"Nyaruziba",116,139,255,5,502,50207,5020701
502070106,"Rwimirama",284,354,638,5,502,50207,5020701
502070107,"Urugano",167,171,338,5,502,50207,5020701
502070108,"Urutambi",146,153,299,5,502,50207,5020701
502070201,"Gakoma",283,331,614,5,502,50207,5020702
502070202,"Gisenyi",255,300,555,5,502,50207,5020702
502070203,"Kanyinya",299,356,655,5,502,50207,5020702
502070204,"Kumusaraba",281,322,603,5,502,50207,5020702
502070205,"Nyagahandagaza",248,294,542,5,502,50207,5020702
502070206,"Nyarwina",348,429,777,5,502,50207,5020702
502070207,"Rusororo",330,349,679,5,502,50207,5020702
502070301,"Cyabwana",357,409,766,5,502,50207,5020703
502070302,"Gitwe",332,403,735,5,502,50207,5020703
502070303,"Iterambere",191,240,431,5,502,50207,5020703
502070304,"Kabeza",270,327,597,5,502,50207,5020703
502070305,"Mizero",238,277,515,5,502,50207,5020703
502070306,"Nyabugogo",302,348,650,5,502,50207,5020703
502070307,"Nyagahita",460,539,999,5,502,50207,5020703
502070308,"Rebero",175,213,388,5,502,50207,5020703
502070309,"Rubumba",398,427,825,5,502,50207,5020703
502070310,"Shenga",271,301,572,5,502,50207,5020703
502070401,"Byimana",383,395,778,5,502,50207,5020704
502070402,"Indahemuka",439,472,911,5,502,50207,5020704
502070403,"Isangano",402,441,843,5,502,50207,5020704
502070404,"Karukwanzi",273,299,572,5,502,50207,5020704
502070405,"Rebero",291,301,592,5,502,50207,5020704
502070406,"Rwimirama",271,326,597,5,502,50207,5020704
502070501,"Amahoro",263,251,514,5,502,50207,5020705
502070502,"Isangano",292,353,645,5,502,50207,5020705
502070503,"Nteko",337,357,694,5,502,50207,5020705
502070504,"Rebero",395,424,819,5,502,50207,5020705
502070505,"Ubumwe",386,383,769,5,502,50207,5020705
502070506,"Urumuri",281,308,589,5,502,50207,5020705
502080101,"Bitabo",196,216,412,5,502,50208,5020801
502080102,"Bufunda",259,298,557,5,502,50208,5020801
502080103,"Kibihanga",293,328,621,5,502,50208,5020801
502080104,"Nyakajeje",161,158,319,5,502,50208,5020801
502080105,"Rebero",233,261,494,5,502,50208,5020801
502080201,"Gatete I",259,296,555,5,502,50208,5020802
502080202,"Gatete Ii",173,215,388,5,502,50208,5020802
502080203,"Hunga",243,304,547,5,502,50208,5020802
502080204,"Kazinga",268,288,556,5,502,50208,5020802
502080205,"Rutete",294,331,625,5,502,50208,5020802
502080206,"Ryandahuka",161,196,357,5,502,50208,5020802
502080301,"Butare",173,172,345,5,502,50208,5020803
502080302,"Butwaro",151,139,290,5,502,50208,5020803
502080303,"Gashahi",235,285,520,5,502,50208,5020803
502080304,"Gihengeri",364,350,714,5,502,50208,5020803
502080305,"Gishoro",253,323,576,5,502,50208,5020803
502080306,"Kabongoya I",180,214,394,5,502,50208,5020803
502080307,"Kabongoya Ii",219,211,430,5,502,50208,5020803
502080308,"Kigarama",204,263,467,5,502,50208,5020803
502080309,"Nyarubuye",276,272,548,5,502,50208,5020803
502080401,"Akinyambo",147,167,314,5,502,50208,5020804
502080402,"Byumba",213,225,438,5,502,50208,5020804
502080403,"Kabeza",340,345,685,5,502,50208,5020804
502080404,"Kabukunzi",369,363,732,5,502,50208,5020804
502080405,"Kisaro",256,323,579,5,502,50208,5020804
502080501,"Cyabahurura",250,279,529,5,502,50208,5020805
502080502,"Kagonga",313,321,634,5,502,50208,5020805
502080503,"Kireranyana",229,245,474,5,502,50208,5020805
502080504,"Ngoma",240,260,500,5,502,50208,5020805
502080505,"Nyagatare",295,305,600,5,502,50208,5020805
502080506,"Nyakagarama",295,319,614,5,502,50208,5020805
502080507,"Nyakarama",248,257,505,5,502,50208,5020805
502080601,"Bukire",230,246,476,5,502,50208,5020806
502080602,"Byimana",259,291,550,5,502,50208,5020806
502080603,"Kibondo",206,233,439,5,502,50208,5020806
502080604,"Kireranyana",184,212,396,5,502,50208,5020806
502080605,"Nyacyonga",390,407,797,5,502,50208,5020806
502080606,"Nyakagarama",252,258,510,5,502,50208,5020806
502080607,"Sipure",174,183,357,5,502,50208,5020806
502090101,"Kabungo",255,295,550,5,502,50209,5020901
502090102,"Kibirizi",237,285,522,5,502,50209,5020901
502090103,"Nyamenge",189,190,379,5,502,50209,5020901
502090104,"Nyamisange",293,288,581,5,502,50209,5020901
502090201,"Kagwegwe",442,481,923,5,502,50209,5020902
502090202,"Kanyinya",102,106,208,5,502,50209,5020902
502090203,"Kijojo",150,135,285,5,502,50209,5020902
502090204,"Rwakabungo",485,516,1001,5,502,50209,5020902
502090301,"Gakiri",481,527,1008,5,502,50209,5020903
502090302,"Kiyaza",299,321,620,5,502,50209,5020903
502090303,"Mugari",333,340,673,5,502,50209,5020903
502090304,"Musheri",581,459,1040,5,502,50209,5020903
502090401,"Bikonoka",271,299,570,5,502,50209,5020904
502090402,"Murisanga",509,537,1046,5,502,50209,5020904
502090403,"Ntoma",838,884,1722,5,502,50209,5020904
502090404,"Rukundo",448,410,858,5,502,50209,5020904
502090405,"Rutarama",565,630,1195,5,502,50209,5020904
502090501,"Gikunyu",450,462,912,5,502,50209,5020905
502090502,"Mushorerwa",337,363,700,5,502,50209,5020905
502090503,"Nyagatabire",540,549,1089,5,502,50209,5020905
502090504,"Rugarama",156,133,289,5,502,50209,5020905
502090601,"Cyenombe",185,200,385,5,502,50209,5020906
502090602,"Isangano",353,371,724,5,502,50209,5020906
502090603,"Nyamiyonga",261,264,525,5,502,50209,5020906
502090604,"Shirimpumu",356,366,722,5,502,50209,5020906
502090701,"Humure",376,397,773,5,502,50209,5020907
502090702,"Karambi",433,492,925,5,502,50209,5020907
502090703,"Karuca",397,379,776,5,502,50209,5020907
502090704,"Nyabyihura",233,259,492,5,502,50209,5020907
502090801,"Kibitaka I",248,302,550,5,502,50209,5020908
502090802,"Rebero",411,476,887,5,502,50209,5020908
502090803,"Rwenyana",258,241,499,5,502,50209,5020908
502090804,"Umunini",446,422,868,5,502,50209,5020908
502100101,"Barija A",496,369,865,5,502,50210,5021001
502100102,"Barija B",362,417,779,5,502,50210,5021001
502100103,"Burumba",1880,664,2544,5,502,50210,5021001
502100104,"Kinihira",370,384,754,5,502,50210,5021001
502100201,"Bushoga",453,523,976,5,502,50210,5021002
502100202,"Cyabahanga",129,146,275,5,502,50210,5021002
502100203,"Cyonyo",473,481,954,5,502,50210,5021002
502100204,"Ruhuha I",302,297,599,5,502,50210,5021002
502100205,"Ruhuha Ii",279,317,596,5,502,50210,5021002
502100206,"Ryinkuyu",417,428,845,5,502,50210,5021002
502100301,"Akamonyi",1146,1212,2358,5,502,50210,5021003
502100302,"Bihinga",395,436,831,5,502,50210,5021003
502100303,"Cyabayaga",661,827,1488,5,502,50210,5021003
502100304,"Nyakabuye",572,590,1162,5,502,50210,5021003
502100305,"Urugero",627,613,1240,5,502,50210,5021003
502100401,"Gakirage",638,724,1362,5,502,50210,5021004
502100402,"Kiboga I",330,387,717,5,502,50210,5021004
502100403,"Kiboga Ii",461,495,956,5,502,50210,5021004
502100404,"Mihingo",342,426,768,5,502,50210,5021004
502100405,"Nkongi",314,370,684,5,502,50210,5021004
502100406,"Urumuri",384,428,812,5,502,50210,5021004
502100501,"Kamagiri",338,365,703,5,502,50210,5021005
502100502,"Karungi",242,237,479,5,502,50210,5021005
502100503,"Nkerenke",188,190,378,5,502,50210,5021005
502100601,"Kabare",307,330,637,5,502,50210,5021006
502100602,"Nsheke",249,260,509,5,502,50210,5021006
502100603,"Nyegeza",338,263,601,5,502,50210,5021006
502100701,"Mirama I",262,296,558,5,502,50210,5021007
502100702,"Mirama Ii",265,232,497,5,502,50210,5021007
502100703,"Nyagatare I",745,673,1418,5,502,50210,5021007
502100704,"Nyagatare Ii",576,481,1057,5,502,50210,5021007
502100705,"Nyagatare Iii",176,205,381,5,502,50210,5021007
502100801,"Gihorobwa",206,241,447,5,502,50210,5021008
502100802,"Mugari",164,198,362,5,502,50210,5021008
502100803,"Nkonji",193,175,368,5,502,50210,5021008
502100804,"Rutaraka",220,201,421,5,502,50210,5021008
502100805,"Ryabega",187,202,389,5,502,50210,5021008
502100901,"Marongero",368,404,772,5,502,50210,5021009
502100902,"Rugendo",370,353,723,5,502,50210,5021009
502100903,"Ryabega ",158,198,356,5,502,50210,5021009
502110101,"Amahoro",168,199,367,5,502,50211,5021101
502110102,"Busasamana",132,153,285,5,502,50211,5021101
502110103,"Isangano ",124,130,254,5,502,50211,5021101
502110104,"Nomero I",290,286,576,5,502,50211,5021101
502110105,"Rambura",187,216,403,5,502,50211,5021101
502110106,"Ruyonza",134,149,283,5,502,50211,5021101
502110107,"Ubumwe",185,179,364,5,502,50211,5021101
502110108,"Urugwiro",195,219,414,5,502,50211,5021101
502110109,"Urukundo",122,128,250,5,502,50211,5021101
502110110,"Urumuri",169,215,384,5,502,50211,5021101
502110201,"Agasasa",276,333,609,5,502,50211,5021102
502110202,"Bukamba",326,373,699,5,502,50211,5021102
502110203,"Gashenyi",385,430,815,5,502,50211,5021102
502110204,"Gisenyi",354,367,721,5,502,50211,5021102
502110205,"Huriro",222,261,483,5,502,50211,5021102
502110206,"Isangano",199,182,381,5,502,50211,5021102
502110207,"Kiyovu",207,215,422,5,502,50211,5021102
502110208,"Murore",275,310,585,5,502,50211,5021102
502110209,"Nyamirambo",317,322,639,5,502,50211,5021102
502110210,"Rebero",257,270,527,5,502,50211,5021102
502110211,"Rukomo",242,233,475,5,502,50211,5021102
502110212,"Rurembo",211,229,440,5,502,50211,5021102
502110301,"Akamashama",186,219,405,5,502,50211,5021103
502110302,"Akamashereka",250,256,506,5,502,50211,5021103
502110303,"Amahoro",263,259,522,5,502,50211,5021103
502110304,"Amizero",165,161,326,5,502,50211,5021103
502110305,"Gashenyi",249,260,509,5,502,50211,5021103
502110306,"Gashura",319,339,658,5,502,50211,5021103
502110307,"Isangano",223,241,464,5,502,50211,5021103
502110308,"Karugondo",132,156,288,5,502,50211,5021103
502110309,"Kayenzi",268,267,535,5,502,50211,5021103
502110310,"Musenyi",245,281,526,5,502,50211,5021103
502110311,"Nyakagarama",175,190,365,5,502,50211,5021103
502110312,"Nyamworoma",223,236,459,5,502,50211,5021103
502110401,"Amahoro",138,132,270,5,502,50211,5021104
502110402,"Berwa",126,152,278,5,502,50211,5021104
502110403,"Isangano",211,231,442,5,502,50211,5021104
502110404,"Kabeza",336,345,681,5,502,50211,5021104
502110405,"Mwurirwa",180,193,373,5,502,50211,5021104
502110406,"Nyange",253,289,542,5,502,50211,5021104
502110407,"Nyarubuye",150,166,316,5,502,50211,5021104
502110408,"Nyarurama",223,244,467,5,502,50211,5021104
502110409,"Rebero",216,237,453,5,502,50211,5021104
502110410,"Rugabano",222,246,468,5,502,50211,5021104
502110501,"Akajuka",241,196,437,5,502,50211,5021105
502110502,"Benishyaka",195,286,481,5,502,50211,5021105
502110503,"Biryogo",336,336,672,5,502,50211,5021105
502110504,"Kabeza",365,370,735,5,502,50211,5021105
502110505,"Kabusunzu",196,225,421,5,502,50211,5021105
502110506,"Nyabwunyu",238,255,493,5,502,50211,5021105
502110507,"Nyamirambo",390,425,815,5,502,50211,5021105
502110508,"Rurenge",288,294,582,5,502,50211,5021105
502110509,"Rushashi",201,225,426,5,502,50211,5021105
502110510,"Rwiju",167,200,367,5,502,50211,5021105
502120101,"Cyenjonjo I",271,231,502,5,502,50212,5021201
502120102,"Cyenjonjo Ii",196,181,377,5,502,50212,5021201
502120103,"Rutare",215,227,442,5,502,50212,5021201
502120201,"Gasinga",306,317,623,5,502,50212,5021202
502120202,"Nyendo",170,186,356,5,502,50212,5021202
502120203,"Rwibishorogoto",228,207,435,5,502,50212,5021202
502120301,"Gituro",356,398,754,5,502,50212,5021203
502120302,"Kabare",245,209,454,5,502,50212,5021203
502120303,"Ururimbi",204,204,408,5,502,50212,5021203
502120401,"Gakindo",191,193,384,5,502,50212,5021204
502120402,"Kazaza",194,196,390,5,502,50212,5021204
502120403,"Rukiri",151,141,292,5,502,50212,5021204
502120501,"Gicwamba",195,181,376,5,502,50212,5021205
502120502,"Kinungu",309,301,610,5,502,50212,5021205
502120503,"Mishenyi",165,192,357,5,502,50212,5021205
502120601,"Bubare",291,290,581,5,502,50212,5021206
502120602,"Rugarama",276,271,547,5,502,50212,5021206
502120701,"Bukonji",181,183,364,5,502,50212,5021207
502120702,"Rukorota",240,236,476,5,502,50212,5021207
502120801,"Mashaka",337,349,686,5,502,50212,5021208
502120802,"Nshuli",165,225,390,5,502,50212,5021208
502120803,"Rutare",206,217,423,5,502,50212,5021208
502120901,"Nyarubare",117,141,258,5,502,50212,5021209
502120902,"Rwahi",147,171,318,5,502,50212,5021209
502120903,"Rwempasha",253,250,503,5,502,50212,5021209
502120904,"Uwinkiko",128,128,256,5,502,50212,5021209
502121001,"Bweya",288,297,585,5,502,50212,5021210
502121002,"Ryeru",377,377,754,5,502,50212,5021210
502130101,"Bugaragara",215,211,426,5,502,50213,5021301
502130102,"Gacundezi I",194,210,404,5,502,50213,5021301
502130103,"Gacundezi Ii",307,288,595,5,502,50213,5021301
502130104,"Rukundo I",457,514,971,5,502,50213,5021301
502130105,"Rukundo Ii",207,188,395,5,502,50213,5021301
502130106,"Rukundo Iii",186,192,378,5,502,50213,5021301
502130201,"Gatovu",298,307,605,5,502,50213,5021302
502130202,"Kabeza",323,372,695,5,502,50213,5021302
502130203,"Kabeza Centre",288,300,588,5,502,50213,5021302
502130204,"Kavumu",298,311,609,5,502,50213,5021302
502130205,"Rugarama",284,330,614,5,502,50213,5021302
502130206,"Rukiri I",804,797,1601,5,502,50213,5021302
502130207,"Rukiri Ii",419,436,855,5,502,50213,5021302
502130301,"Gatebe I",66,35,101,5,502,50213,5021303
502130302,"Gatebe Ii",74,36,110,5,502,50213,5021303
502130303,"Kirebe",164,134,298,5,502,50213,5021303
502130304,"Rukindo",151,123,274,5,502,50213,5021303
502130401,"Gashwenu",210,188,398,5,502,50213,5021304
502130402,"Kibuye",245,242,487,5,502,50213,5021304
502130403,"Kimaramu",162,208,370,5,502,50213,5021304
502130404,"Nyampire",189,166,355,5,502,50213,5021304
502130405,"Rwembogo",252,265,517,5,502,50213,5021304
502130501,"Kamagiri",326,315,641,5,502,50213,5021305
502130502,"Nyakagando I",356,371,727,5,502,50213,5021305
502130503,"Nyakagando Ii",297,288,585,5,502,50213,5021305
502130504,"Nyarupfubire I",451,455,906,5,502,50213,5021305
502130505,"Nyarupfubire Ii",344,343,687,5,502,50213,5021305
502130506,"Rwimiyaga I ",194,196,390,5,502,50213,5021305
502130507,"Rwimiyaga Ii",377,394,771,5,502,50213,5021305
502130601,"Isangano",359,370,729,5,502,50213,5021306
502130602,"Nyamirama ",417,425,842,5,502,50213,5021306
502130603,"Rebero",394,400,794,5,502,50213,5021306
502130604,"Remera",378,412,790,5,502,50213,5021306
502130701,"Bwera",160,140,300,5,502,50213,5021307
502130702,"Cyamunyana",275,232,507,5,502,50213,5021307
502130703,"Gakagati I",574,693,1267,5,502,50213,5021307
502130704,"Gakagati Ii",399,370,769,5,502,50213,5021307
502130705,"Rubira",216,154,370,5,502,50213,5021307
502130801,"Byimana",483,483,966,5,502,50213,5021308
502130802,"Gakoma",325,358,683,5,502,50213,5021308
502130803,"Kizungu",517,546,1063,5,502,50213,5021308
502130804,"Mahoro",392,356,748,5,502,50213,5021308
502130805,"Muyange",607,649,1256,5,502,50213,5021308
502130806,"Rebero",532,542,1074,5,502,50213,5021308
502130807,"Rwinyange",348,377,725,5,502,50213,5021308
502140101,"Gatoma",268,300,568,5,502,50214,5021401
502140102,"Kaborogota",283,397,680,5,502,50214,5021401
502140103,"Kayanja",363,432,795,5,502,50214,5021401
502140104,"Nyagatare",256,242,498,5,502,50214,5021401
502140105,"Nyasine",189,216,405,5,502,50214,5021401
502140201,"Bitibyoma",181,226,407,5,502,50214,5021402
502140202,"Gitengure",184,187,371,5,502,50214,5021402
502140203,"Kayigiro",205,251,456,5,502,50214,5021402
502140204,"Nshuri",194,204,398,5,502,50214,5021402
502140205,"Nyagasigati",298,327,625,5,502,50214,5021402
502140301,"Agafaru",441,512,953,5,502,50214,5021403
502140302,"Ibare",274,360,634,5,502,50214,5021403
502140303,"Kabeza",362,431,793,5,502,50214,5021403
502140304,"Kaduha",286,290,576,5,502,50214,5021403
502140305,"Kigando",316,295,611,5,502,50214,5021403
502140306,"Mutozo",292,308,600,5,502,50214,5021403
502140307,"Nkoma",374,395,769,5,502,50214,5021403
502140308,"Rugabano",275,332,607,5,502,50214,5021403
502140309,"Runyinya",348,373,721,5,502,50214,5021403
502140401,"Kabeza",203,196,399,5,502,50214,5021404
502140402,"Kabirizi",487,495,982,5,502,50214,5021404
502140403,"Kamate",265,310,575,5,502,50214,5021404
502140404,"Kangoma",165,165,330,5,502,50214,5021404
502140405,"Kiyovu",218,238,456,5,502,50214,5021404
502140406,"Munini",168,172,340,5,502,50214,5021404
502140501,"Agafaro",483,474,957,5,502,50214,5021405
502140502,"Agasongero",562,636,1198,5,502,50214,5021405
502140503,"Akajevuba",281,308,589,5,502,50214,5021405
502140504,"Kabusunzu",430,515,945,5,502,50214,5021405
502140505,"Mutungisa",352,326,678,5,502,50214,5021405
502140506,"Runyeri",496,586,1082,5,502,50214,5021405
502140601,"Gikoba",254,292,546,5,502,50214,5021406
502140602,"Nyakanoni",314,301,615,5,502,50214,5021406
502140603,"Nyakigando",302,345,647,5,502,50214,5021406
502140604,"Rwubuzizi",119,132,251,5,502,50214,5021406
502140605,"Shonga",288,298,586,5,502,50214,5021406
502140701,"Gakamba",250,253,503,5,502,50214,5021407
502140702,"Gasheshe",110,124,234,5,502,50214,5021407
502140703,"Kagarama",290,303,593,5,502,50214,5021407
502140704,"Nyenyeri",252,232,484,5,502,50214,5021407
502140705,"Tabagwe",367,396,763,5,502,50214,5021407
503010101,"Kabuye",621,689,1310,5,503,50301,5030101
503010102,"Kigabiro",532,581,1113,5,503,50301,5030101
503010103,"Maya",610,534,1144,5,503,50301,5030101
503010104,"Munini",623,677,1300,5,503,50301,5030101
503010105,"Rugarama",379,369,748,5,503,50301,5030101
503010201,"Byahi",332,357,689,5,503,50301,5030102
503010202,"Kagarama",381,423,804,5,503,50301,5030102
503010203,"Kimana",406,395,801,5,503,50301,5030102
503010204,"Rugarama",273,280,553,5,503,50301,5030102
503010301,"Buburankwi",383,409,792,5,503,50301,5030103
503010302,"Giheta",519,540,1059,5,503,50301,5030103
503010303,"Kinunga",613,557,1170,5,503,50301,5030103
503010304,"Teme",559,568,1127,5,503,50301,5030103
503010401,"Gahara I",538,525,1063,5,503,50301,5030104
503010402,"Gahara Ii",422,467,889,5,503,50301,5030104
503010403,"Kagogo",410,447,857,5,503,50301,5030104
503010404,"Viro",466,461,927,5,503,50301,5030104
503020101,"Gatare",184,241,425,5,503,50302,5030201
503020102,"Gatsibo",103,119,222,5,503,50302,5030201
503020103,"Hanika I",87,90,177,5,503,50302,5030201
503020104,"Hanika Ii",220,267,487,5,503,50302,5030201
503020105,"Mukwiza",282,282,564,5,503,50302,5030201
503020106,"Munini",107,134,241,5,503,50302,5030201
503020107,"Nyakagarama",206,225,431,5,503,50302,5030201
503020108,"Nyamuduha",246,254,500,5,503,50302,5030201
503020109,"Nyarukoni",348,372,720,5,503,50302,5030201
503020110,"Rwimbogo",467,517,984,5,503,50302,5030201
503020201,"Manishya",219,258,477,5,503,50302,5030202
503020202,"Nyagahandagaza",252,266,518,5,503,50302,5030202
503020203,"Nyaruhanga",228,221,449,5,503,50302,5030202
503020204,"Nyarukoni",253,304,557,5,503,50302,5030202
503020205,"Rugarama",349,334,683,5,503,50302,5030202
503020301,"Kabuga",184,194,378,5,503,50302,5030203
503020302,"Kamasapfu",302,363,665,5,503,50302,5030203
503020303,"Karambo I",278,299,577,5,503,50302,5030203
503020304,"Kavumu",198,248,446,5,503,50302,5030203
503020305,"Kayisha",385,401,786,5,503,50302,5030203
503020306,"Kiraritsi",149,176,325,5,503,50302,5030203
503020307,"Mugera",410,349,759,5,503,50302,5030203
503020308,"Nyarukoni I",144,173,317,5,503,50302,5030203
503020309,"Rurama",299,345,644,5,503,50302,5030203
503020401,"Agakenyeri",243,262,505,5,503,50302,5030204
503020402,"Agakomeye",341,385,726,5,503,50302,5030204
503020403,"Agatoma",226,261,487,5,503,50302,5030204
503020404,"Gatungu",165,181,346,5,503,50302,5030204
503020405,"Kabashenda",154,177,331,5,503,50302,5030204
503020406,"Kaduha",227,279,506,5,503,50302,5030204
503020407,"Kigarama",217,230,447,5,503,50302,5030204
503020408,"Nyabiheke",246,258,504,5,503,50302,5030204
503020409,"Nyamuduha",266,296,562,5,503,50302,5030204
503020410,"Rucumbo",215,234,449,5,503,50302,5030204
503020411,"Rutovu",204,228,432,5,503,50302,5030204
503020412,"Ryabakame",187,246,433,5,503,50302,5030204
503020413,"Ryebare",303,305,608,5,503,50302,5030204
503020501,"Gitega",253,271,524,5,503,50302,5030205
503020502,"Karama",250,261,511,5,503,50302,5030205
503020503,"Kizinga",297,317,614,5,503,50302,5030205
503020504,"Mangarama",220,252,472,5,503,50302,5030205
503020505,"Nyagahanga",471,649,1120,5,503,50302,5030205
503020506,"Nyakibande",265,283,548,5,503,50302,5030205
503020507,"Rugarama",320,352,672,5,503,50302,5030205
503020508,"Rusenge",188,229,417,5,503,50302,5030205
503030101,"Bukomane",390,409,799,5,503,50303,5030301
503030102,"Burembo",196,181,377,5,503,50303,5030301
503030103,"Gakiri",270,308,578,5,503,50303,5030301
503030104,"Gisaka",92,143,235,5,503,50303,5030301
503030105,"Kigomero",238,277,515,5,503,50303,5030301
503030106,"Ngaju",300,296,596,5,503,50303,5030301
503030107,"Nyakayaga",113,116,229,5,503,50303,5030301
503030108,"Rurema",168,183,351,5,503,50303,5030301
503030109,"Rwagitima",210,217,427,5,503,50303,5030301
503030110,"Ryarukaza",210,215,425,5,503,50303,5030301
503030201,"Binunga",144,155,299,5,503,50303,5030302
503030202,"Cyabusheshe",292,299,591,5,503,50303,5030302
503030203,"Cyoto",307,349,656,5,503,50303,5030302
503030204,"Kigabiro",306,364,670,5,503,50303,5030302
503030205,"Kivuba",293,343,636,5,503,50303,5030302
503030206,"Nyarunazi",197,238,435,5,503,50303,5030302
503030207,"Rushashi",258,281,539,5,503,50303,5030302
503030301,"Gisharara ",213,232,445,5,503,50303,5030303
503030302,"Isangano",245,291,536,5,503,50303,5030303
503030303,"Kagugu",323,371,694,5,503,50303,5030303
503030304,"Kamuhenda",282,312,594,5,503,50303,5030303
503030305,"Karubungo",199,216,415,5,503,50303,5030303
503030306,"Kinyange",305,327,632,5,503,50303,5030303
503030307,"Nyagacyamo",262,288,550,5,503,50303,5030303
503030308,"Nyarugarama",185,252,437,5,503,50303,5030303
503030309,"Rugarama",300,324,624,5,503,50303,5030303
503030310,"Rwamuhinga",134,125,259,5,503,50303,5030303
503030311,"Sata",338,362,700,5,503,50303,5030303
503030401,"Akibiraro",199,256,455,5,503,50303,5030304
503030402,"Akuruganda",217,229,446,5,503,50303,5030304
503030403,"Bukira",233,240,473,5,503,50303,5030304
503030404,"Bwiza",232,234,466,5,503,50303,5030304
503030405,"Gahama",239,239,478,5,503,50303,5030304
503030406,"Nyakabungo",196,231,427,5,503,50303,5030304
503030407,"Nyaruhanga",213,262,475,5,503,50303,5030304
503030408,"Ryabugenge",244,262,506,5,503,50303,5030304
503030409,"Tsima",137,147,284,5,503,50303,5030304
503030501,"Gahabo",236,271,507,5,503,50303,5030305
503030502,"Kagarama",232,269,501,5,503,50303,5030305
503030503,"Kinteko",258,315,573,5,503,50303,5030305
503030504,"Kwishaba",361,400,761,5,503,50303,5030305
503030505,"Minago",227,263,490,5,503,50303,5030305
503030506,"Mwanama",237,243,480,5,503,50303,5030305
503030507,"Nyabikenke",208,236,444,5,503,50303,5030305
503030508,"Nyamuraza",172,188,360,5,503,50303,5030305
503030509,"Nyarukombe",234,230,464,5,503,50303,5030305
503030510,"Rukiri",251,283,534,5,503,50303,5030305
503030511,"Rwinsanga",132,164,296,5,503,50303,5030305
503030601,"Gakiri",190,233,423,5,503,50303,5030306
503030602,"Gikuyu",184,221,405,5,503,50303,5030306
503030603,"Kavumu",191,220,411,5,503,50303,5030306
503030604,"Nyakabota",285,321,606,5,503,50303,5030306
503030605,"Nyakagarama",120,114,234,5,503,50303,5030306
503030606,"Nyamengo",185,214,399,5,503,50303,5030306
503030607,"Rugarama",136,165,301,5,503,50303,5030306
503030608,"Rurehe",138,184,322,5,503,50303,5030306
503030609,"Rwintama",392,424,816,5,503,50303,5030306
503040101,"Bihinga",834,834,1668,5,503,50304,5030401
503040102,"Kabarore I",741,711,1452,5,503,50304,5030401
503040103,"Kabaroreii",296,325,621,5,503,50304,5030401
503040104,"Kabingo",604,625,1229,5,503,50304,5030401
503040201,"Gatoki",1020,1060,2080,5,503,50304,5030402
503040202,"Kabeza",410,332,742,5,503,50304,5030402
503040203,"Mishenyi",497,563,1060,5,503,50304,5030402
503040204,"Ryanjeru",275,299,574,5,503,50304,5030402
503040301,"Karenge",931,1046,1977,5,503,50304,5030403
503040302,"Mutarama",664,709,1373,5,503,50304,5030403
503040303,"Nyarubuye",979,987,1966,5,503,50304,5030403
503040401,"Kabare",278,252,530,5,503,50304,5030404
503040402,"Kanteri",272,323,595,5,503,50304,5030404
503040403,"Marimba",479,571,1050,5,503,50304,5030404
503040404,"Nyarwanya",201,237,438,5,503,50304,5030404
503040405,"Rebero",662,754,1416,5,503,50304,5030404
503040406,"Rutenderi",1096,1183,2279,5,503,50304,5030404
503040407,"Rwimbogo",821,937,1758,5,503,50304,5030404
503040501,"Kabeza",657,761,1418,5,503,50304,5030405
503040502,"Ngarama",4047,1376,5423,5,503,50304,5030405
503040503,"Nyabikiri",1167,1248,2415,5,503,50304,5030405
503040601,"Kibondo I",264,222,486,5,503,50304,5030406
503040602,"Kibondo Ii",497,515,1012,5,503,50304,5030406
503040603,"Ruhuha",1455,1582,3037,5,503,50304,5030406
503040604,"Simbwa",995,1011,2006,5,503,50304,5030406
503050101,"Busetsa",338,356,694,5,503,50305,5030501
503050102,"Cyabuhimbiri",296,295,591,5,503,50305,5030501
503050103,"Cyatoko",195,246,441,5,503,50305,5030501
503050104,"Gitebwe",216,225,441,5,503,50305,5030501
503050105,"Kaninga",234,285,519,5,503,50305,5030501
503050106,"Kayenzi",203,201,404,5,503,50305,5030501
503050107,"Kivugiza",203,247,450,5,503,50305,5030501
503050108,"Nyarubuye I",382,365,747,5,503,50305,5030501
503050109,"Nyarubuye Ii",236,139,375,5,503,50305,5030501
503050110,"Nyarusange",207,193,400,5,503,50305,5030501
503050111,"Rugarama",330,381,711,5,503,50305,5030501
503050112,"Rwikubo",197,217,414,5,503,50305,5030501
503050113,"Tsima",164,180,344,5,503,50305,5030501
503050201,"Bugarama",204,236,440,5,503,50305,5030502
503050202,"Gisiza",256,256,512,5,503,50305,5030502
503050203,"Kabacuzi",216,214,430,5,503,50305,5030502
503050204,"Kigara",232,237,469,5,503,50305,5030502
503050205,"Mpama",356,407,763,5,503,50305,5030502
503050206,"Nyakabare",216,245,461,5,503,50305,5030502
503050207,"Rwabihumbi",219,243,462,5,503,50305,5030502
503050301,"Gakeri",269,256,525,5,503,50305,5030503
503050302,"Jabiro",311,295,606,5,503,50305,5030503
503050303,"Kigando",359,350,709,5,503,50305,5030503
503050304,"Kirara",310,296,606,5,503,50305,5030503
503050305,"Nyakabungo",150,158,308,5,503,50305,5030503
503050306,"Rutoma",288,357,645,5,503,50305,5030503
503050307,"Ryabushogoro",228,283,511,5,503,50305,5030503
503050401,"Agatare",336,402,738,5,503,50305,5030504
503050402,"Kageyo",280,306,586,5,503,50305,5030504
503050403,"Kashango",330,355,685,5,503,50305,5030504
503050404,"Kinyana",368,394,762,5,503,50305,5030504
503050405,"Nyabukobero",260,327,587,5,503,50305,5030504
503050406,"Nyagisozi",370,366,736,5,503,50305,5030504
503050407,"Rukira",235,291,526,5,503,50305,5030504
503060101,"Akagarama",266,255,521,5,503,50306,5030601
503060102,"Akarambo",308,354,662,5,503,50306,5030601
503060103,"Amataba",359,410,769,5,503,50306,5030601
503060104,"Bushenyi",280,356,636,5,503,50306,5030601
503060105,"Businde",382,433,815,5,503,50306,5030601
503060106,"Kiramuruzi",606,664,1270,5,503,50306,5030601
503060107,"Kiyogori",260,332,592,5,503,50306,5030601
503060108,"Nduba",281,344,625,5,503,50306,5030601
503060109,"Ubuhoro",297,304,601,5,503,50306,5030601
503060201,"Akabingo",374,447,821,5,503,50306,5030602
503060202,"Akamasine",403,360,763,5,503,50306,5030602
503060203,"Akurusizi",234,270,504,5,503,50306,5030602
503060204,"Bwunyu",218,295,513,5,503,50306,5030602
503060205,"Gatugunda",253,273,526,5,503,50306,5030602
503060206,"Gipangu",223,232,455,5,503,50306,5030602
503060207,"Kayita",336,442,778,5,503,50306,5030602
503060208,"Nyakagarama",329,359,688,5,503,50306,5030602
503060209,"Nyamarebe",224,279,503,5,503,50306,5030602
503060210,"Rwagashyaba",188,199,387,5,503,50306,5030602
503060211,"Umurehe",356,380,736,5,503,50306,5030602
503060301,"Karuhura",443,497,940,5,503,50306,5030603
503060302,"Kiyovu",284,297,581,5,503,50306,5030603
503060303,"Kumana",203,234,437,5,503,50306,5030603
503060304,"Kumunini",288,347,635,5,503,50306,5030603
503060305,"Kumwiga",348,449,797,5,503,50306,5030603
503060306,"Rwajembe",149,238,387,5,503,50306,5030603
503060401,"Akabare",295,360,655,5,503,50306,5030604
503060402,"Akabuga",332,393,725,5,503,50306,5030604
503060403,"Akantunga",248,274,522,5,503,50306,5030604
503060404,"Bushenyi",276,319,595,5,503,50306,5030604
503060405,"Gahoko",240,259,499,5,503,50306,5030604
503060406,"Gasave",290,357,647,5,503,50306,5030604
503060407,"Gitunginka",303,338,641,5,503,50306,5030604
503060408,"Itaba",347,394,741,5,503,50306,5030604
503060409,"Karaba",307,344,651,5,503,50306,5030604
503060410,"Nyagasambu",363,416,779,5,503,50306,5030604
503060411,"Nyagashenyi",293,328,621,5,503,50306,5030604
503060412,"Nyarusambu",335,414,749,5,503,50306,5030604
503060413,"Rugenge",202,243,445,5,503,50306,5030604
503070101,"Agatovu",316,343,659,5,503,50307,5030701
503070102,"Akabingo",225,251,476,5,503,50307,5030701
503070103,"Akingondo",255,299,554,5,503,50307,5030701
503070104,"Bishenyi",221,276,497,5,503,50307,5030701
503070105,"Bwiza",309,346,655,5,503,50307,5030701
503070106,"Isangano",325,369,694,5,503,50307,5030701
503070107,"Ishanti",319,283,602,5,503,50307,5030701
503070108,"Munanira",405,496,901,5,503,50307,5030701
503070109,"Muringa",159,180,339,5,503,50307,5030701
503070110,"Nyungwe",180,222,402,5,503,50307,5030701
503070111,"Ubutatu",333,370,703,5,503,50307,5030701
503070201,"Akabuye",355,348,703,5,503,50307,5030702
503070202,"Akavumu",326,354,680,5,503,50307,5030702
503070203,"Nyakabungo",221,292,513,5,503,50307,5030702
503070204,"Nyakagarama",303,272,575,5,503,50307,5030702
503070205,"Rebero",108,126,234,5,503,50307,5030702
503070206,"Ryabihura",289,330,619,5,503,50307,5030702
503070207,"Ryamuhuzi",281,360,641,5,503,50307,5030702
503070301,"Akabagendo",176,159,335,5,503,50307,5030703
503070302,"Akamamesa",283,311,594,5,503,50307,5030703
503070303,"Akarambo",169,197,366,5,503,50307,5030703
503070304,"Bidudu",368,427,795,5,503,50307,5030703
503070305,"Gakunyu",194,183,377,5,503,50307,5030703
503070306,"Gihinga",123,142,265,5,503,50307,5030703
503070307,"Gorora",304,359,663,5,503,50307,5030703
503070308,"Kabukungu",189,193,382,5,503,50307,5030703
503070309,"Kanyonyomba",109,123,232,5,503,50307,5030703
503070310,"Kigarama",290,361,651,5,503,50307,5030703
503070311,"Kinunga",158,174,332,5,503,50307,5030703
503070312,"Mataba",203,235,438,5,503,50307,5030703
503070313,"Mishunzi",239,260,499,5,503,50307,5030703
503070314,"Murehe",158,187,345,5,503,50307,5030703
503070315,"Nyagashenyi",257,276,533,5,503,50307,5030703
503070316,"Rubungo",222,281,503,5,503,50307,5030703
503070317,"Rukungu",134,151,285,5,503,50307,5030703
503070318,"Ryarugema",78,92,170,5,503,50307,5030703
503070401,"Agatare",130,178,308,5,503,50307,5030704
503070402,"Akagarama",197,203,400,5,503,50307,5030704
503070403,"Amarende",116,130,246,5,503,50307,5030704
503070404,"Bwiza",162,179,341,5,503,50307,5030704
503070405,"Cyarutabira",207,254,461,5,503,50307,5030704
503070406,"Ihema",140,143,283,5,503,50307,5030704
503070407,"Iramba",205,230,435,5,503,50307,5030704
503070408,"Kigabiro",181,215,396,5,503,50307,5030704
503070409,"Kigoroba",138,169,307,5,503,50307,5030704
503070410,"Kinimba",251,278,529,5,503,50307,5030704
503070411,"Nyagasambu",218,229,447,5,503,50307,5030704
503070412,"Nyarurembo",159,181,340,5,503,50307,5030704
503070413,"Rubaya",203,230,433,5,503,50307,5030704
503070414,"Rubira",401,402,803,5,503,50307,5030704
503070415,"Ryakabucye",242,196,438,5,503,50307,5030704
503070416,"Ryanyiranyana",166,224,390,5,503,50307,5030704
503070417,"Tubindi",194,253,447,5,503,50307,5030704
503080101,"Agasharu ",74,90,164,5,503,50308,5030801
503080102,"Akabuga ",59,70,129,5,503,50308,5030801
503080103,"Akagasaro",121,124,245,5,503,50308,5030801
503080104,"Cyahafi",144,176,320,5,503,50308,5030801
503080105,"Cyarugira ",46,49,95,5,503,50308,5030801
503080106,"Cyaruhagazi ",92,107,199,5,503,50308,5030801
503080107,"Gasigati",89,106,195,5,503,50308,5030801
503080108,"Kinyaga",91,111,202,5,503,50308,5030801
503080109,"Maryohe",175,187,362,5,503,50308,5030801
503080110,"Mugogo",59,68,127,5,503,50308,5030801
503080111,"Musasa",247,256,503,5,503,50308,5030801
503080112,"Rutoma",70,89,159,5,503,50308,5030801
503080113,"Rwangendo",72,92,164,5,503,50308,5030801
503080201,"Agahama",177,199,376,5,503,50308,5030802
503080202,"Agasharu",181,180,361,5,503,50308,5030802
503080203,"Biniga",223,245,468,5,503,50308,5030802
503080204,"Kinihira",158,182,340,5,503,50308,5030802
503080205,"Nyarubuye",206,208,414,5,503,50308,5030802
503080206,"Umunini",219,204,423,5,503,50308,5030802
503080207,"Urubiri",189,223,412,5,503,50308,5030802
503080208,"Urugarama",201,222,423,5,503,50308,5030802
503080209,"Uwakibungo",254,270,524,5,503,50308,5030802
503080301,"Agatagara",250,294,544,5,503,50308,5030803
503080302,"Akabirizi",175,194,369,5,503,50308,5030803
503080303,"Akamamana",243,273,516,5,503,50308,5030803
503080304,"Akamatamu",230,263,493,5,503,50308,5030803
503080305,"Akarengo",194,199,393,5,503,50308,5030803
503080306,"Kamugenge",196,232,428,5,503,50308,5030803
503080307,"Kaziga",258,284,542,5,503,50308,5030803
503080308,"Ruhinga",275,334,609,5,503,50308,5030803
503080309,"Rwanama",175,204,379,5,503,50308,5030803
503080310,"Umunanira",176,182,358,5,503,50308,5030803
503080401,"Gihembe",222,230,452,5,503,50308,5030804
503080402,"Juga",195,215,410,5,503,50308,5030804
503080403,"Kabeza",439,475,914,5,503,50308,5030804
503080404,"Karama",298,294,592,5,503,50308,5030804
503080405,"Kigarama",323,385,708,5,503,50308,5030804
503080406,"Ntungamo",383,378,761,5,503,50308,5030804
503080407,"Nyange",187,274,461,5,503,50308,5030804
503080408,"Rwasama",257,224,481,5,503,50308,5030804
503080409,"Rweza",270,284,554,5,503,50308,5030804
503080410,"Umurambi",234,271,505,5,503,50308,5030804
503080501,"Cyoga I",141,166,307,5,503,50308,5030805
503080502,"Cyoga Ii",256,261,517,5,503,50308,5030805
503080503,"Gahanga",238,274,512,5,503,50308,5030805
503080504,"Gatare",398,371,769,5,503,50308,5030805
503080505,"Kanyinya",545,513,1058,5,503,50308,5030805
503080506,"Karenge",355,395,750,5,503,50308,5030805
503080507,"Matyazo",141,165,306,5,503,50308,5030805
503080508,"Mayora",237,250,487,5,503,50308,5030805
503080509,"Mwambaro",301,370,671,5,503,50308,5030805
503080510,"Nshoro",171,176,347,5,503,50308,5030805
503080511,"Rugarama",389,382,771,5,503,50308,5030805
503080512,"Ruhenda",286,288,574,5,503,50308,5030805
503080513,"Rususa",171,178,349,5,503,50308,5030805
503080514,"Rwangendo",198,231,429,5,503,50308,5030805
503080515,"Taba",590,469,1059,5,503,50308,5030805
503090101,"Agacyamo",241,264,505,5,503,50309,5030901
503090102,"Agasharu",295,323,618,5,503,50309,5030901
503090103,"Agatagara",237,277,514,5,503,50309,5030901
503090104,"Akamashya",283,350,633,5,503,50309,5030901
503090105,"Byimana",328,340,668,5,503,50309,5030901
503090106,"Kabarondo",252,288,540,5,503,50309,5030901
503090107,"Kabuga",204,248,452,5,503,50309,5030901
503090108,"Kigote",250,289,539,5,503,50309,5030901
503090109,"Kimironko",365,391,756,5,503,50309,5030901
503090110,"Kiniga",236,290,526,5,503,50309,5030901
503090111,"Mataba",368,428,796,5,503,50309,5030901
503090112,"Ryampunga",383,422,805,5,503,50309,5030901
503090113,"Urugarama ",117,132,249,5,503,50309,5030901
503090201,"Bweranyange",373,522,895,5,503,50309,5030902
503090202,"Kabeza",437,521,958,5,503,50309,5030902
503090203,"Kagenge",329,385,714,5,503,50309,5030902
503090204,"Kiniga",438,509,947,5,503,50309,5030902
503090205,"Runyinya",353,437,790,5,503,50309,5030902
503090301,"Akarambo",267,318,585,5,503,50309,5030903
503090302,"Akayenzi",263,312,575,5,503,50309,5030903
503090303,"Ikinyaga",245,247,492,5,503,50309,5030903
503090304,"Impanzi",352,374,726,5,503,50309,5030903
503090305,"Nyagasambu",336,437,773,5,503,50309,5030903
503090306,"Nyagatovu",215,214,429,5,503,50309,5030903
503090307,"Umwiga",438,480,918,5,503,50309,5030903
503090308,"Urugarama",405,445,850,5,503,50309,5030903
503090401,"Bushenyi",314,363,677,5,503,50309,5030904
503090402,"Bweya",313,362,675,5,503,50309,5030904
503090403,"Byimana",451,535,986,5,503,50309,5030904
503090404,"Kibumba",219,266,485,5,503,50309,5030904
503090405,"Kigote",209,236,445,5,503,50309,5030904
503090406,"Kimondo",198,252,450,5,503,50309,5030904
503090407,"Kinunga",379,431,810,5,503,50309,5030904
503090408,"Nyakabanda",478,549,1027,5,503,50309,5030904
503090409,"Rugarama",225,280,505,5,503,50309,5030904
503100101,"Akagerero",356,399,755,5,503,50310,5031001
503100102,"Cyamuganga",211,210,421,5,503,50310,5031001
503100103,"Kajevuba",296,335,631,5,503,50310,5031001
503100104,"Kinihira",354,420,774,5,503,50310,5031001
503100105,"Kinyinya",301,343,644,5,503,50310,5031001
503100201,"Cyankondo",310,316,626,5,503,50310,5031002
503100202,"Kamuri",264,311,575,5,503,50310,5031002
503100203,"Karambi",239,239,478,5,503,50310,5031002
503100204,"Kimbugu",271,296,567,5,503,50310,5031002
503100205,"Mishenyi",500,579,1079,5,503,50310,5031002
503100206,"Ruhuha",226,233,459,5,503,50310,5031002
503100207,"Rurama",383,453,836,5,503,50310,5031002
503100208,"Rushenyi",292,317,609,5,503,50310,5031002
503100209,"Ruziranyenzi",383,425,808,5,503,50310,5031002
503100210,"Rwagakara",370,404,774,5,503,50310,5031002
503100301,"Akabuga",191,229,420,5,503,50310,5031003
503100302,"Akabuye",296,308,604,5,503,50310,5031003
503100303,"Akagarama",155,165,320,5,503,50310,5031003
503100304,"Akajevuba",133,124,257,5,503,50310,5031003
503100305,"Byimana",148,176,324,5,503,50310,5031003
503100306,"Cyabahima",140,139,279,5,503,50310,5031003
503100307,"Cyahafi",230,284,514,5,503,50310,5031003
503100308,"Gikundamvura",202,197,399,5,503,50310,5031003
503100309,"Ikirongo",145,162,307,5,503,50310,5031003
503100310,"Iperu",190,207,397,5,503,50310,5031003
503100311,"Kinunga",196,178,374,5,503,50310,5031003
503100312,"Kiyovu",131,153,284,5,503,50310,5031003
503100313,"Kizunguruko",153,164,317,5,503,50310,5031003
503100314,"Mbogo",175,172,347,5,503,50310,5031003
503100315,"Nyagisa",252,248,500,5,503,50310,5031003
503100316,"Nyantojo",110,124,234,5,503,50310,5031003
503100317,"Rukombe",236,214,450,5,503,50310,5031003
503100318,"Rurama",156,181,337,5,503,50310,5031003
503100319,"Ruyonza",267,316,583,5,503,50310,5031003
503100320,"Rwangingo",211,225,436,5,503,50310,5031003
503100401,"Amahoro",410,387,797,5,503,50310,5031004
503100402,"Gatungo",177,190,367,5,503,50310,5031004
503100403,"Ibare",237,218,455,5,503,50310,5031004
503100404,"Intsinzi",395,387,782,5,503,50310,5031004
503100405,"Kabeho",448,322,770,5,503,50310,5031004
503100406,"Kiyovu",582,469,1051,5,503,50310,5031004
503100407,"Rugarama",160,192,352,5,503,50310,5031004
503100408,"Urukundo",280,261,541,5,503,50310,5031004
503100501,"Burambira",205,250,455,5,503,50310,5031005
503100502,"Kintarama",236,233,469,5,503,50310,5031005
503100503,"Kivumu",251,300,551,5,503,50310,5031005
503100504,"Murama",189,238,427,5,503,50310,5031005
503100505,"Rugarama",274,306,580,5,503,50310,5031005
503100506,"Ruhengeri",336,312,648,5,503,50310,5031005
503100507,"Rutovu",169,223,392,5,503,50310,5031005
503100508,"Rwiri",197,203,400,5,503,50310,5031005
503110101,"Gatungo",196,237,433,5,503,50311,5031101
503110102,"Isangano",169,194,363,5,503,50311,5031101
503110103,"Kibimbiri",118,130,248,5,503,50311,5031101
503110104,"Kintarama",193,208,401,5,503,50311,5031101
503110105,"Kirehe",65,65,130,5,503,50311,5031101
503110106,"Kiziba",179,196,375,5,503,50311,5031101
503110107,"Nyabukingi",119,127,246,5,503,50311,5031101
503110108,"Rushenyi",151,140,291,5,503,50311,5031101
503110109,"Twegerane",164,197,361,5,503,50311,5031101
503110201,"Bitaba",148,149,297,5,503,50311,5031102
503110202,"Bushashari",133,140,273,5,503,50311,5031102
503110203,"Bwicaro",197,209,406,5,503,50311,5031102
503110204,"Gashure",162,195,357,5,503,50311,5031102
503110205,"Gatyazo",234,246,480,5,503,50311,5031102
503110206,"Kagera",198,224,422,5,503,50311,5031102
503110207,"Kigarama",178,189,367,5,503,50311,5031102
503110208,"Kukabare",235,276,511,5,503,50311,5031102
503110209,"Murambi",247,284,531,5,503,50311,5031102
503110210,"Rugaragara",146,157,303,5,503,50311,5031102
503110301,"Kabuye",139,170,309,5,503,50311,5031103
503110302,"Kajevuba",184,190,374,5,503,50311,5031103
503110303,"Kamatamu",165,181,346,5,503,50311,5031103
503110304,"Mpangare I",188,220,408,5,503,50311,5031103
503110305,"Mpangare Ii",95,115,210,5,503,50311,5031103
503110306,"Neke",224,252,476,5,503,50311,5031103
503110307,"Nyarubuye",135,162,297,5,503,50311,5031103
503110308,"Rweza",165,174,339,5,503,50311,5031103
503110401,"Gishikiri",134,137,271,5,503,50311,5031104
503110402,"Kabeza",250,272,522,5,503,50311,5031104
503110403,"Kagarama",300,321,621,5,503,50311,5031104
503110404,"Kanyinya",366,356,722,5,503,50311,5031104
503110405,"Mubirembo",305,304,609,5,503,50311,5031104
503110406,"Munanira",147,164,311,5,503,50311,5031104
503110407,"Rukoma",259,281,540,5,503,50311,5031104
503110408,"Rusenge",145,151,296,5,503,50311,5031104
503110409,"Umugamba",236,190,426,5,503,50311,5031104
503110501,"Byimana",186,223,409,5,503,50311,5031105
503110502,"Kabudogo",146,149,295,5,503,50311,5031105
503110503,"Kamiseke",160,205,365,5,503,50311,5031105
503110504,"Kamurara",203,226,429,5,503,50311,5031105
503110505,"Kibatsi",241,246,487,5,503,50311,5031105
503110506,"Kuwingeri",229,247,476,5,503,50311,5031105
503110507,"Mataba",244,269,513,5,503,50311,5031105
503110508,"Mpashani",290,340,630,5,503,50311,5031105
503110509,"Nyamikamba",304,355,659,5,503,50311,5031105
503110510,"Par-chance",204,216,420,5,503,50311,5031105
503110511,"Rwintare",125,154,279,5,503,50311,5031105
503110601,"Burembo",260,297,557,5,503,50311,5031106
503110602,"Butumba",138,144,282,5,503,50311,5031106
503110603,"Cyanayanoga",185,178,363,5,503,50311,5031106
503110604,"Kabuga",244,229,473,5,503,50311,5031106
503110605,"Nyakabungo",175,188,363,5,503,50311,5031106
503110606,"Nyamiyaga",155,184,339,5,503,50311,5031106
503110607,"Rugarama",100,126,226,5,503,50311,5031106
503110608,"Rugogwe",234,261,495,5,503,50311,5031106
503120101,"Abanyangeyo",137,193,330,5,503,50312,5031201
503120102,"Agasenga",263,263,526,5,503,50312,5031201
503120103,"Akagarama I",268,324,592,5,503,50312,5031201
503120104,"Akagarama Ii",233,263,496,5,503,50312,5031201
503120105,"Akamabuye",172,196,368,5,503,50312,5031201
503120106,"Akankusi",202,208,410,5,503,50312,5031201
503120107,"Gumino",215,251,466,5,503,50312,5031201
503120108,"Nyagatabire",278,322,600,5,503,50312,5031201
503120109,"Rwagitima",243,315,558,5,503,50312,5031201
503120201,"Akabuga",281,311,592,5,503,50312,5031202
503120202,"Gasabo",356,407,763,5,503,50312,5031202
503120203,"Icyerekezo",282,289,571,5,503,50312,5031202
503120204,"Urushenyi",280,285,565,5,503,50312,5031202
503120301,"Akabuga",209,209,418,5,503,50312,5031203
503120302,"Amataba",272,302,574,5,503,50312,5031203
503120303,"Byimana",293,281,574,5,503,50312,5031203
503120304,"Kanyinya",364,354,718,5,503,50312,5031203
503120305,"Kigabiro",233,266,499,5,503,50312,5031203
503120306,"Runyinya",279,287,566,5,503,50312,5031203
503120307,"Rwamusaro",220,232,452,5,503,50312,5031203
503120308,"Rwikubo",117,136,253,5,503,50312,5031203
503120309,"Ryarutsinzi",163,162,325,5,503,50312,5031203
503120401,"Akababito",517,489,1006,5,503,50312,5031204
503120402,"Karufuri",274,313,587,5,503,50312,5031204
503120403,"Nyakanga",357,397,754,5,503,50312,5031204
503120404,"Nyamarebe",195,216,411,5,503,50312,5031204
503120405,"Nyaruhoko",264,299,563,5,503,50312,5031204
503120501,"Akagarama",151,145,296,5,503,50312,5031205
503120502,"Butinza",132,146,278,5,503,50312,5031205
503120503,"Kagunga",117,134,251,5,503,50312,5031205
503120504,"Kibenga",129,153,282,5,503,50312,5031205
503120505,"Nyagasozi",204,230,434,5,503,50312,5031205
503120506,"Rubare",251,264,515,5,503,50312,5031205
503120507,"Rugarama",165,161,326,5,503,50312,5031205
503120508,"Rurenge",156,183,339,5,503,50312,5031205
503120601,"Cyeru",191,237,428,5,503,50312,5031206
503120602,"Kabuye",443,466,909,5,503,50312,5031206
503120603,"Kagasha",168,211,379,5,503,50312,5031206
503120604,"Kigarama",154,165,319,5,503,50312,5031206
503120605,"Nyamugari",259,279,538,5,503,50312,5031206
503120606,"Nyarubuye",494,529,1023,5,503,50312,5031206
503120607,"Rugarama",294,381,675,5,503,50312,5031206
503120608,"Rushenyi",335,356,691,5,503,50312,5031206
503120609,"Umunini",286,351,637,5,503,50312,5031206
503130101,"Akenene",262,276,538,5,503,50313,5031301
503130102,"Kabare",254,267,521,5,503,50313,5031301
503130103,"Nyagasiga",370,422,792,5,503,50313,5031301
503130104,"Rebero",485,545,1030,5,503,50313,5031301
503130201,"Agatare",421,429,850,5,503,50313,5031302
503130202,"Gashenyi I",275,276,551,5,503,50313,5031302
503130203,"Gashenyi Ii",250,288,538,5,503,50313,5031302
503130204,"Ibare",254,296,550,5,503,50313,5031302
503130205,"Ntende I",271,299,570,5,503,50313,5031302
503130206,"Ntende Ii",329,363,692,5,503,50313,5031302
503130207,"Nyagahanga",300,290,590,5,503,50313,5031302
503130301,"Agakiri",444,524,968,5,503,50313,5031303
503130302,"Akazinga",154,177,331,5,503,50313,5031303
503130303,"Amahoro",213,251,464,5,503,50313,5031303
503130304,"Cyampirita",204,234,438,5,503,50313,5031303
503130305,"Kabeza",407,411,818,5,503,50313,5031303
503130306,"Kanyangese",101,98,199,5,503,50313,5031303
503130307,"Munini",190,227,417,5,503,50313,5031303
503130308,"Nyabubare",304,365,669,5,503,50313,5031303
503130309,"Nyakariro",296,340,636,5,503,50313,5031303
503130310,"Rebero",177,212,389,5,503,50313,5031303
503130311,"Remera",230,243,473,5,503,50313,5031303
503130312,"Rugarama",206,181,387,5,503,50313,5031303
503130313,"Rugazi",345,348,693,5,503,50313,5031303
503130314,"Rwagitima",201,199,400,5,503,50313,5031303
503130315,"Rwunyu",322,327,649,5,503,50313,5031303
503130316,"Tetero",254,304,558,5,503,50313,5031303
503130401,"Agakenyeri",210,226,436,5,503,50313,5031304
503130402,"Akabare",163,179,342,5,503,50313,5031304
503130403,"Bujumo",198,191,389,5,503,50313,5031304
503130404,"Gitsimba I",217,215,432,5,503,50313,5031304
503130405,"Gitsimba Ii",244,272,516,5,503,50313,5031304
503130406,"Kabana",360,396,756,5,503,50313,5031304
503130407,"Matare",134,171,305,5,503,50313,5031304
503130408,"Nyagatare",326,360,686,5,503,50313,5031304
503130409,"Nyarusambu",276,306,582,5,503,50313,5031304
503130410,"Rebero",384,385,769,5,503,50313,5031304
503130411,"Rwankuba",208,222,430,5,503,50313,5031304
503130501,"Akabasanza",246,220,466,5,503,50313,5031305
503130502,"Gatovu",201,256,457,5,503,50313,5031305
503130503,"Kabeza",241,274,515,5,503,50313,5031305
503130504,"Ngoma",213,216,429,5,503,50313,5031305
503130505,"Nyabagendwa",225,239,464,5,503,50313,5031305
503130506,"Nyamata",221,259,480,5,503,50313,5031305
503130507,"Nyamirambo",263,296,559,5,503,50313,5031305
503130508,"Nyenyeri",264,268,532,5,503,50313,5031305
503130509,"Rambura",256,245,501,5,503,50313,5031305
503130510,"Rushenyi",216,244,460,5,503,50313,5031305
503130511,"Tungiro",235,260,495,5,503,50313,5031305
503130601,"Akajevuba",379,392,771,5,503,50313,5031306
503130602,"Gikoma",409,446,855,5,503,50313,5031306
503130603,"Kanyiranzage",412,463,875,5,503,50313,5031306
503130604,"Miko",334,397,731,5,503,50313,5031306
503130605,"Rwamivu",326,385,711,5,503,50313,5031306
503140101,"Isangano",286,292,578,5,503,50314,5031401
503140102,"Kiburara",231,237,468,5,503,50314,5031401
503140103,"Nyacyonga",192,237,429,5,503,50314,5031401
503140104,"Rebero",297,323,620,5,503,50314,5031401
503140105,"Rubirizi",223,218,441,5,503,50314,5031401
503140106,"Rugando",239,245,484,5,503,50314,5031401
503140201,"Gikobwa",128,79,207,5,503,50314,5031402
503140202,"Humure",306,350,656,5,503,50314,5031402
503140203,"Kabeza",441,460,901,5,503,50314,5031402
503140204,"Marembo",411,396,807,5,503,50314,5031402
503140205,"Mucucu",118,47,165,5,503,50314,5031402
503140206,"Munini",507,468,975,5,503,50314,5031402
503140207,"Nyamwiza",231,235,466,5,503,50314,5031402
503140208,"Rweza",276,346,622,5,503,50314,5031402
503140209,"Rwinyana",182,156,338,5,503,50314,5031402
503140301,"Akajevuba",319,311,630,5,503,50314,5031403
503140302,"Gashenyi",350,331,681,5,503,50314,5031403
503140303,"Gihunika",426,449,875,5,503,50314,5031403
503140304,"Gitega",478,507,985,5,503,50314,5031403
503140305,"Kabeza",431,442,873,5,503,50314,5031403
503140306,"Kagugu",352,370,722,5,503,50314,5031403
503140307,"Kidugudu",515,510,1025,5,503,50314,5031403
503140308,"Kiyovu",477,468,945,5,503,50314,5031403
503140309,"Nyamatete",347,388,735,5,503,50314,5031403
503140310,"Rutembo",264,281,545,5,503,50314,5031403
503140311,"Rwimbogo",393,377,770,5,503,50314,5031403
503140312,"Rwiminazi",443,480,923,5,503,50314,5031403
503140313,"Umurego",260,278,538,5,503,50314,5031403
503140401,"Akamahoro",289,323,612,5,503,50314,5031404
503140402,"Byimana",468,500,968,5,503,50314,5031404
503140403,"Isangano",253,265,518,5,503,50314,5031404
503140404,"Kabusunzu",497,565,1062,5,503,50314,5031404
503140405,"Karambi",359,370,729,5,503,50314,5031404
503140406,"Kinunga",506,518,1024,5,503,50314,5031404
503140407,"Ndama I",359,381,740,5,503,50314,5031404
503140408,"Ndama Ii",324,368,692,5,503,50314,5031404
503140409,"Nyamabuye",360,378,738,5,503,50314,5031404
503140410,"Rukomo",447,449,896,5,503,50314,5031404
503140411,"Rwikiniro I",451,426,877,5,503,50314,5031404
503140412,"Rwikiniro Ii",299,265,564,5,503,50314,5031404
504010101,"Gisenga",177,185,362,5,504,50401,5040101
504010102,"Juru",594,675,1269,5,504,50401,5040101
504010103,"Kamudongo",251,318,569,5,504,50401,5040101
504010104,"Kimana",279,291,570,5,504,50401,5040101
504010105,"Kwisoko",303,306,609,5,504,50401,5040101
504010106,"Mikinga",402,414,816,5,504,50401,5040101
504010107,"Miyaga",337,284,621,5,504,50401,5040101
504010108,"Musimbi",222,219,441,5,504,50401,5040101
504010109,"Nyabombe",211,233,444,5,504,50401,5040101
504010110,"Nyabugogo",246,263,509,5,504,50401,5040101
504010111,"Nyakabungo",245,317,562,5,504,50401,5040101
504010112,"Rubariro",414,468,882,5,504,50401,5040101
504010201,"Akabare",388,384,772,5,504,50401,5040102
504010202,"Nyamiyaga",612,589,1201,5,504,50401,5040102
504010203,"Rukore",491,503,994,5,504,50401,5040102
504010204,"Tsima",331,359,690,5,504,50401,5040102
504010205,"Uruhuha",443,304,747,5,504,50401,5040102
504010301,"Kabuye",459,506,965,5,504,50401,5040103
504010302,"Kinyinya",328,385,713,5,504,50401,5040103
504010303,"Kiyenzi",340,395,735,5,504,50401,5040103
504010304,"Nyagahandagaza",430,476,906,5,504,50401,5040103
504010305,"Nyirampaca",392,489,881,5,504,50401,5040103
504010401,"Akabahizi",416,489,905,5,504,50401,5040104
504010402,"Akabeza",289,325,614,5,504,50401,5040104
504010403,"Akamuyenzi",245,301,546,5,504,50401,5040104
504010404,"Akimpara",294,340,634,5,504,50401,5040104
504010405,"Buyanja",347,376,723,5,504,50401,5040104
504010406,"Ibiza",300,367,667,5,504,50401,5040104
504010407,"Myatano",293,384,677,5,504,50401,5040104
504010408,"Nyagitabire",393,350,743,5,504,50401,5040104
504010409,"Rwinkuba",301,377,678,5,504,50401,5040104
504010410,"Umwiga",302,386,688,5,504,50401,5040104
504010411,"Urugarama",274,354,628,5,504,50401,5040104
504010412,"Videwo",352,405,757,5,504,50401,5040104
504020101,"Kabeza",368,399,767,5,504,50402,5040201
504020102,"Kacyiru",252,275,527,5,504,50402,5040201
504020103,"Kanyetonga",248,253,501,5,504,50402,5040201
504020104,"Kibimba",251,269,520,5,504,50402,5040201
504020105,"Kiburara",384,411,795,5,504,50402,5040201
504020106,"Mahumbezi",289,298,587,5,504,50402,5040201
504020107,"Nyagakonji",223,225,448,5,504,50402,5040201
504020108,"Rukagati",332,311,643,5,504,50402,5040201
504020109,"Rwabarema",312,349,661,5,504,50402,5040201
504020110,"Rwakavuna",247,258,505,5,504,50402,5040201
504020111,"Umunini",213,242,455,5,504,50402,5040201
504020112,"Umuremampango",279,332,611,5,504,50402,5040201
504020113,"Umuyenzi",324,338,662,5,504,50402,5040201
504020201,"Gahombya",191,186,377,5,504,50402,5040202
504020202,"Kagumiro",155,174,329,5,504,50402,5040202
504020203,"Kajevuba",246,317,563,5,504,50402,5040202
504020204,"Kazeneza",176,201,377,5,504,50402,5040202
504020205,"Mubuga",338,352,690,5,504,50402,5040202
504020206,"Rugunga",456,477,933,5,504,50402,5040202
504020301,"Duterimbere",327,380,707,5,504,50402,5040203
504020302,"Gahama",379,348,727,5,504,50402,5040203
504020303,"Gikombe",245,297,542,5,504,50402,5040203
504020304,"Kabatinya",263,305,568,5,504,50402,5040203
504020305,"Kabuhome",342,361,703,5,504,50402,5040203
504020306,"Kanyirabuki",405,422,827,5,504,50402,5040203
504020307,"Matahiro",437,459,896,5,504,50402,5040203
504020308,"Nyabiyenzi",282,307,589,5,504,50402,5040203
504020309,"Rompuwe",303,331,634,5,504,50402,5040203
504020310,"Rushenyi",413,428,841,5,504,50402,5040203
504020311,"Rwagatera",404,431,835,5,504,50402,5040203
504020401,"Bara",460,484,944,5,504,50402,5040204
504020402,"Buhabwa",211,229,440,5,504,50402,5040204
504020403,"Kabarungu",318,356,674,5,504,50402,5040204
504020404,"Kabeza",452,461,913,5,504,50402,5040204
504020405,"Kamuhabura",349,363,712,5,504,50402,5040204
504020406,"Nyarusange",233,255,488,5,504,50402,5040204
504020407,"Rwamushoma",250,314,564,5,504,50402,5040204
504020501,"Bwatampama",421,448,869,5,504,50402,5040205
504020502,"Gakenyeri",272,245,517,5,504,50402,5040205
504020503,"Gakoma",231,270,501,5,504,50402,5040205
504020504,"Gishyoza",336,386,722,5,504,50402,5040205
504020505,"Kibimba",185,202,387,5,504,50402,5040205
504020506,"Kibuye",336,363,699,5,504,50402,5040205
504020507,"Ntungamo",476,461,937,5,504,50402,5040205
504020508,"Nyabugogo",332,358,690,5,504,50402,5040205
504030101,"Busindu",342,422,764,5,504,50403,5040301
504030102,"Cyabajwa",204,202,406,5,504,50403,5040301
504030103,"Kabarondo",774,700,1474,5,504,50403,5040301
504030104,"Murenge",325,337,662,5,504,50403,5040301
504030105,"Nkuba I",279,289,568,5,504,50403,5040301
504030106,"Nkuba Ii",206,223,429,5,504,50403,5040301
504030107,"Rugwagwa",388,395,783,5,504,50403,5040301
504030108,"Rutagara",661,603,1264,5,504,50403,5040301
504030201,"Agashikiri",230,307,537,5,504,50403,5040302
504030202,"Akinyenyeri",384,301,685,5,504,50403,5040302
504030203,"Bitoma",288,335,623,5,504,50403,5040302
504030204,"Cyinzovu",287,321,608,5,504,50403,5040302
504030205,"Gihuke",206,224,430,5,504,50403,5040302
504030206,"Munini",370,386,756,5,504,50403,5040302
504030207,"Nyabisenga",155,130,285,5,504,50403,5040302
504030208,"Nyakabungo",219,247,466,5,504,50403,5040302
504030209,"Rugarama ",127,148,275,5,504,50403,5040302
504030210,"Rugazi",260,297,557,5,504,50403,5040302
504030211,"Rurenge",372,385,757,5,504,50403,5040302
504030212,"Rwakigeri",347,418,765,5,504,50403,5040302
504030301,"Agasharu",275,251,526,5,504,50403,5040303
504030302,"Agatare",358,396,754,5,504,50403,5040303
504030303,"Akagarama",289,296,585,5,504,50403,5040303
504030304,"Gashonyi",181,208,389,5,504,50403,5040303
504030305,"Gisoro",358,399,757,5,504,50403,5040303
504030306,"Kabeza",389,410,799,5,504,50403,5040303
504030307,"Kabuye",581,625,1206,5,504,50403,5040303
504030308,"Kanyegenyege",316,397,713,5,504,50403,5040303
504030309,"Murambi",223,285,508,5,504,50403,5040303
504030310,"Nyabikenke I",177,229,406,5,504,50403,5040303
504030311,"Nyabikenke Ii",271,290,561,5,504,50403,5040303
504030312,"Rubira",197,281,478,5,504,50403,5040303
504030401,"Butobagire",280,279,559,5,504,50403,5040304
504030402,"Rurama",322,315,637,5,504,50403,5040304
504030403,"Rusera",285,350,635,5,504,50403,5040304
504030404,"Rutagara Centre ",280,279,559,5,504,50403,5040304
504030405,"Umucyo",417,392,809,5,504,50403,5040304
504040101,"Abemeye Amahoro",379,520,899,5,504,50404,5040401
504040102,"Abisunganye",439,455,894,5,504,50404,5040401
504040103,"Amizero",383,430,813,5,504,50404,5040401
504040104,"Karambarara",327,335,662,5,504,50404,5040401
504040105,"Kinyemera",261,293,554,5,504,50404,5040401
504040201,"Akabuga",238,249,487,5,504,50404,5040402
504040202,"Buhonde",369,436,805,5,504,50404,5040402
504040203,"Cyeru",276,330,606,5,504,50404,5040402
504040204,"Gakurazo",318,387,705,5,504,50404,5040402
504040205,"Gasogororo",277,359,636,5,504,50404,5040402
504040206,"Gatebe",448,537,985,5,504,50404,5040402
504040207,"Kabungo",251,294,545,5,504,50404,5040402
504040208,"Kayonza Centre",607,619,1226,5,504,50404,5040402
504040209,"Kivugiza",253,287,540,5,504,50404,5040402
504040210,"Miyange",308,345,653,5,504,50404,5040402
504040211,"Munazi",201,255,456,5,504,50404,5040402
504040301,"Akabuga",202,196,398,5,504,50404,5040403
504040302,"Akarugangare",181,250,431,5,504,50404,5040403
504040303,"Bwingeyo",251,321,572,5,504,50404,5040403
504040304,"Gihima",268,351,619,5,504,50404,5040403
504040305,"Kinunga",320,431,751,5,504,50404,5040403
504040306,"Mburabuturo",235,293,528,5,504,50404,5040403
504040401,"Akabeza",226,265,491,5,504,50404,5040404
504040402,"Akamarara",250,272,522,5,504,50404,5040404
504040403,"Akamayange",284,338,622,5,504,50404,5040404
504040404,"Akanyinya",282,342,624,5,504,50404,5040404
504040405,"Gatagara",310,392,702,5,504,50404,5040404
504040406,"Iragwe",305,349,654,5,504,50404,5040404
504040407,"Irebero",398,422,820,5,504,50404,5040404
504040408,"Nyagatovu",278,267,545,5,504,50404,5040404
504040501,"Gikumba",331,401,732,5,504,50404,5040405
504040502,"Kanyamasha",318,311,629,5,504,50404,5040405
504040503,"Karambo I",244,291,535,5,504,50404,5040405
504040504,"Karambo Ii",238,242,480,5,504,50404,5040405
504040505,"Nyakagarama",241,246,487,5,504,50404,5040405
504040506,"Rugendabari",293,349,642,5,504,50404,5040405
504040507,"Rutare",200,215,415,5,504,50404,5040405
504050101,"Bweramvura",222,272,494,5,504,50405,5040501
504050102,"Gahengeri",145,150,295,5,504,50405,5040501
504050103,"Gisunzu",286,334,620,5,504,50405,5040501
504050104,"Kabeza",271,307,578,5,504,50405,5040501
504050105,"Kagarama",293,323,616,5,504,50405,5040501
504050106,"Mpilindi",265,291,556,5,504,50405,5040501
504050107,"Nyamabuye",263,241,504,5,504,50405,5040501
504050108,"Shyanda",344,405,749,5,504,50405,5040501
504050201,"Gihazo",199,223,422,5,504,50405,5040502
504050202,"Karama",306,370,676,5,504,50405,5040502
504050203,"Ngoma",292,337,629,5,504,50405,5040502
504050204,"Rebezo",203,225,428,5,504,50405,5040502
504050205,"Rugarama",184,206,390,5,504,50405,5040502
504050301,"Bubindi",215,244,459,5,504,50405,5040503
504050302,"Kajevuba",229,231,460,5,504,50405,5040503
504050303,"Murama",242,268,510,5,504,50405,5040503
504050304,"Rusaro",197,230,427,5,504,50405,5040503
504050305,"Rwabugengeri",210,235,445,5,504,50405,5040503
504050401,"Busasamana",208,225,433,5,504,50405,5040504
504050402,"Nyagahinga",264,313,577,5,504,50405,5040504
504050403,"Nyakanazi",403,430,833,5,504,50405,5040504
504050404,"Rugazi",324,359,683,5,504,50405,5040504
504050405,"Rurenge",163,212,375,5,504,50405,5040504
504050501,"Bicumbi",295,338,633,5,504,50405,5040505
504050502,"Bwinyana",334,329,663,5,504,50405,5040505
504050503,"Byimana",238,291,529,5,504,50405,5040505
504050504,"Gasutamo",355,420,775,5,504,50405,5040505
504050505,"Kinyinya",355,366,721,5,504,50405,5040505
504050506,"Seresi",240,281,521,5,504,50405,5040505
504060101,"Buhabwa",445,362,807,5,504,50406,5040601
504060102,"Cyamburara",413,414,827,5,504,50406,5040601
504060103,"Gakoma",153,76,229,5,504,50406,5040601
504060104,"Miyaga",246,243,489,5,504,50406,5040601
504060105,"Mucucu",69,42,111,5,504,50406,5040601
504060106,"Murundi",249,231,480,5,504,50406,5040601
504060201,"Akamina",321,329,650,5,504,50406,5040602
504060202,"Bugarura",314,303,617,5,504,50406,5040602
504060203,"Gafunzo",202,224,426,5,504,50406,5040602
504060204,"Kabana",202,249,451,5,504,50406,5040602
504060205,"Kabuga",241,276,517,5,504,50406,5040602
504060206,"Karambi",373,349,722,5,504,50406,5040602
504060207,"Kiyovu",297,272,569,5,504,50406,5040602
504060208,"Ngumeri I",279,322,601,5,504,50406,5040602
504060209,"Ngumeri Ii",195,228,423,5,504,50406,5040602
504060210,"Nyagashanga",259,282,541,5,504,50406,5040602
504060211,"Nyamirama",358,375,733,5,504,50406,5040602
504060212,"Rugunga",407,402,809,5,504,50406,5040602
504060213,"Rukoyoyo",360,372,732,5,504,50406,5040602
504060214,"Rumuri",225,240,465,5,504,50406,5040602
504060215,"Rushenyi",298,349,647,5,504,50406,5040602
504060216,"Rwasama ",281,278,559,5,504,50406,5040602
504060217,"Rwinsheke I",236,256,492,5,504,50406,5040602
504060218,"Rwinsheke Ii",155,154,309,5,504,50406,5040602
504060301,"Kayongo",326,307,633,5,504,50406,5040603
504060302,"Kibari",221,253,474,5,504,50406,5040603
504060303,"Kinyana",364,378,742,5,504,50406,5040603
504060304,"Macuba",314,329,643,5,504,50406,5040603
504060305,"Nyanga",268,281,549,5,504,50406,5040603
504060306,"Rucaca",289,312,601,5,504,50406,5040603
504060401,"Akanyerezo",162,162,324,5,504,50406,5040604
504060402,"Cyandorimana",189,208,397,5,504,50406,5040604
504060403,"Kabingo",332,352,684,5,504,50406,5040604
504060404,"Kaneke",149,140,289,5,504,50406,5040604
504060405,"Kanyegera",173,184,357,5,504,50406,5040604
504060406,"Ngarama",187,203,390,5,504,50406,5040604
504060407,"Nyabugando",229,214,443,5,504,50406,5040604
504060408,"Rwakabanda",460,474,934,5,504,50406,5040604
504060409,"Rwinyambo",269,346,615,5,504,50406,5040604
504060410,"Ryakirenzi I",419,439,858,5,504,50406,5040604
504060411,"Ryakirenzi Ii",444,524,968,5,504,50406,5040604
504060412,"Ryamanyoni",313,360,673,5,504,50406,5040604
504060413,"Ubwiza",403,441,844,5,504,50406,5040604
504070101,"Gisunzu",200,183,383,5,504,50407,5040701
504070102,"Kiyonza",184,19,203,5,504,50407,5040701
504070103,"Ndago",255,244,499,5,504,50407,5040701
504070104,"Rugeyo",156,134,290,5,504,50407,5040701
504070105,"Rwisirabo A",277,268,545,5,504,50407,5040701
504070106,"Rwisirabo B",412,346,758,5,504,50407,5040701
504070107,"Sebasengo",240,233,473,5,504,50407,5040701
504070201,"Agahiza",321,346,667,5,504,50407,5040702
504070202,"Murori",383,430,813,5,504,50407,5040702
504070203,"Mwiri",268,289,557,5,504,50407,5040702
504070204,"Nyakagarama",154,189,343,5,504,50407,5040702
504070205,"Umutekano",322,343,665,5,504,50407,5040702
504070301,"Gasarabwayi",531,567,1098,5,504,50407,5040703
504070302,"Kabeza",414,466,880,5,504,50407,5040703
504070303,"Kabukeye",426,399,825,5,504,50407,5040703
504070304,"Kigarama",510,499,1009,5,504,50407,5040703
504070305,"Ruhoroba",321,377,698,5,504,50407,5040703
504070306,"Rwazana",542,606,1148,5,504,50407,5040703
504070307,"Ryamutumo",327,346,673,5,504,50407,5040703
504070401,"Gitega",279,352,631,5,504,50407,5040704
504070402,"Muhozi",518,538,1056,5,504,50407,5040704
504070403,"Murehe",356,380,736,5,504,50407,5040704
504070404,"Nyakabungo",143,148,291,5,504,50407,5040704
504070405,"Ryakibanda",309,372,681,5,504,50407,5040704
504080101,"Busasamana",138,157,295,5,504,50408,5040801
504080102,"Irebero",192,177,369,5,504,50408,5040801
504080103,"Kabeza",184,146,330,5,504,50408,5040801
504080104,"Kururembo",125,164,289,5,504,50408,5040801
504080105,"Nyakabingo",242,275,517,5,504,50408,5040801
504080106,"Nyamata",261,278,539,5,504,50408,5040801
504080201,"Gafunzo",166,215,381,5,504,50408,5040802
504080202,"Gashonga",252,261,513,5,504,50408,5040802
504080203,"Kabusunzu",185,206,391,5,504,50408,5040802
504080204,"Kagese",442,212,654,5,504,50408,5040802
504080205,"Kagoma",253,273,526,5,504,50408,5040802
504080206,"Kamahoro",190,218,408,5,504,50408,5040802
504080207,"Kanyinya",210,210,420,5,504,50408,5040802
504080208,"Kibare",134,173,307,5,504,50408,5040802
504080301,"Gasenyi",284,347,631,5,504,50408,5040803
504080302,"Ihema",221,220,441,5,504,50408,5040803
504080303,"Kagasa",300,273,573,5,504,50408,5040803
504080304,"Kamabuye",350,338,688,5,504,50408,5040803
504080305,"Kumunini",217,201,418,5,504,50408,5040803
504080306,"Murambi",186,185,371,5,504,50408,5040803
504080307,"Musenyi ",104,108,212,5,504,50408,5040803
504080308,"Remera",363,423,786,5,504,50408,5040803
504080401,"Gasabo",340,339,679,5,504,50408,5040804
504080402,"Ihumure",422,442,864,5,504,50408,5040804
504080403,"Iramiro",362,384,746,5,504,50408,5040804
504080404,"Mwurire",373,411,784,5,504,50408,5040804
504080405,"Nyamugari",327,292,619,5,504,50408,5040804
504090101,"Gasharu",314,363,677,5,504,50409,5040901
504090102,"Gasogi",352,398,750,5,504,50409,5040901
504090103,"Gasura",532,596,1128,5,504,50409,5040901
504090104,"Kabuye",380,370,750,5,504,50409,5040901
504090105,"Kamonyi",273,372,645,5,504,50409,5040901
504090106,"Karambi",360,438,798,5,504,50409,5040901
504090107,"Kinkoronko",451,497,948,5,504,50409,5040901
504090108,"Kiyanja",256,298,554,5,504,50409,5040901
504090201,"Karama",389,410,799,5,504,50409,5040902
504090202,"Kiyovu",320,375,695,5,504,50409,5040902
504090203,"Musenyi",466,556,1022,5,504,50409,5040902
504090204,"Nyabisindu",370,375,745,5,504,50409,5040902
504090205,"Nyagasambu",397,388,785,5,504,50409,5040902
504090206,"Nyarunazi",681,652,1333,5,504,50409,5040902
504090207,"Rusera",219,222,441,5,504,50409,5040902
504090301,"Amashinge ",334,366,700,5,504,50409,5040903
504090302,"Bwiza",387,382,769,5,504,50409,5040903
504090303,"Kabeza",570,596,1166,5,504,50409,5040903
504090304,"Kabuya I",377,442,819,5,504,50409,5040903
504090305,"Kabuya Ii",341,395,736,5,504,50409,5040903
504090306,"Kabuye",247,272,519,5,504,50409,5040903
504090307,"Ntintyi",264,312,576,5,504,50409,5040903
504090308,"Rugarama",322,349,671,5,504,50409,5040903
504090309,"Ruvumu",439,517,956,5,504,50409,5040903
504090310,"Shirinyota",214,230,444,5,504,50409,5040903
504090401,"Agasharu",324,367,691,5,504,50409,5040904
504090402,"Gatoki",158,183,341,5,504,50409,5040904
504090403,"Kacyiru",365,406,771,5,504,50409,5040904
504090404,"Nyacyonga",621,434,1055,5,504,50409,5040904
504090405,"Nyakagarama",343,416,759,5,504,50409,5040904
504090406,"Rugagi",201,216,417,5,504,50409,5040904
504090407,"Rwangabarezi",187,200,387,5,504,50409,5040904
504090408,"Rwinyana",322,376,698,5,504,50409,5040904
504100101,"Butimba I",363,452,815,5,504,50410,5041001
504100102,"Butimba Ii",229,267,496,5,504,50410,5041001
504100103,"Gakenyeri",366,395,761,5,504,50410,5041001
504100104,"Gitega",274,339,613,5,504,50410,5041001
504100105,"Karama",265,304,569,5,504,50410,5041001
504100106,"Kidogo",377,377,754,5,504,50410,5041001
504100107,"Kinunga ",373,400,773,5,504,50410,5041001
504100108,"Rwempasha",268,295,563,5,504,50410,5041001
504100201,"Butimba",515,592,1107,5,504,50410,5041002
504100202,"Buyonza",344,384,728,5,504,50410,5041002
504100203,"Gitarama",107,125,232,5,504,50410,5041002
504100204,"Ibiza",370,386,756,5,504,50410,5041002
504100205,"Kabuga",326,349,675,5,504,50410,5041002
504100206,"Kamajigija",107,120,227,5,504,50410,5041002
504100207,"Karambo I",306,356,662,5,504,50410,5041002
504100208,"Karambo Ii",233,276,509,5,504,50410,5041002
504100209,"Karubamba",444,423,867,5,504,50410,5041002
504100210,"Kinunga I",443,537,980,5,504,50410,5041002
504100211,"Kinunga Ii",89,111,200,5,504,50410,5041002
504100212,"Mitungo",294,339,633,5,504,50410,5041002
504100213,"Mumuri",264,312,576,5,504,50410,5041002
504100214,"Munyinya",221,263,484,5,504,50410,5041002
504100215,"Muzizi",549,544,1093,5,504,50410,5041002
504100216,"Nyagaharabuge",400,434,834,5,504,50410,5041002
504100217,"Nyirarukara",260,296,556,5,504,50410,5041002
504100218,"Ruyenzi",239,315,554,5,504,50410,5041002
504100301,"Akabare I",311,317,628,5,504,50410,5041003
504100302,"Akabare Ii",359,429,788,5,504,50410,5041003
504100303,"Karagari I",348,397,745,5,504,50410,5041003
504100304,"Karagari Ii",254,336,590,5,504,50410,5041003
504100305,"Kigwene I",371,442,813,5,504,50410,5041003
504100306,"Kigwene Ii",370,423,793,5,504,50410,5041003
504100307,"Kinunga I",200,256,456,5,504,50410,5041003
504100308,"Kinunga Ii",451,442,893,5,504,50410,5041003
504100309,"Mirambi I",356,389,745,5,504,50410,5041003
504100310,"Mirambi Ii",324,369,693,5,504,50410,5041003
504100311,"Mirambi Iii",219,256,475,5,504,50410,5041003
504100312,"Nyarutunga I",315,334,649,5,504,50410,5041003
504100313,"Nyarutunga Ii",267,340,607,5,504,50410,5041003
504110101,"Agasharu",311,343,654,5,504,50411,5041101
504110102,"Agatare",245,287,532,5,504,50411,5041101
504110103,"Amashya",214,257,471,5,504,50411,5041101
504110104,"Buhoro",200,253,453,5,504,50411,5041101
504110105,"Murambi",208,250,458,5,504,50411,5041101
504110201,"Akabarima",308,376,684,5,504,50411,5041102
504110202,"Akarambo",306,310,616,5,504,50411,5041102
504110203,"Cyabitana",196,204,400,5,504,50411,5041102
504110204,"Gitega",346,386,732,5,504,50411,5041102
504110205,"Nyagacyamu",217,262,479,5,504,50411,5041102
504110206,"Sabununga",252,297,549,5,504,50411,5041102
504110207,"Umubuga",275,313,588,5,504,50411,5041102
504110301,"Gisenga",229,269,498,5,504,50411,5041103
504110302,"Gitoki",133,159,292,5,504,50411,5041103
504110303,"Gitwa",204,242,446,5,504,50411,5041103
504110304,"Kabeza",239,258,497,5,504,50411,5041103
504110305,"Kacyiru",200,231,431,5,504,50411,5041103
504110306,"Rukoma",172,246,418,5,504,50411,5041103
504110307,"Taba",280,314,594,5,504,50411,5041103
504110401,"Agasharu",306,386,692,5,504,50411,5041104
504110402,"Akarugina",219,290,509,5,504,50411,5041104
504110403,"Amazinga",289,328,617,5,504,50411,5041104
504110404,"Gitesannyi",133,211,344,5,504,50411,5041104
504110405,"Kabukara",164,170,334,5,504,50411,5041104
504110406,"Kabuye",143,169,312,5,504,50411,5041104
504110407,"Kajembe",212,215,427,5,504,50411,5041104
504110408,"Kamukire",283,334,617,5,504,50411,5041104
504120101,"Akajevuba",258,235,493,5,504,50412,5041201
504120102,"Akayebe",188,222,410,5,504,50412,5041201
504120103,"Gihinga",228,279,507,5,504,50412,5041201
504120104,"Karuhambo",296,360,656,5,504,50412,5041201
504120105,"Migera",314,338,652,5,504,50412,5041201
504120106,"Nyabimuri",146,166,312,5,504,50412,5041201
504120107,"Rubirizi",340,356,696,5,504,50412,5041201
504120108,"Rugunga",251,252,503,5,504,50412,5041201
504120109,"Rusera",155,166,321,5,504,50412,5041201
504120110,"Uburembo",335,358,693,5,504,50412,5041201
504120201,"Gacaca",197,223,420,5,504,50412,5041202
504120202,"Gahushyi",139,165,304,5,504,50412,5041202
504120203,"Kingogo",140,205,345,5,504,50412,5041202
504120204,"Mbarara I",244,302,546,5,504,50412,5041202
504120205,"Mbarara Ii",220,218,438,5,504,50412,5041202
504120206,"Mutembo",329,387,716,5,504,50412,5041202
504120301,"Bishenyi",213,197,410,5,504,50412,5041203
504120302,"Busasamana",197,228,425,5,504,50412,5041203
504120303,"Bwiza",122,128,250,5,504,50412,5041203
504120304,"Dusabane",268,291,559,5,504,50412,5041203
504120305,"Kazeneza",229,276,505,5,504,50412,5041203
504120306,"Kiyovu",299,308,607,5,504,50412,5041203
504120307,"Mahumbezi",176,185,361,5,504,50412,5041203
504120308,"Mutembo",153,185,338,5,504,50412,5041203
504120309,"Nyamabuye",153,199,352,5,504,50412,5041203
504120310,"Nyankora",441,431,872,5,504,50412,5041203
504120311,"Nyarwashama I",129,136,265,5,504,50412,5041203
504120312,"Nyarwashama Ii",100,135,235,5,504,50412,5041203
504120313,"Rebero",190,195,385,5,504,50412,5041203
504120314,"Twibanire",301,302,603,5,504,50412,5041203
504120315,"Twiyunge",108,121,229,5,504,50412,5041203
504120316,"Vungiro",123,151,274,5,504,50412,5041203
504120401,"Burigade",238,221,459,5,504,50412,5041204
504120402,"Byimana",163,186,349,5,504,50412,5041204
504120403,"Gasabo",349,389,738,5,504,50412,5041204
504120404,"Gisozi",275,312,587,5,504,50412,5041204
504120405,"Kinihira",171,199,370,5,504,50412,5041204
504120406,"Matinza",311,345,656,5,504,50412,5041204
504120407,"Muganza",171,200,371,5,504,50412,5041204
504120408,"Nkondo I",296,306,602,5,504,50412,5041204
504120409,"Nkondo Ii",192,211,403,5,504,50412,5041204
504120410,"Nyabihare ",52,56,108,5,504,50412,5041204
504120411,"Rebero",247,279,526,5,504,50412,5041204
504120412,"Rurama",309,341,650,5,504,50412,5041204
504120413,"Rwinkwavu",287,265,552,5,504,50412,5041204
504120414,"Seka",254,283,537,5,504,50412,5041204
505010101,"Cyamabuye",182,195,377,5,505,50501,5050101
505010102,"Cyasusa I",181,192,373,5,505,50501,5050101
505010103,"Cyasusa Ii",112,131,243,5,505,50501,5050101
505010104,"Irama Centre",204,223,427,5,505,50501,5050101
505010105,"Kabeza",140,138,278,5,505,50501,5050101
505010106,"Kijumbura I",152,168,320,5,505,50501,5050101
505010107,"Kijumbura Ii",136,137,273,5,505,50501,5050101
505010108,"Kijumbura Iii",123,150,273,5,505,50501,5050101
505010109,"Kivogera ",185,213,398,5,505,50501,5050101
505010110,"Rwabarimba",109,125,234,5,505,50501,5050101
505010111,"Rwabiyombe",135,157,292,5,505,50501,5050101
505010112,"Rwamabenga",107,146,253,5,505,50501,5050101
505010113,"Rwamuzima",221,254,475,5,505,50501,5050101
505010114,"Samuko",125,112,237,5,505,50501,5050101
505010115,"Umubano I",183,194,377,5,505,50501,5050101
505010116,"Umubano Ii",157,180,337,5,505,50501,5050101
505010201,"Bukorasi",184,221,405,5,505,50501,5050102
505010202,"Cyobaharaye",187,224,411,5,505,50501,5050102
505010203,"Gacaca",156,162,318,5,505,50501,5050102
505010204,"Gasaka",262,222,484,5,505,50501,5050102
505010205,"Gasasa",112,195,307,5,505,50501,5050102
505010206,"Kabeza",147,150,297,5,505,50501,5050102
505010207,"Muhero",233,253,486,5,505,50501,5050102
505010208,"Murama",310,368,678,5,505,50501,5050102
505010209,"Muyange",232,256,488,5,505,50501,5050102
505010210,"Ntaruka",156,198,354,5,505,50501,5050102
505010211,"Nyabitare",114,126,240,5,505,50501,5050102
505010212,"Rusisiro",147,132,279,5,505,50501,5050102
505010301,"Cyasemakamba",306,358,664,5,505,50501,5050103
505010302,"Cyumbati",180,232,412,5,505,50501,5050103
505010303,"Isangano",320,325,645,5,505,50501,5050103
505010304,"Mugogo",219,305,524,5,505,50501,5050103
505010305,"Murama I",374,369,743,5,505,50501,5050103
505010306,"Murama Ii",281,302,583,5,505,50501,5050103
505010307,"Nyakarambi",201,206,407,5,505,50501,5050103
505010308,"Nyamahuna",393,396,789,5,505,50501,5050103
505010309,"Nyamirondogoro",349,327,676,5,505,50501,5050103
505010310,"Nyamugari",178,219,397,5,505,50501,5050103
505010311,"Nyankurazo",158,195,353,5,505,50501,5050103
505010312,"Nyombe",206,243,449,5,505,50501,5050103
505010313,"Village Dagaza",252,276,528,5,505,50501,5050103
505010401,"Cyabihama I",260,328,588,5,505,50501,5050104
505010402,"Cyabihama Ii",180,241,421,5,505,50501,5050104
505010403,"Gakurungo",344,394,738,5,505,50501,5050104
505010404,"Gasarabwayi",201,237,438,5,505,50501,5050104
505010405,"Gashongora",215,301,516,5,505,50501,5050104
505010406,"Iribagiza",157,181,338,5,505,50501,5050104
505010407,"Kabagera",177,198,375,5,505,50501,5050104
505010408,"Kagarama",178,191,369,5,505,50501,5050104
505010409,"Mugatare",167,187,354,5,505,50501,5050104
505010410,"Nyakabimba",226,237,463,5,505,50501,5050104
505010411,"Nyamisagara",249,278,527,5,505,50501,5050104
505010412,"Rugando",204,260,464,5,505,50501,5050104
505010413,"Rugina",223,279,502,5,505,50501,5050104
505010414,"Rusave",236,271,507,5,505,50501,5050104
505010415,"Rwabaseka",197,253,450,5,505,50501,5050104
505010416,"Rwambanda",192,189,381,5,505,50501,5050104
505010501,"Kivogo",213,213,426,5,505,50501,5050105
505010502,"Muguruka I",146,172,318,5,505,50501,5050105
505010503,"Muguruka Ii",224,260,484,5,505,50501,5050105
505010504,"Mukundanya",184,217,401,5,505,50501,5050105
505010505,"Nyagasozi",158,203,361,5,505,50501,5050105
505010506,"Rubira",133,135,268,5,505,50501,5050105
505010507,"Rubumba",186,207,393,5,505,50501,5050105
505010508,"Rurama",234,280,514,5,505,50501,5050105
505010509,"Susuruka",260,256,516,5,505,50501,5050105
505010601,"Agatangaza",239,263,502,5,505,50501,5050106
505010602,"Byimana",265,275,540,5,505,50501,5050106
505010603,"Kanteyamanga",169,178,347,5,505,50501,5050106
505010604,"Kinyonzo I",112,133,245,5,505,50501,5050106
505010605,"Kinyonzo Ii",145,153,298,5,505,50501,5050106
505010606,"Nyagasozi",180,191,371,5,505,50501,5050106
505010607,"Nyakarambi",203,213,416,5,505,50501,5050106
505010608,"Rubira",209,226,435,5,505,50501,5050106
505010609,"Rununga",228,250,478,5,505,50501,5050106
505010610,"Rwakajonge",143,180,323,5,505,50501,5050106
505010611,"Rwamaranga I",193,222,415,5,505,50501,5050106
505010612,"Rwamaranga Ii",238,257,495,5,505,50501,5050106
505010613,"Rwamurema",236,272,508,5,505,50501,5050106
505010614,"Umubogora",230,280,510,5,505,50501,5050106
505020101,"Gatega",310,330,640,5,505,50502,5050201
505020102,"Kigarama",227,245,472,5,505,50502,5050201
505020103,"Mugeruko",185,260,445,5,505,50502,5050201
505020104,"Nyarwogo",164,183,347,5,505,50502,5050201
505020105,"Rugari",342,377,719,5,505,50502,5050201
505020106,"Runyinya",233,243,476,5,505,50502,5050201
505020107,"Rutoma",248,259,507,5,505,50502,5050201
505020201,"Cyunuzi I",503,564,1067,5,505,50502,5050202
505020202,"Cyunuzi Ii",256,365,621,5,505,50502,5050202
505020203,"Gakuyo",324,334,658,5,505,50502,5050202
505020204,"Kabeza",291,326,617,5,505,50502,5050202
505020205,"Kabungo",199,199,398,5,505,50502,5050202
505020206,"Nyagashyanga",209,178,387,5,505,50502,5050202
505020207,"Rurenge",221,254,475,5,505,50502,5050202
505020301,"Kamomo",261,268,529,5,505,50502,5050203
505020302,"Karenge",291,320,611,5,505,50502,5050203
505020303,"Ntungamo",303,350,653,5,505,50502,5050203
505020304,"Nyarusange",163,190,353,5,505,50502,5050203
505020305,"Rebero",361,384,745,5,505,50502,5050203
505020306,"Rwabigaro",255,283,538,5,505,50502,5050203
505020401,"Bwiza",206,244,450,5,505,50502,5050204
505020402,"Gashanga",302,343,645,5,505,50502,5050204
505020403,"Gasharu",105,126,231,5,505,50502,5050204
505020404,"Karambi",309,340,649,5,505,50502,5050204
505020405,"Nyagitongo",201,235,436,5,505,50502,5050204
505020406,"Rubuye",208,220,428,5,505,50502,5050204
505020407,"Rwanyabigaba",241,320,561,5,505,50502,5050204
505020501,"Bitoma I",196,198,394,5,505,50502,5050205
505020502,"Bitoma Ii",203,226,429,5,505,50502,5050205
505020503,"Muyange",114,119,233,5,505,50502,5050205
505020504,"Rugina",278,308,586,5,505,50502,5050205
505020505,"Rurembo I",198,221,419,5,505,50502,5050205
505020506,"Samuko",205,241,446,5,505,50502,5050205
505020507,"Ururembo Ii",334,377,711,5,505,50502,5050205
505020601,"Cyiha",306,311,617,5,505,50502,5050206
505020602,"Karehero",215,225,440,5,505,50502,5050206
505020603,"Karembo",156,188,344,5,505,50502,5050206
505020604,"Kavomo",193,221,414,5,505,50502,5050206
505020605,"Kigarama",329,389,718,5,505,50502,5050206
505020606,"Mitoyi",179,201,380,5,505,50502,5050206
505020607,"Mumeya",367,419,786,5,505,50502,5050206
505020608,"Rubona",180,199,379,5,505,50502,5050206
505020609,"Rusenyi",198,232,430,5,505,50502,5050206
505020610,"Rutare",227,238,465,5,505,50502,5050206
505030101,"Cyanya",211,258,469,5,505,50503,5050301
505030102,"Gakoni",250,308,558,5,505,50503,5050301
505030103,"Kabimba I",287,302,589,5,505,50503,5050301
505030104,"Kabimba Ii",195,204,399,5,505,50503,5050301
505030105,"Kigende",202,184,386,5,505,50503,5050301
505030106,"Nyakavogo",207,217,424,5,505,50503,5050301
505030107,"Nyamikoni",288,291,579,5,505,50503,5050301
505030108,"Nyamirambo I",299,320,619,5,505,50503,5050301
505030109,"Nyamirambo Ii",264,263,527,5,505,50503,5050301
505030110,"Nyarutovu",272,284,556,5,505,50503,5050301
505030111,"Rubare",196,190,386,5,505,50503,5050301
505030201,"Gahindu",254,243,497,5,505,50503,5050302
505030202,"Humure",342,402,744,5,505,50503,5050302
505030203,"Kigarama",261,255,516,5,505,50503,5050302
505030204,"Kiravunga",199,240,439,5,505,50503,5050302
505030205,"Nyakazinga",147,169,316,5,505,50503,5050302
505030206,"Nyamiyaga",229,261,490,5,505,50503,5050302
505030207,"Nyarutojo",226,224,450,5,505,50503,5050302
505030208,"Rugari",223,270,493,5,505,50503,5050302
505030209,"Rurenge",203,234,437,5,505,50503,5050302
505030210,"Samuko",192,206,398,5,505,50503,5050302
505030301,"Bweranka I ",167,184,351,5,505,50503,5050303
505030302,"Bweranka Ii",186,220,406,5,505,50503,5050303
505030303,"Cyanika",211,232,443,5,505,50503,5050303
505030304,"Irama",103,126,229,5,505,50503,5050303
505030305,"Kagane",214,256,470,5,505,50503,5050303
505030306,"Kagorogoro",261,285,546,5,505,50503,5050303
505030307,"Kaguriro",226,254,480,5,505,50503,5050303
505030308,"Karenge I",200,235,435,5,505,50503,5050303
505030309,"Karenge Ii",120,143,263,5,505,50503,5050303
505030310,"Kayirarye",183,189,372,5,505,50503,5050303
505030311,"Kimesho",220,243,463,5,505,50503,5050303
505030312,"Kiremera",207,259,466,5,505,50503,5050303
505030313,"Nyaryenge",246,274,520,5,505,50503,5050303
505030314,"Rwesinge",348,367,715,5,505,50503,5050303
505030315,"Umunezero",229,255,484,5,505,50503,5050303
505030401,"Gasenyi",287,262,549,5,505,50503,5050304
505030402,"Gatari",271,282,553,5,505,50503,5050304
505030403,"Kabare",228,239,467,5,505,50503,5050304
505030404,"Kabuga",223,262,485,5,505,50503,5050304
505030405,"Kiyovu",195,238,433,5,505,50503,5050304
505030406,"Nyabubare",157,179,336,5,505,50503,5050304
505030407,"Ruhandagazi",296,319,615,5,505,50503,5050304
505030408,"Rukiri",225,218,443,5,505,50503,5050304
505030409,"Ryamukaza",126,139,265,5,505,50503,5050304
505030501,"Kabeza",244,246,490,5,505,50503,5050305
505030502,"Kivu",163,196,359,5,505,50503,5050305
505030503,"Marembo",213,256,469,5,505,50503,5050305
505030504,"Nshungerezi",232,247,479,5,505,50503,5050305
505030505,"Nyagahanga",321,335,656,5,505,50503,5050305
505030506,"Nyakabungo",291,347,638,5,505,50503,5050305
505030507,"Nyakigera",175,175,350,5,505,50503,5050305
505030508,"Nyakwisi",157,176,333,5,505,50503,5050305
505030509,"Rama",333,323,656,5,505,50503,5050305
505030510,"Ruhuha",198,268,466,5,505,50503,5050305
505030511,"Rusumo",96,138,234,5,505,50503,5050305
505040101,"Efemu",163,185,348,5,505,50504,5050401
505040102,"Gitaba",182,167,349,5,505,50504,5050401
505040103,"Kabimba",317,295,612,5,505,50504,5050401
505040104,"Kabugwe",171,209,380,5,505,50504,5050401
505040105,"Kanogo",138,144,282,5,505,50504,5050401
505040106,"Kanyabihara",115,120,235,5,505,50504,5050401
505040107,"Nyakizu",162,171,333,5,505,50504,5050401
505040108,"Ruhama",331,362,693,5,505,50504,5050401
505040201,"Isangano",168,214,382,5,505,50504,5050402
505040202,"Kabeza",211,242,453,5,505,50504,5050402
505040203,"Kagega",318,308,626,5,505,50504,5050402
505040204,"Kimeya",169,196,365,5,505,50504,5050402
505040205,"Kubwinteko",210,217,427,5,505,50504,5050402
505040206,"Kukabuga",201,237,438,5,505,50504,5050402
505040207,"Kundengo",158,138,296,5,505,50504,5050402
505040208,"Mubyimana",227,228,455,5,505,50504,5050402
505040209,"Muganza",311,317,628,5,505,50504,5050402
505040210,"Nyagisozi",139,170,309,5,505,50504,5050402
505040211,"Rugando",207,223,430,5,505,50504,5050402
505040212,"Rugarama",174,206,380,5,505,50504,5050402
505040213,"Rujambara",155,206,361,5,505,50504,5050402
505040214,"Rwakanyambo",420,435,855,5,505,50504,5050402
505040301,"Buhwaga",213,212,425,5,505,50504,5050403
505040302,"Kavuzo",226,244,470,5,505,50504,5050403
505040303,"Ku Murenge",245,245,490,5,505,50504,5050403
505040304,"Nyagasozi",174,245,419,5,505,50504,5050403
505040305,"Nyakarambi I",374,344,718,5,505,50504,5050403
505040306,"Nyakarambi Ii",383,382,765,5,505,50504,5050403
505040307,"Nyakibande",115,122,237,5,505,50504,5050403
505040308,"Rebezo",201,202,403,5,505,50504,5050403
505040309,"Rubare",199,264,463,5,505,50504,5050403
505040310,"Rwagasare I",169,198,367,5,505,50504,5050403
505040311,"Rwagasare Ii",198,215,413,5,505,50504,5050403
505040312,"Rwakarinda",234,268,502,5,505,50504,5050403
505040313,"Rwamabare",169,169,338,5,505,50504,5050403
505040314,"Rwamakara",195,233,428,5,505,50504,5050403
505040315,"Rwanyamutara",210,229,439,5,505,50504,5050403
505040401,"Bugarura",347,320,667,5,505,50504,5050404
505040402,"Gasarasi",340,372,712,5,505,50504,5050404
505040403,"Mugisenyi I",165,178,343,5,505,50504,5050404
505040404,"Mugisenyi Ii",276,312,588,5,505,50504,5050404
505040405,"Nyakayaga",198,202,400,5,505,50504,5050404
505040406,"Rusororo",262,283,545,5,505,50504,5050404
505040407,"Rwanteru I",253,236,489,5,505,50504,5050404
505040408,"Rwanteru Ii",542,421,963,5,505,50504,5050404
505050101,"Byimana",119,134,253,5,505,50505,5050501
505050102,"Kabeza",152,165,317,5,505,50505,5050501
505050103,"Kaziba",220,248,468,5,505,50505,5050501
505050104,"Kiyovu",202,252,454,5,505,50505,5050501
505050105,"Muhweza",168,170,338,5,505,50505,5050501
505050106,"Murugarama",124,163,287,5,505,50505,5050501
505050107,"Ntungamo",267,308,575,5,505,50505,5050501
505050108,"Nyakatsi",221,225,446,5,505,50505,5050501
505050109,"Nyamazi",207,195,402,5,505,50505,5050501
505050110,"Rebero",126,119,245,5,505,50505,5050501
505050201,"Agatwa",219,231,450,5,505,50505,5050502
505050202,"Byimana",278,282,560,5,505,50505,5050502
505050203,"Kamasaro",493,529,1022,5,505,50505,5050502
505050204,"Kirehe",291,383,674,5,505,50505,5050502
505050205,"Mirambi",305,315,620,5,505,50505,5050502
505050206,"Runyinya",301,324,625,5,505,50505,5050502
505050301,"Bugarura",140,200,340,5,505,50505,5050503
505050302,"Duterimbere",138,193,331,5,505,50505,5050503
505050303,"Gahuzamiryango",118,134,252,5,505,50505,5050503
505050304,"Kabeza",172,204,376,5,505,50505,5050503
505050305,"Kamuhoza",148,156,304,5,505,50505,5050503
505050306,"Mushirarungu",135,186,321,5,505,50505,5050503
505050307,"Nyarurembo",157,157,314,5,505,50505,5050503
505050308,"Rurenge",157,174,331,5,505,50505,5050503
505050309,"Twizerane",128,125,253,5,505,50505,5050503
505050310,"Vatikani",168,188,356,5,505,50505,5050503
505050401,"Bwiza",368,258,626,5,505,50505,5050504
505050402,"Byimana",148,157,305,5,505,50505,5050504
505050403,"Kaduha",166,206,372,5,505,50505,5050504
505050404,"Karenge",129,148,277,5,505,50505,5050504
505050405,"Kiyovu",143,151,294,5,505,50505,5050504
505050406,"Kwihanika",165,226,391,5,505,50505,5050504
505050407,"Kwirebero",133,143,276,5,505,50505,5050504
505050408,"Mumpinga",95,119,214,5,505,50505,5050504
505050409,"Nyarurembo",120,125,245,5,505,50505,5050504
505050410,"Nyarusange",120,142,262,5,505,50505,5050504
505050411,"Rugenge",97,120,217,5,505,50505,5050504
505050412,"Rugero",199,180,379,5,505,50505,5050504
505050413,"Rurama",171,185,356,5,505,50505,5050504
505050414,"Rusamaza",126,121,247,5,505,50505,5050504
505050415,"Rutonde",137,160,297,5,505,50505,5050504
505050501,"Bengazi",158,175,333,5,505,50505,5050505
505050502,"Byimana",122,129,251,5,505,50505,5050505
505050503,"Gahama",243,270,513,5,505,50505,5050505
505050504,"Kabeza",121,140,261,5,505,50505,5050505
505050505,"Karuhura",156,180,336,5,505,50505,5050505
505050506,"Kumunini",256,307,563,5,505,50505,5050505
505050507,"Rwabikweto",151,162,313,5,505,50505,5050505
505050508,"Rwesero",274,299,573,5,505,50505,5050505
505060101,"Amahoro",202,238,440,5,505,50506,5050601
505060102,"Bwiza",250,254,504,5,505,50506,5050601
505060103,"Byimana",130,154,284,5,505,50506,5050601
505060104,"Kabuga",258,278,536,5,505,50506,5050601
505060105,"Kamabuye",156,193,349,5,505,50506,5050601
505060106,"Kamato",118,109,227,5,505,50506,5050601
505060107,"Kamombo",213,247,460,5,505,50506,5050601
505060108,"Kigongi",275,248,523,5,505,50506,5050601
505060109,"Kigufi",269,284,553,5,505,50506,5050601
505060110,"Rumuri",294,300,594,5,505,50506,5050601
505060111,"Terimbere",294,344,638,5,505,50506,5050601
505060112,"Umubano",310,327,637,5,505,50506,5050601
505060201,"Buhaga",184,206,390,5,505,50506,5050602
505060202,"Cyanika",221,217,438,5,505,50506,5050602
505060203,"Gisanze",212,211,423,5,505,50506,5050602
505060204,"Isangano",210,199,409,5,505,50506,5050602
505060205,"Kwisha",331,430,761,5,505,50506,5050602
505060206,"Mwoga",283,280,563,5,505,50506,5050602
505060207,"Nyarusange",279,337,616,5,505,50506,5050602
505060301,"Gisenyi",271,274,545,5,505,50506,5050603
505060302,"Kanombe",321,335,656,5,505,50506,5050603
505060303,"Karebezo",278,272,550,5,505,50506,5050603
505060304,"Muride",331,341,672,5,505,50506,5050603
505060305,"Nyagahanga",200,237,437,5,505,50506,5050603
505060306,"Nyamiyumbo",292,310,602,5,505,50506,5050603
505060307,"Rushonga",258,260,518,5,505,50506,5050603
505060308,"Saruhembe",270,326,596,5,505,50506,5050603
505060401,"Ihuriro",197,197,394,5,505,50506,5050604
505060402,"Kabeza",204,207,411,5,505,50506,5050604
505060403,"Kagera",135,150,285,5,505,50506,5050604
505060404,"Karambi",159,176,335,5,505,50506,5050604
505060405,"Munini",401,406,807,5,505,50506,5050604
505060406,"Nyenyeri",209,237,446,5,505,50506,5050604
505060407,"Rebero",191,194,385,5,505,50506,5050604
505060408,"Remanyundo",277,299,576,5,505,50506,5050604
505060409,"Rugarama",210,199,409,5,505,50506,5050604
505060410,"Ruhondo",270,304,574,5,505,50506,5050604
505070101,"Bihembe",230,222,452,5,505,50507,5050701
505070102,"Cyimparage",202,208,410,5,505,50507,5050701
505070103,"Gisenyi",355,407,762,5,505,50507,5050701
505070104,"Kacyiru",174,210,384,5,505,50507,5050701
505070105,"Kamarashavu",125,123,248,5,505,50507,5050701
505070106,"Kangarame",247,242,489,5,505,50507,5050701
505070107,"Nyagasenyi",212,218,430,5,505,50507,5050701
505070108,"Nyakabande",190,228,418,5,505,50507,5050701
505070109,"Ruhama",187,235,422,5,505,50507,5050701
505070201,"Kankobwa",182,187,369,5,505,50507,5050702
505070202,"Murundi",287,320,607,5,505,50507,5050702
505070203,"Nyamiyaga",268,310,578,5,505,50507,5050702
505070204,"Remera",376,404,780,5,505,50507,5050702
505070205,"Rusha",245,323,568,5,505,50507,5050702
505070301,"Kabuye I",2119,262,2381,5,505,50507,5050703
505070302,"Kabuye Ii",247,315,562,5,505,50507,5050703
505070303,"Mpanga",252,297,549,5,505,50507,5050703
505070304,"Nyagatovu",237,269,506,5,505,50507,5050703
505070305,"Rurambi I",287,283,570,5,505,50507,5050703
505070306,"Rurambi Ii",247,247,494,5,505,50507,5050703
505070401,"Gitoma",241,228,469,5,505,50507,5050704
505070402,"Kayanga",284,282,566,5,505,50507,5050704
505070403,"Mishenyi",220,256,476,5,505,50507,5050704
505070404,"Mushongi ",277,295,572,5,505,50507,5050704
505070405,"Ngugu I",204,205,409,5,505,50507,5050704
505070406,"Ngugu Ii",188,180,368,5,505,50507,5050704
505070501,"Agasasa",256,273,529,5,505,50507,5050705
505070502,"Busasamana I",251,245,496,5,505,50507,5050705
505070503,"Busasamana Ii",203,229,432,5,505,50507,5050705
505070504,"Ibanda",275,236,511,5,505,50507,5050705
505070505,"Mutwe",288,275,563,5,505,50507,5050705
505070506,"Nyabubare I",231,258,489,5,505,50507,5050705
505070507,"Nyabubare Ii",239,247,486,5,505,50507,5050705
505070508,"Nyawera I",191,217,408,5,505,50507,5050705
505070509,"Nyawera Ii",186,208,394,5,505,50507,5050705
505070510,"Pilote",362,376,738,5,505,50507,5050705
505070601,"Cyamuhabura",199,208,407,5,505,50507,5050706
505070602,"Gikushya",288,340,628,5,505,50507,5050706
505070603,"Gitega",243,272,515,5,505,50507,5050706
505070604,"Isenga",146,162,308,5,505,50507,5050706
505070605,"Kabuga",143,174,317,5,505,50507,5050706
505070606,"Nyagatovu",225,279,504,5,505,50507,5050706
505070607,"Nyakabungo",303,352,655,5,505,50507,5050706
505070608,"Rudandi",201,237,438,5,505,50507,5050706
505070609,"Rushenyi",267,266,533,5,505,50507,5050706
505070701,"Akinzuki",179,188,367,5,505,50507,5050707
505070702,"Byimana",247,290,537,5,505,50507,5050707
505070703,"Gacenshero",218,233,451,5,505,50507,5050707
505070704,"Kabeza",261,280,541,5,505,50507,5050707
505070705,"Mumpinga",147,155,302,5,505,50507,5050707
505070706,"Murambi",255,307,562,5,505,50507,5050707
505070707,"Rubaya",233,243,476,5,505,50507,5050707
505070708,"Rukonji",204,249,453,5,505,50507,5050707
505070709,"Rushonga",228,211,439,5,505,50507,5050707
505080101,"Gasarabwayi",382,362,744,5,505,50508,5050801
505080102,"Gicuma",266,314,580,5,505,50508,5050801
505080103,"Kanyosha",189,195,384,5,505,50508,5050801
505080104,"Nyakariba I",153,162,315,5,505,50508,5050801
505080105,"Nyakariba Ii",280,305,585,5,505,50508,5050801
505080106,"Nyakiriba",146,127,273,5,505,50508,5050801
505080107,"Rukumba",153,171,324,5,505,50508,5050801
505080108,"Rwinyundo",141,158,299,5,505,50508,5050801
505080201,"Gikenke",271,317,588,5,505,50508,5050802
505080202,"Kabuga",317,348,665,5,505,50508,5050802
505080203,"Kagasa",163,188,351,5,505,50508,5050802
505080204,"Kambwire",347,369,716,5,505,50508,5050802
505080205,"Kimeya",305,342,647,5,505,50508,5050802
505080206,"Nyamugari",278,373,651,5,505,50508,5050802
505080207,"Rubuye I",299,339,638,5,505,50508,5050802
505080208,"Rubuye Ii",179,203,382,5,505,50508,5050802
505080209,"Rugango",117,154,271,5,505,50508,5050802
505080210,"Rwamurema",300,354,654,5,505,50508,5050802
505080301,"Kanogo",233,268,501,5,505,50508,5050803
505080302,"Kanombe",387,466,853,5,505,50508,5050803
505080303,"Kiyovu",280,314,594,5,505,50508,5050803
505080304,"Mubuga",134,159,293,5,505,50508,5050803
505080305,"Runyinya",205,260,465,5,505,50508,5050803
505080306,"Rwamuhazi",178,194,372,5,505,50508,5050803
505080307,"Ryabega",274,287,561,5,505,50508,5050803
505080308,"Ryarugazi",257,309,566,5,505,50508,5050803
505080401,"Gatwe I",230,279,509,5,505,50508,5050804
505080402,"Gatwe Ii",244,257,501,5,505,50508,5050804
505080403,"Kanyinya I",211,277,488,5,505,50508,5050804
505080404,"Kanyinya Ii",150,142,292,5,505,50508,5050804
505080405,"Musaza ",222,225,447,5,505,50508,5050804
505080406,"Muyoka",364,463,827,5,505,50508,5050804
505080407,"Nyakariba",274,303,577,5,505,50508,5050804
505080501,"Gacuba I",161,183,344,5,505,50508,5050805
505080502,"Gacuba Ii",94,95,189,5,505,50508,5050805
505080503,"Kamagare",130,141,271,5,505,50508,5050805
505080504,"Kaziba",248,280,528,5,505,50508,5050805
505080505,"Murura",129,134,263,5,505,50508,5050805
505080506,"Nganda",190,220,410,5,505,50508,5050805
505080507,"Nganda Ville I",181,180,361,5,505,50508,5050805
505080508,"Nganda Ville Ii",125,136,261,5,505,50508,5050805
505080509,"Nyamiyaga",311,330,641,5,505,50508,5050805
505080510,"Ruseke",130,151,281,5,505,50508,5050805
505080511,"Rwabugagara",141,149,290,5,505,50508,5050805
505080512,"Rwamushongore",168,177,345,5,505,50508,5050805
505090101,"Bingaro",281,284,565,5,505,50509,5050901
505090102,"Bisagara",209,239,448,5,505,50509,5050901
505090103,"Isangano",185,217,402,5,505,50509,5050901
505090104,"Kampara",193,253,446,5,505,50509,5050901
505090105,"Nkoyoyo",300,290,590,5,505,50509,5050901
505090106,"Nyabubare",192,197,389,5,505,50509,5050901
505090107,"Nyakabande",188,193,381,5,505,50509,5050901
505090108,"Ruturamigina",175,218,393,5,505,50509,5050901
505090109,"Umunini",166,206,372,5,505,50509,5050901
505090110,"Umutuzo",395,444,839,5,505,50509,5050901
505090111,"Umuyange",367,400,767,5,505,50509,5050901
505090201,"Bwiza",139,133,272,5,505,50509,5050902
505090202,"Impara",135,142,277,5,505,50509,5050902
505090203,"Isangano",121,118,239,5,505,50509,5050902
505090204,"Kamasare",155,162,317,5,505,50509,5050902
505090205,"Karenge",165,200,365,5,505,50509,5050902
505090206,"Kigarama",192,247,439,5,505,50509,5050902
505090207,"Nyamabuye",125,124,249,5,505,50509,5050902
505090208,"Rusenyi",149,138,287,5,505,50509,5050902
505090301,"Birengero",133,144,277,5,505,50509,5050903
505090302,"Bugarura",132,119,251,5,505,50509,5050903
505090303,"Cyanjuna ",177,141,318,5,505,50509,5050903
505090304,"Cyanyamisa",129,144,273,5,505,50509,5050903
505090305,"Gahushyi",133,157,290,5,505,50509,5050903
505090306,"Kacyiru",103,137,240,5,505,50509,5050903
505090307,"Kamarashavu",163,178,341,5,505,50509,5050903
505090308,"Kamunyana",227,243,470,5,505,50509,5050903
505090309,"Karambi",173,184,357,5,505,50509,5050903
505090310,"Nyagatugunda",126,114,240,5,505,50509,5050903
505090311,"Nyagitongo",150,157,307,5,505,50509,5050903
505090312,"Rutare",156,178,334,5,505,50509,5050903
505090313,"Rwamunana",150,170,320,5,505,50509,5050903
505090314,"Ryogire",103,141,244,5,505,50509,5050903
505090315,"Tomi",100,132,232,5,505,50509,5050903
505090401,"Bweramana",128,151,279,5,505,50509,5050904
505090402,"Cyaka",120,152,272,5,505,50509,5050904
505090403,"Cyeru",125,117,242,5,505,50509,5050904
505090404,"Humure",149,132,281,5,505,50509,5050904
505090405,"Mugina",113,124,237,5,505,50509,5050904
505090406,"Munini",141,162,303,5,505,50509,5050904
505090407,"Nterere",140,160,300,5,505,50509,5050904
505090408,"Nyagateme",92,117,209,5,505,50509,5050904
505090409,"Nyaruhanga",127,148,275,5,505,50509,5050904
505090410,"Rubimba",154,174,328,5,505,50509,5050904
505090411,"Rutare",105,109,214,5,505,50509,5050904
505090412,"Rutoma",160,173,333,5,505,50509,5050904
505090413,"Sake",114,148,262,5,505,50509,5050904
505090501,"Barisuka",291,334,625,5,505,50509,5050905
505090502,"Birembo",119,144,263,5,505,50509,5050905
505090503,"Isangano",154,197,351,5,505,50509,5050905
505090504,"Kabeza",259,315,574,5,505,50509,5050905
505090505,"Kabuga",373,416,789,5,505,50509,5050905
505090506,"Nyakabande",106,126,232,5,505,50509,5050905
505090507,"Nyungwe",172,212,384,5,505,50509,5050905
505090508,"Rukira",305,319,624,5,505,50509,5050905
505090509,"Rusumo",309,384,693,5,505,50509,5050905
505090510,"Rwahenge",223,271,494,5,505,50509,5050905
505090511,"Rwakabandama",181,182,363,5,505,50509,5050905
505090512,"Rwayikona",188,208,396,5,505,50509,5050905
505090513,"Tonero",310,336,646,5,505,50509,5050905
505100101,"Gicaca",255,252,507,5,505,50510,5051001
505100102,"Kagamba",334,372,706,5,505,50510,5051001
505100103,"Kagese I",332,373,705,5,505,50510,5051001
505100104,"Nyakazinga",372,413,785,5,505,50510,5051001
505100105,"Rugwiro",166,163,329,5,505,50510,5051001
505100106,"Rukono",258,270,528,5,505,50510,5051001
505100107,"Rushoka",287,409,696,5,505,50510,5051001
505100108,"Rwinyange",342,355,697,5,505,50510,5051001
505100201,"Gatunguru",274,290,564,5,505,50510,5051002
505100202,"Kagese Ii",235,269,504,5,505,50510,5051002
505100203,"Kanamira",162,153,315,5,505,50510,5051002
505100204,"Kibimba",338,381,719,5,505,50510,5051002
505100205,"Mitsindo",214,214,428,5,505,50510,5051002
505100206,"Murehe",228,253,481,5,505,50510,5051002
505100207,"Nyabimuri",201,235,436,5,505,50510,5051002
505100301,"Gashasha",186,229,415,5,505,50510,5051003
505100302,"Kabusunzu",230,261,491,5,505,50510,5051003
505100303,"Karenge Ii",178,167,345,5,505,50510,5051003
505100304,"Nyabihara",155,172,327,5,505,50510,5051003
505100305,"Nyagasozi",361,388,749,5,505,50510,5051003
505100306,"Nyamurindira",148,166,314,5,505,50510,5051003
505100307,"Ruhema",202,248,450,5,505,50510,5051003
505100308,"Ruseke",292,352,644,5,505,50510,5051003
505100309,"Rwamuhigi",239,284,523,5,505,50510,5051003
505100401,"Kabigembe I",198,199,397,5,505,50510,5051004
505100402,"Kabigembe Ii",214,234,448,5,505,50510,5051004
505100403,"Kadamu",347,410,757,5,505,50510,5051004
505100404,"Karenge I",432,445,877,5,505,50510,5051004
505100405,"Masizi",550,588,1138,5,505,50510,5051004
505100406,"Mulindi",475,520,995,5,505,50510,5051004
505100407,"Nyabiyenzi ",231,251,482,5,505,50510,5051004
505100408,"Rwandarushya I",222,258,480,5,505,50510,5051004
505100409,"Rwandarushya Ii",228,281,509,5,505,50510,5051004
505100501,"Gashiru",208,236,444,5,505,50510,5051005
505100502,"Gatarama",133,131,264,5,505,50510,5051005
505100503,"Gatare",372,408,780,5,505,50510,5051005
505100504,"Kabigembe",426,400,826,5,505,50510,5051005
505100505,"Kageyo",227,238,465,5,505,50510,5051005
505100506,"Karama",155,175,330,5,505,50510,5051005
505100507,"Karubare",172,187,359,5,505,50510,5051005
505100508,"Rebezo",186,224,410,5,505,50510,5051005
505100509,"Rugoma",231,211,442,5,505,50510,5051005
505110101,"Bukinanyana",380,421,801,5,505,50511,5051101
505110102,"Bukora",126,146,272,5,505,50511,5051101
505110103,"Busasamana",191,173,364,5,505,50511,5051101
505110104,"Bweramana",186,197,383,5,505,50511,5051101
505110105,"Kabuga",211,228,439,5,505,50511,5051101
505110106,"Maranyundo",137,167,304,5,505,50511,5051101
505110107,"Mudahunga",258,264,522,5,505,50511,5051101
505110108,"Mumararungu",198,227,425,5,505,50511,5051101
505110109,"Mushirarungu",215,243,458,5,505,50511,5051101
505110110,"Mwima",258,269,527,5,505,50511,5051101
505110111,"Nyabiyenzi",193,207,400,5,505,50511,5051101
505110112,"Remanyundo",142,147,289,5,505,50511,5051101
505110201,"Bwiza",242,273,515,5,505,50511,5051102
505110202,"Ituze",279,330,609,5,505,50511,5051102
505110203,"Kagasa",333,325,658,5,505,50511,5051102
505110204,"Kamabuye",252,295,547,5,505,50511,5051102
505110205,"Kameya",203,214,417,5,505,50511,5051102
505110206,"Mataba",331,351,682,5,505,50511,5051102
505110207,"Nyabayama",305,343,648,5,505,50511,5051102
505110208,"Nyakariba",312,307,619,5,505,50511,5051102
505110209,"Nyamirama",357,371,728,5,505,50511,5051102
505110210,"Nyarurembo",272,230,502,5,505,50511,5051102
505110211,"Rebero",409,428,837,5,505,50511,5051102
505110212,"Urugwiro",285,330,615,5,505,50511,5051102
505110301,"Amahoro",200,206,406,5,505,50511,5051103
505110302,"Byimana",190,202,392,5,505,50511,5051103
505110303,"Gahomvu",270,271,541,5,505,50511,5051103
505110304,"Gasabo",221,224,445,5,505,50511,5051103
505110305,"Gasetsa",161,206,367,5,505,50511,5051103
505110306,"Gashanga",217,264,481,5,505,50511,5051103
505110307,"Jyambere",213,215,428,5,505,50511,5051103
505110308,"Kabwayi",204,195,399,5,505,50511,5051103
505110309,"Mucyo",240,282,522,5,505,50511,5051103
505110310,"Nyenyeri",234,264,498,5,505,50511,5051103
505110311,"Tetero",223,268,491,5,505,50511,5051103
505110312,"Ururembo",190,224,414,5,505,50511,5051103
505110401,"Kabungeri",253,255,508,5,505,50511,5051104
505110402,"Kabuye",200,235,435,5,505,50511,5051104
505110403,"Kacyiru",230,180,410,5,505,50511,5051104
505110404,"Kagera",307,315,622,5,505,50511,5051104
505110405,"Kamarashavu",265,280,545,5,505,50511,5051104
505110406,"Karambi",152,156,308,5,505,50511,5051104
505110407,"Karehe",246,318,564,5,505,50511,5051104
505110408,"Karembo",247,248,495,5,505,50511,5051104
505110409,"Kinamba",134,151,285,5,505,50511,5051104
505110410,"Matare",179,208,387,5,505,50511,5051104
505110411,"Mitako",246,282,528,5,505,50511,5051104
505110412,"Murambi",254,285,539,5,505,50511,5051104
505110413,"Muyinza",336,361,697,5,505,50511,5051104
505110414,"Nyarwamura",287,306,593,5,505,50511,5051104
505110415,"Remera",161,152,313,5,505,50511,5051104
505110416,"Rusumo",97,76,173,5,505,50511,5051104
505110501,"Amahoro",136,179,315,5,505,50511,5051105
505110502,"Gasenyi",85,81,166,5,505,50511,5051105
505110503,"Ihuriro",254,214,468,5,505,50511,5051105
505110504,"Isangano",140,156,296,5,505,50511,5051105
505110505,"Kabeza",172,180,352,5,505,50511,5051105
505110506,"Kamugarura",106,139,245,5,505,50511,5051105
505110507,"Kimigisha",99,111,210,5,505,50511,5051105
505110508,"Munini",104,135,239,5,505,50511,5051105
505110509,"Muramba",105,132,237,5,505,50511,5051105
505110510,"Nyagahama",98,117,215,5,505,50511,5051105
505110511,"Nyamugari Centre",141,139,280,5,505,50511,5051105
505110512,"Rama",86,103,189,5,505,50511,5051105
505110513,"Rebero",128,134,262,5,505,50511,5051105
505110514,"Rurembo",98,116,214,5,505,50511,5051105
505110515,"Rusozi",128,139,267,5,505,50511,5051105
505110516,"Ubumwe",108,118,226,5,505,50511,5051105
505110517,"Umubano",95,132,227,5,505,50511,5051105
505110518,"Umunezero",135,157,292,5,505,50511,5051105
505120101,"Burembo",226,308,534,5,505,50512,5051201
505120102,"Kaziba I",232,248,480,5,505,50512,5051201
505120103,"Kaziba Ii",185,223,408,5,505,50512,5051201
505120104,"Nyacyonga I",278,296,574,5,505,50512,5051201
505120105,"Nyacyonga Ii",197,205,402,5,505,50512,5051201
505120106,"Nyamateke",338,378,716,5,505,50512,5051201
505120107,"Rurenge I",140,150,290,5,505,50512,5051201
505120108,"Rurenge Ii",155,214,369,5,505,50512,5051201
505120201,"Bicumbi",288,320,608,5,505,50512,5051202
505120202,"Kazizi ",64,105,169,5,505,50512,5051202
505120203,"Kazizi Ii",111,130,241,5,505,50512,5051202
505120204,"Mpanguhe",288,353,641,5,505,50512,5051202
505120205,"Ndabarekuye",201,231,432,5,505,50512,5051202
505120206,"Nyabayama",420,421,841,5,505,50512,5051202
505120207,"Nyabitare",228,323,551,5,505,50512,5051202
505120208,"Nyamisagara",266,289,555,5,505,50512,5051202
505120209,"Nyamugari",258,327,585,5,505,50512,5051202
505120210,"Rugarama",303,357,660,5,505,50512,5051202
505120211,"Rwamagana",197,241,438,5,505,50512,5051202
505120301,"Akirondo",225,14,239,5,505,50512,5051203
505120302,"Bugarura",319,331,650,5,505,50512,5051203
505120303,"Kagabiro",233,255,488,5,505,50512,5051203
505120304,"Kagorogoro",188,220,408,5,505,50512,5051203
505120305,"Nkakwa",136,166,302,5,505,50512,5051203
505120306,"Nyakanazi",284,288,572,5,505,50512,5051203
505120307,"Nyarubuye I",214,223,437,5,505,50512,5051203
505120308,"Nyarubuye Ii",169,179,348,5,505,50512,5051203
505120309,"Nyarutunga",308,324,632,5,505,50512,5051203
505120310,"Remera",297,279,576,5,505,50512,5051203
505120311,"Rubare",169,187,356,5,505,50512,5051203
505120312,"Rutunga",345,302,647,5,505,50512,5051203
506010101,"Cyerwa",219,259,478,5,506,50601,5060101
506010102,"Gako",273,312,585,5,506,50601,5060101
506010103,"Mizibiri",283,270,553,5,506,50601,5060101
506010104,"Muyange",227,242,469,5,506,50601,5060101
506010105,"Nyamugali",200,240,440,5,506,50601,5060101
506010106,"Ruyema I",148,179,327,5,506,50601,5060101
506010107,"Ruyema Ii",211,254,465,5,506,50601,5060101
506010201,"Kibimba",140,161,301,5,506,50601,5060102
506010202,"Murambi",261,275,536,5,506,50601,5060102
506010203,"Nyagitabire",190,191,381,5,506,50601,5060102
506010204,"Rubambantare",318,407,725,5,506,50601,5060102
506010205,"Rwambohero",337,354,691,5,506,50601,5060102
506010206,"Rwanyamigono",483,274,757,5,506,50601,5060102
506010301,"Gakuto",230,300,530,5,506,50601,5060103
506010302,"Kanege",267,335,602,5,506,50601,5060103
506010303,"Nyagasenga",264,305,569,5,506,50601,5060103
506010304,"Rugarama",150,181,331,5,506,50601,5060103
506010401,"Cyanama",211,221,432,5,506,50601,5060104
506010402,"Gisenyi",177,172,349,5,506,50601,5060104
506010403,"Kanyinya",392,423,815,5,506,50601,5060104
506010404,"Kirundo",250,279,529,5,506,50601,5060104
506010405,"Nyakarambo",194,185,379,5,506,50601,5060104
506010406,"Nyamasare",290,318,608,5,506,50601,5060104
506010407,"Rwakavuna",212,227,439,5,506,50601,5060104
506010408,"Rwinkuba",180,235,415,5,506,50601,5060104
506010409,"Ryangiriye",175,202,377,5,506,50601,5060104
506020101,"Irebero",335,359,694,5,506,50602,5060201
506020102,"Kabonero",250,233,483,5,506,50602,5060201
506020103,"Kamapfizi",392,462,854,5,506,50602,5060201
506020104,"Kivugiza",274,307,581,5,506,50602,5060201
506020105,"Nyamugari",469,478,947,5,506,50602,5060201
506020106,"Umuka",254,309,563,5,506,50602,5060201
506020201,"Abiyunze",272,299,571,5,506,50602,5060202
506020202,"Akabeza",276,305,581,5,506,50602,5060202
506020203,"Dufatanye",309,346,655,5,506,50602,5060202
506020204,"Duterimbere",294,361,655,5,506,50602,5060202
506020205,"Irarire",271,339,610,5,506,50602,5060202
506020206,"Twizerane",332,356,688,5,506,50602,5060202
506020207,"Ubumwe",231,277,508,5,506,50602,5060202
506020301,"Akabuga",142,183,325,5,506,50602,5060203
506020302,"Akagoma",198,222,420,5,506,50602,5060203
506020303,"Akajevuba",161,176,337,5,506,50602,5060203
506020304,"Gisoko",162,195,357,5,506,50602,5060203
506020305,"Kanombe",161,206,367,5,506,50602,5060203
506020306,"Karenge",114,112,226,5,506,50602,5060203
506020307,"Kavumu",181,201,382,5,506,50602,5060203
506020308,"Korandebe",130,176,306,5,506,50602,5060203
506020309,"Nyamirambo",173,161,334,5,506,50602,5060203
506020310,"Nyarurembo",192,201,393,5,506,50602,5060203
506020311,"Rusenyi",104,152,256,5,506,50602,5060203
506020312,"Shirinyota",177,215,392,5,506,50602,5060203
506020401,"Akabira",163,189,352,5,506,50602,5060204
506020402,"Akaziba",201,222,423,5,506,50602,5060204
506020403,"Cyahafi",221,255,476,5,506,50602,5060204
506020404,"Ibabiri",198,249,447,5,506,50602,5060204
506020405,"Murama",221,271,492,5,506,50602,5060204
506020406,"Uruhuha",189,199,388,5,506,50602,5060204
506020407,"Urukomo",149,192,341,5,506,50602,5060204
506020501,"Icyurusambu",193,214,407,5,506,50602,5060205
506020502,"Iramiro",264,301,565,5,506,50602,5060205
506020503,"Kigoma",361,383,744,5,506,50602,5060205
506020504,"Meraneza",345,282,627,5,506,50602,5060205
506020505,"Mubaha",272,284,556,5,506,50602,5060205
506020506,"Ramba",169,175,344,5,506,50602,5060205
506020507,"Remera",207,219,426,5,506,50602,5060205
506020508,"Vunga",307,326,633,5,506,50602,5060205
506030101,"Impinga",131,127,258,5,506,50603,5060301
506030102,"Iperu",131,143,274,5,506,50603,5060301
506030103,"Kukabeza",160,212,372,5,506,50603,5060301
506030104,"Ngara",228,278,506,5,506,50603,5060301
506030105,"Nyagasozi",169,183,352,5,506,50603,5060301
506030106,"Rubumba",223,224,447,5,506,50603,5060301
506030107,"Rukizi",94,123,217,5,506,50603,5060301
506030108,"Rurenge",135,154,289,5,506,50603,5060301
506030109,"Rwamuhimbura",264,335,599,5,506,50603,5060301
506030110,"Umusebeya",136,156,292,5,506,50603,5060301
506030111,"Umuyange",125,157,282,5,506,50603,5060301
506030201,"Kigobe",302,316,618,5,506,50603,5060302
506030202,"Mungoro",322,340,662,5,506,50603,5060302
506030203,"Rusumbantwari",402,420,822,5,506,50603,5060302
506030204,"Umurehe",275,311,586,5,506,50603,5060302
506030205,"Urutare",244,284,528,5,506,50603,5060302
506030301,"Gashekasheke I",239,270,509,5,506,50603,5060303
506030302,"Gashekasheke Ii",225,258,483,5,506,50603,5060303
506030303,"Gitaraga",166,225,391,5,506,50603,5060303
506030304,"Kanama",325,371,696,5,506,50603,5060303
506030305,"Karibu",283,337,620,5,506,50603,5060303
506030306,"Kivugangoma I",268,329,597,5,506,50603,5060303
506030307,"Kivugangoma Ii",176,174,350,5,506,50603,5060303
506030308,"Mumahoro",182,203,385,5,506,50603,5060303
506030309,"Murambi",216,285,501,5,506,50603,5060303
506030310,"Rwakayango",290,312,602,5,506,50603,5060303
506040101,"Gahondo",540,590,1130,5,506,50604,5060401
506040102,"Karisizo",566,647,1213,5,506,50604,5060401
506040103,"Murindwa",487,592,1079,5,506,50604,5060401
506040104,"Murusenyi",441,464,905,5,506,50604,5060401
506040105,"Nyakagezi",287,345,632,5,506,50604,5060401
506040201,"Itambiro",561,662,1223,5,506,50604,5060402
506040202,"Rebero",380,432,812,5,506,50604,5060402
506040203,"Rugenge",402,460,862,5,506,50604,5060402
506040204,"Umuyange",405,473,878,5,506,50604,5060402
506040301,"Kabimba",195,246,441,5,506,50604,5060403
506040302,"Kagusa",316,384,700,5,506,50604,5060403
506040303,"Karenge",205,269,474,5,506,50604,5060403
506040304,"Mpandu",762,835,1597,5,506,50604,5060403
506040305,"Rango",544,619,1163,5,506,50604,5060403
506040401,"Amabumba",425,470,895,5,506,50604,5060404
506040402,"Kibimba",695,741,1436,5,506,50604,5060404
506040403,"Rugarama",609,696,1305,5,506,50604,5060404
506040404,"Tunduti",521,610,1131,5,506,50604,5060404
506040501,"Akabaya",404,498,902,5,506,50604,5060405
506040502,"Kagarama",219,276,495,5,506,50604,5060405
506040503,"Kazo",409,414,823,5,506,50604,5060405
506040504,"Umukamba",413,406,819,5,506,50604,5060405
506050101,"Amarembo",744,497,1241,5,506,50605,5060501
506050102,"Bwiza",390,398,788,5,506,50605,5060501
506050103,"Gatoro",180,187,367,5,506,50605,5060501
506050104,"Kabeza",396,386,782,5,506,50605,5060501
506050105,"Kiruhura",385,384,769,5,506,50605,5060501
506050106,"Rubimba",746,806,1552,5,506,50605,5060501
506050201,"Gasoro",246,287,533,5,506,50605,5060502
506050202,"Karenge",388,424,812,5,506,50605,5060502
506050203,"Kazeneza",302,339,641,5,506,50605,5060502
506050204,"Nyamigina",196,263,459,5,506,50605,5060502
506050205,"Rutovu",291,286,577,5,506,50605,5060502
506050206,"Rwamihuro",234,245,479,5,506,50605,5060502
506050301,"Karungu",342,418,760,5,506,50605,5060503
506050302,"Misange",274,306,580,5,506,50605,5060503
506050303,"Nyagakizi",255,264,519,5,506,50605,5060503
506050304,"Nyagatovu",365,444,809,5,506,50605,5060503
506050305,"Nyakabungo",319,314,633,5,506,50605,5060503
506050306,"Rubona",202,228,430,5,506,50605,5060503
506050401,"Amahoro",3004,780,3784,5,506,50605,5060504
506050402,"Gatare",672,223,895,5,506,50605,5060504
506050403,"Ihuriro",229,226,455,5,506,50605,5060504
506050404,"Isangano",519,566,1085,5,506,50605,5060504
506050405,"Kabeza",392,439,831,5,506,50605,5060504
506050406,"Musamvu",685,750,1435,5,506,50605,5060504
506050407,"Ubumwe",287,302,589,5,506,50605,5060504
506050501,"Gisaka",383,440,823,5,506,50605,5060505
506050502,"Kabimba",362,442,804,5,506,50605,5060505
506050503,"Kacyiru",221,252,473,5,506,50605,5060505
506050504,"Karambi",340,341,681,5,506,50605,5060505
506050505,"Rebezo",221,263,484,5,506,50605,5060505
506050506,"Ruhinga",202,228,430,5,506,50605,5060505
506060101,"Agakindo",386,455,841,5,506,50606,5060601
506060102,"Akabingo",435,484,919,5,506,50606,5060601
506060103,"Kinihira",326,340,666,5,506,50606,5060601
506060104,"Nyamirambo",367,406,773,5,506,50606,5060601
506060105,"Rugarama",367,435,802,5,506,50606,5060601
506060106,"Rurenge",225,297,522,5,506,50606,5060601
506060107,"Rwinkwavu",354,445,799,5,506,50606,5060601
506060201,"Icocorero",322,359,681,5,506,50606,5060602
506060202,"Ikibinge",402,448,850,5,506,50606,5060602
506060203,"Isangano",236,232,468,5,506,50606,5060602
506060204,"Kampara",268,305,573,5,506,50606,5060602
506060205,"Kumunini",255,292,547,5,506,50606,5060602
506060206,"Kumuyange",272,310,582,5,506,50606,5060602
506060207,"Mumurenge",246,293,539,5,506,50606,5060602
506060208,"Rwamenyo",273,291,564,5,506,50606,5060602
506060301,"Akabande",228,255,483,5,506,50606,5060603
506060302,"Akabeza",228,233,461,5,506,50606,5060603
506060303,"Akinteko",261,289,550,5,506,50606,5060603
506060304,"Ikiyovu",276,312,588,5,506,50606,5060603
506060305,"Murambi",301,355,656,5,506,50606,5060603
506060306,"Rugaju",359,425,784,5,506,50606,5060603
506060307,"Urukoki",292,318,610,5,506,50606,5060603
506060401,"Gisenyi",242,270,512,5,506,50606,5060604
506060402,"Gishandaro",318,388,706,5,506,50606,5060604
506060403,"Kimanama",212,261,473,5,506,50606,5060604
506060404,"Nyamabuye",344,413,757,5,506,50606,5060604
506060405,"Rwarutare",266,325,591,5,506,50606,5060604
506060406,"Ubuhanira",279,299,578,5,506,50606,5060604
506060501,"Agatare",367,390,757,5,506,50606,5060605
506060502,"Gomezo",251,291,542,5,506,50606,5060605
506060503,"Ntarama",291,287,578,5,506,50606,5060605
506060504,"Nunga",307,369,676,5,506,50606,5060605
506060505,"Rugazi",328,354,682,5,506,50606,5060605
506060506,"Rusave",197,198,395,5,506,50606,5060605
506060507,"Rwamibari",313,350,663,5,506,50606,5060605
506070101,"Gitaraga",162,201,363,5,506,50607,5060701
506070102,"Kizenga",280,310,590,5,506,50607,5060701
506070103,"Ntara",227,266,493,5,506,50607,5060701
506070104,"Nyagahura",259,331,590,5,506,50607,5060701
506070105,"Nyakabanga",268,314,582,5,506,50607,5060701
506070106,"Rukizi",186,218,404,5,506,50607,5060701
506070107,"Tonero",269,289,558,5,506,50607,5060701
506070201,"Cyeru",229,276,505,5,506,50607,5060702
506070202,"Kaboza",161,193,354,5,506,50607,5060702
506070203,"Kigabiro",350,400,750,5,506,50607,5060702
506070204,"Murutare",232,285,517,5,506,50607,5060702
506070205,"Mutara",280,348,628,5,506,50607,5060702
506070206,"Nyagasozi",302,361,663,5,506,50607,5060702
506070301,"Gitesanyi",231,270,501,5,506,50607,5060703
506070302,"Kibimba",195,239,434,5,506,50607,5060703
506070303,"Kiyagara",241,298,539,5,506,50607,5060703
506070304,"Mvumba",186,170,356,5,506,50607,5060703
506070305,"Nyakagezi",265,256,521,5,506,50607,5060703
506070306,"Nyarwanya",124,142,266,5,506,50607,5060703
506070307,"Rugarama",114,130,244,5,506,50607,5060703
506070401,"Gashanda",193,217,410,5,506,50607,5060704
506070402,"Gasibya",182,203,385,5,506,50607,5060704
506070403,"Gatoma",144,179,323,5,506,50607,5060704
506070404,"Gitaba",338,326,664,5,506,50607,5060704
506070405,"Kabeza",171,206,377,5,506,50607,5060704
506070406,"Kambuto",120,136,256,5,506,50607,5060704
506070407,"Kanyinya",239,265,504,5,506,50607,5060704
506070408,"Kaziba",184,208,392,5,506,50607,5060704
506070409,"Kurutare",119,138,257,5,506,50607,5060704
506070410,"Muguruka",200,213,413,5,506,50607,5060704
506070411,"Murambi",112,144,256,5,506,50607,5060704
506070412,"Ruvuzi",180,188,368,5,506,50607,5060704
506070413,"Ruzinga",109,143,252,5,506,50607,5060704
506070501,"Gatonde",225,224,449,5,506,50607,5060705
506070502,"Kabahushi",190,202,392,5,506,50607,5060705
506070503,"Kakahi",139,175,314,5,506,50607,5060705
506070504,"Kavumu",239,336,575,5,506,50607,5060705
506070505,"Kukarenge",134,156,290,5,506,50607,5060705
506070506,"Mukibara",202,233,435,5,506,50607,5060705
506070507,"Nyagataba",110,119,229,5,506,50607,5060705
506070508,"Nyamirembe",172,209,381,5,506,50607,5060705
506070509,"Rwabuconco",124,150,274,5,506,50607,5060705
506070510,"Sagatare",222,252,474,5,506,50607,5060705
506070511,"Urubare",269,289,558,5,506,50607,5060705
506080101,"Cyanamo",281,337,618,5,506,50608,5060801
506080102,"Gitesanyi",281,316,597,5,506,50608,5060801
506080103,"Meraneza",427,376,803,5,506,50608,5060801
506080104,"Musenyi",367,347,714,5,506,50608,5060801
506080201,"Kabombo",387,419,806,5,506,50608,5060802
506080202,"Mutukura",475,518,993,5,506,50608,5060802
506080203,"Ndarage",367,393,760,5,506,50608,5060802
506080204,"Rwakaza",447,464,911,5,506,50608,5060802
506080205,"Rwankamba",412,472,884,5,506,50608,5060802
506080301,"Agatonde",360,360,720,5,506,50608,5060803
506080302,"Akarimbu",1013,812,1825,5,506,50608,5060803
506080303,"Cyanyunga",300,341,641,5,506,50608,5060803
506080304,"Kibaya",345,420,765,5,506,50608,5060803
506080305,"Tonero",380,415,795,5,506,50608,5060803
506080401,"Gatonde",304,339,643,5,506,50608,5060804
506080402,"Rusave",351,386,737,5,506,50608,5060804
506080403,"Rwakandari",251,280,531,5,506,50608,5060804
506080404,"Shyagashya",257,277,534,5,506,50608,5060804
506080405,"Umuyange",223,263,486,5,506,50608,5060804
506080501,"Nyagasozi",655,745,1400,5,506,50608,5060805
506080502,"Nyamirindi",579,656,1235,5,506,50608,5060805
506080503,"Nyamugari",456,551,1007,5,506,50608,5060805
506090101,"Gasebeya",255,302,557,5,506,50609,5060901
506090102,"Gatare",356,357,713,5,506,50609,5060901
506090103,"Gisunzu",292,305,597,5,506,50609,5060901
506090104,"Kabeza",249,302,551,5,506,50609,5060901
506090105,"Kiyovu",346,369,715,5,506,50609,5060901
506090106,"Kumukiza",260,328,588,5,506,50609,5060901
506090107,"Munini I",207,229,436,5,506,50609,5060901
506090108,"Munini Ii",193,227,420,5,506,50609,5060901
506090109,"Nkenke",153,172,325,5,506,50609,5060901
506090110,"Rubumba",289,344,633,5,506,50609,5060901
506090111,"Rwesero",189,214,403,5,506,50609,5060901
506090201,"Kabeza",428,452,880,5,506,50609,5060902
506090202,"Kamvumba",270,346,616,5,506,50609,5060902
506090203,"Kigaga",220,222,442,5,506,50609,5060902
506090204,"Murambi",293,294,587,5,506,50609,5060902
506090205,"Nyarugenge",389,455,844,5,506,50609,5060902
506090206,"Urusagara",401,407,808,5,506,50609,5060902
506090301,"Gikomero",244,259,503,5,506,50609,5060903
506090302,"Icyakabiri",398,466,864,5,506,50609,5060903
506090303,"Rugando",467,486,953,5,506,50609,5060903
506090304,"Ruhuha",372,430,802,5,506,50609,5060903
506090305,"Rukore",463,559,1022,5,506,50609,5060903
506090306,"Rwamutabazi",510,581,1091,5,506,50609,5060903
506090401,"Bukiranzuki",227,279,506,5,506,50609,5060904
506090402,"Kabuye",219,238,457,5,506,50609,5060904
506090403,"Kaguruka",202,209,411,5,506,50609,5060904
506090404,"Kinanira",333,313,646,5,506,50609,5060904
506090405,"Nyakabingo",451,488,939,5,506,50609,5060904
506090406,"Rebero",230,235,465,5,506,50609,5060904
506090407,"Rubimba",259,281,540,5,506,50609,5060904
506090408,"Ruhama",245,253,498,5,506,50609,5060904
506090409,"Ryinteko",259,248,507,5,506,50609,5060904
506090410,"Tonero",294,370,664,5,506,50609,5060904
506100101,"Dagaza",263,295,558,5,506,50610,5061001
506100102,"Gatare",324,393,717,5,506,50610,5061001
506100103,"Kabeza",316,347,663,5,506,50610,5061001
506100104,"Kanzenze",355,390,745,5,506,50610,5061001
506100105,"Kibande",173,182,355,5,506,50610,5061001
506100106,"Kibimba",163,235,398,5,506,50610,5061001
506100107,"Rugaragara",369,382,751,5,506,50610,5061001
506100108,"Rurama",417,305,722,5,506,50610,5061001
506100109,"Rwakimanzi",298,350,648,5,506,50610,5061001
506100110,"Rwavuguta",192,211,403,5,506,50610,5061001
506100111,"Sangano",208,273,481,5,506,50610,5061001
506100201,"Agatare",160,135,295,5,506,50610,5061002
506100202,"Bweranka",156,187,343,5,506,50610,5061002
506100203,"Gahushyi",162,180,342,5,506,50610,5061002
506100204,"Gituku",245,233,478,5,506,50610,5061002
506100205,"Kagarama",180,234,414,5,506,50610,5061002
506100206,"Kibimba",216,238,454,5,506,50610,5061002
506100207,"Korandebe",263,311,574,5,506,50610,5061002
506100208,"Munezero",192,203,395,5,506,50610,5061002
506100209,"Nyamabuye",219,250,469,5,506,50610,5061002
506100210,"Rubagabaga",167,141,308,5,506,50610,5061002
506100211,"Rusenyi",140,144,284,5,506,50610,5061002
506100212,"Rwanyineka",191,232,423,5,506,50610,5061002
506100213,"Terimbere",146,136,282,5,506,50610,5061002
506100301,"Amahoro",199,244,443,5,506,50610,5061003
506100302,"Cyamahehe",269,331,600,5,506,50610,5061003
506100303,"Gafunzo",214,229,443,5,506,50610,5061003
506100304,"Gatare",221,268,489,5,506,50610,5061003
506100305,"Isangano",269,351,620,5,506,50610,5061003
506100306,"Nyagataba",208,212,420,5,506,50610,5061003
506100307,"Rugenge",286,349,635,5,506,50610,5061003
506100308,"Terimbere",225,238,463,5,506,50610,5061003
506100401,"Cyabayagara",219,233,452,5,506,50610,5061004
506100402,"Kabimba",265,306,571,5,506,50610,5061004
506100403,"Karuruma",195,274,469,5,506,50610,5061004
506100404,"Kibimba",185,192,377,5,506,50610,5061004
506100405,"Mirambi",256,233,489,5,506,50610,5061004
506100406,"Rugarama",259,269,528,5,506,50610,5061004
506100407,"Ruhama",450,544,994,5,506,50610,5061004
506100408,"Rwagakobe",301,329,630,5,506,50610,5061004
506100409,"Rwagishanga",180,207,387,5,506,50610,5061004
506100410,"Rwamukobwa",170,223,393,5,506,50610,5061004
506110101,"Gitesanyi",169,185,354,5,506,50611,5061101
506110102,"Gituza",747,822,1569,5,506,50611,5061101
506110103,"Mfune",745,809,1554,5,506,50611,5061101
506110104,"Ruyenzi",296,308,604,5,506,50611,5061101
506110201,"Iyantende",285,326,611,5,506,50611,5061102
506110202,"Kigese",687,773,1460,5,506,50611,5061102
506110203,"Mugwato",373,403,776,5,506,50611,5061102
506110204,"Ntovi",237,262,499,5,506,50611,5061102
506110205,"Rukumberi",262,299,561,5,506,50611,5061102
506110206,"Rwamibabi",336,397,733,5,506,50611,5061102
506110301,"Akabungo",386,463,849,5,506,50611,5061103
506110302,"Kavumve",406,462,868,5,506,50611,5061103
506110303,"Nyagakizi",366,423,789,5,506,50611,5061103
506110304,"Nyagitabire",344,364,708,5,506,50611,5061103
506110305,"Rubago",269,336,605,5,506,50611,5061103
506110401,"Kagarama",259,322,581,5,506,50611,5061104
506110402,"Maswa I",565,679,1244,5,506,50611,5061104
506110403,"Maswa Ii",456,535,991,5,506,50611,5061104
506110404,"Rugenda I",465,559,1024,5,506,50611,5061104
506110405,"Rugenda Ii",429,407,836,5,506,50611,5061104
506110406,"Ruyenzi I",250,322,572,5,506,50611,5061104
506110501,"Bare",200,197,397,5,506,50611,5061105
506110502,"Karokora",251,287,538,5,506,50611,5061105
506110503,"Rwimpongo I",716,823,1539,5,506,50611,5061105
506110504,"Rwimpongo Ii",474,550,1024,5,506,50611,5061105
506110505,"Shyembe",642,678,1320,5,506,50611,5061105
506120101,"Kuwimana",204,264,468,5,506,50612,5061201
506120102,"Mukibimba",234,259,493,5,506,50612,5061201
506120103,"Rwanyamuhinda",156,154,310,5,506,50612,5061201
506120104,"Umurambi",167,208,375,5,506,50612,5061201
506120105,"Urugazi",265,289,554,5,506,50612,5061201
506120106,"Uruyenzi",309,326,635,5,506,50612,5061201
506120201,"Agatonero",187,198,385,5,506,50612,5061202
506120202,"Gashinya",146,148,294,5,506,50612,5061202
506120203,"Gisunzu",252,274,526,5,506,50612,5061202
506120204,"Gitobe",284,343,627,5,506,50612,5061202
506120205,"Nyamata",502,508,1010,5,506,50612,5061202
506120301,"Inteko",253,310,563,5,506,50612,5061203
506120302,"Kabimba",306,375,681,5,506,50612,5061203
506120303,"Kamugundu",211,220,431,5,506,50612,5061203
506120304,"Karama",233,244,477,5,506,50612,5061203
506120305,"Runazi",245,297,542,5,506,50612,5061203
506120306,"Rwasaburo",189,229,418,5,506,50612,5061203
506120401,"Kajevuba",359,370,729,5,506,50612,5061204
506120402,"Kamwiru",522,608,1130,5,506,50612,5061204
506120403,"Kiyanja",587,587,1174,5,506,50612,5061204
506120404,"Kumunini",140,167,307,5,506,50612,5061204
506120405,"Nyamigende",316,376,692,5,506,50612,5061204
506120406,"Rugarika",339,412,751,5,506,50612,5061204
506120407,"Rwakanuma",314,340,654,5,506,50612,5061204
506120501,"Akarambaraye",214,274,488,5,506,50612,5061205
506120502,"Kabeza",179,231,410,5,506,50612,5061205
506120503,"Mashyoza",340,359,699,5,506,50612,5061205
506120504,"Mbonwa",270,270,540,5,506,50612,5061205
506120505,"Nyabagaza",235,230,465,5,506,50612,5061205
506120506,"Urusagara",328,366,694,5,506,50612,5061205
506120601,"Akabakanda",334,435,769,5,506,50612,5061206
506120602,"Amashya",158,202,360,5,506,50612,5061206
506120603,"Kabashumba",312,392,704,5,506,50612,5061206
506120604,"Kigarama",356,448,804,5,506,50612,5061206
506120605,"Kivugangoma",271,318,589,5,506,50612,5061206
506120606,"Ruhuha",322,381,703,5,506,50612,5061206
506120607,"Rwaromba",311,356,667,5,506,50612,5061206
506130101,"Cyanika",243,296,539,5,506,50613,5061301
506130102,"Gatare",279,312,591,5,506,50613,5061301
506130103,"Icyizanye",171,213,384,5,506,50613,5061301
506130104,"Isovu",285,286,571,5,506,50613,5061301
506130105,"Kiriko",219,271,490,5,506,50613,5061301
506130106,"Kumurenge",299,338,637,5,506,50613,5061301
506130107,"Mabuga I",356,303,659,5,506,50613,5061301
506130108,"Mabuga Ii",303,298,601,5,506,50613,5061301
506130109,"Nyakagezi",279,277,556,5,506,50613,5061301
506130110,"Rwanyabiranga",231,303,534,5,506,50613,5061301
506130111,"Rwumba",275,328,603,5,506,50613,5061301
506130201,"Kabare",321,331,652,5,506,50613,5061302
506130202,"Karenge",280,267,547,5,506,50613,5061302
506130203,"Kidakama",129,147,276,5,506,50613,5061302
506130204,"Murama",304,376,680,5,506,50613,5061302
506130205,"Nkingi",205,250,455,5,506,50613,5061302
506130206,"Nyagasani",328,348,676,5,506,50613,5061302
506130207,"Umucyo",374,418,792,5,506,50613,5061302
506130301,"Agatare",299,338,637,5,506,50613,5061303
506130302,"Akabira",200,232,432,5,506,50613,5061303
506130303,"Bukokoza",278,317,595,5,506,50613,5061303
506130304,"Gisera",372,418,790,5,506,50613,5061303
506130305,"Iryarurengo",235,214,449,5,506,50613,5061303
506130306,"Kanazi",290,343,633,5,506,50613,5061303
506130307,"Mizibiri",227,271,498,5,506,50613,5061303
506130401,"Akagoma",148,178,326,5,506,50613,5061304
506130402,"Irebero",263,307,570,5,506,50613,5061304
506130403,"Isangano",383,441,824,5,506,50613,5061304
506130404,"Muminoga",296,346,642,5,506,50613,5061304
506130405,"Musenyi",450,515,965,5,506,50613,5061304
506130406,"Nyagasozi",180,209,389,5,506,50613,5061304
506130407,"Nyakariba",298,322,620,5,506,50613,5061304
506130408,"Nyarurembo",513,434,947,5,506,50613,5061304
506130409,"Umukoni",372,396,768,5,506,50613,5061304
506140101,"Agatare",141,169,310,5,506,50614,5061401
506140102,"Akabeza",204,227,431,5,506,50614,5061401
506140103,"Akabuga",157,209,366,5,506,50614,5061401
506140104,"Igifurere",180,194,374,5,506,50614,5061401
506140105,"Ikiyovu",145,181,326,5,506,50614,5061401
506140106,"Irebero",155,163,318,5,506,50614,5061401
506140107,"Isanganiro",278,309,587,5,506,50614,5061401
506140108,"Rubati",178,248,426,5,506,50614,5061401
506140109,"Rwanshuro",158,162,320,5,506,50614,5061401
506140110,"Rwimbirwa",395,219,614,5,506,50614,5061401
506140111,"Sugira",183,185,368,5,506,50614,5061401
506140201,"Akanyinya",171,201,372,5,506,50614,5061402
506140202,"Amahoro",139,192,331,5,506,50614,5061402
506140203,"Cyerwa",57,88,145,5,506,50614,5061402
506140204,"Cyizihira",153,152,305,5,506,50614,5061402
506140205,"Itonero",102,84,186,5,506,50614,5061402
506140206,"Jyambere",298,122,420,5,506,50614,5061402
506140207,"Kabonero",202,187,389,5,506,50614,5061402
506140208,"Kirira",167,205,372,5,506,50614,5061402
506140209,"Kizenga",148,175,323,5,506,50614,5061402
506140210,"Kumuyange",123,146,269,5,506,50614,5061402
506140211,"Nyagatugunda",146,149,295,5,506,50614,5061402
506140212,"Nyakabanda",161,209,370,5,506,50614,5061402
506140213,"Nyakabande",135,160,295,5,506,50614,5061402
506140214,"Nyarurembo",111,125,236,5,506,50614,5061402
506140215,"Rebero",125,161,286,5,506,50614,5061402
506140216,"Rugarama",152,172,324,5,506,50614,5061402
506140217,"Rushubi",131,135,266,5,506,50614,5061402
506140218,"Rwezibamba",130,152,282,5,506,50614,5061402
506140301,"Agasave",129,177,306,5,506,50614,5061403
506140302,"Ituze",219,213,432,5,506,50614,5061403
506140303,"Kabeza",521,761,1282,5,506,50614,5061403
506140304,"Kacyiru",142,175,317,5,506,50614,5061403
506140305,"Karenge",173,176,349,5,506,50614,5061403
506140306,"Kumunini",179,197,376,5,506,50614,5061403
506140307,"Makoma",113,164,277,5,506,50614,5061403
506140308,"Mpembwe",152,186,338,5,506,50614,5061403
506140309,"Nyagahinga",143,178,321,5,506,50614,5061403
506140310,"Nyaruteja",139,170,309,5,506,50614,5061403
506140311,"Rugarama",170,194,364,5,506,50614,5061403
506140312,"Rushubi",159,172,331,5,506,50614,5061403
506140313,"Urutare",138,165,303,5,506,50614,5061403
506140401,"Agataba",168,189,357,5,506,50614,5061404
506140402,"Akabungo",191,229,420,5,506,50614,5061404
506140403,"Busasamana",193,219,412,5,506,50614,5061404
506140404,"Gasebeya",138,152,290,5,506,50614,5061404
506140405,"Isangano",166,197,363,5,506,50614,5061404
506140406,"Kagarama",162,181,343,5,506,50614,5061404
506140407,"Nyagahandagazi",165,222,387,5,506,50614,5061404
506140408,"Nyakariba",238,268,506,5,506,50614,5061404
506140409,"Rwakagina",173,191,364,5,506,50614,5061404
506140410,"Sangaza",170,178,348,5,506,50614,5061404
506140411,"Ubumwe",218,269,487,5,506,50614,5061404
506140412,"Umukoma",249,265,514,5,506,50614,5061404
506140413,"Umuvugangoma",206,244,450,5,506,50614,5061404
507010101,"Bidudu",323,348,671,5,507,50701,5070101
507010102,"Biryogo",384,318,702,5,507,50701,5070101
507010103,"Buhoro",188,213,401,5,507,50701,5070101
507010104,"Gihanama",271,249,520,5,507,50701,5070101
507010105,"Kagarama",211,196,407,5,507,50701,5070101
507010106,"Kanyonyomba",186,217,403,5,507,50701,5070101
507010107,"Karutete",201,257,458,5,507,50701,5070101
507010108,"Kivugiza",213,233,446,5,507,50701,5070101
507010109,"Rugunga",274,273,547,5,507,50701,5070101
507010201,"Bidudu",292,310,602,5,507,50701,5070102
507010202,"Kabuye",263,306,569,5,507,50701,5070102
507010203,"Karizinge",318,347,665,5,507,50701,5070102
507010204,"Rwagasiga",171,218,389,5,507,50701,5070102
507010205,"Rweteto",228,245,473,5,507,50701,5070102
507010301,"Akagako",175,193,368,5,507,50701,5070103
507010302,"Kagomasi",192,251,443,5,507,50701,5070103
507010303,"Kiruhura",293,296,589,5,507,50701,5070103
507010304,"Kuruganda",240,319,559,5,507,50701,5070103
507010305,"Runzenze",163,167,330,5,507,50701,5070103
507010306,"Rushubi",220,194,414,5,507,50701,5070103
507010401,"Gaharwa",243,353,596,5,507,50701,5070104
507010402,"Gisenyi",227,301,528,5,507,50701,5070104
507010403,"Kayovu",309,312,621,5,507,50701,5070104
507010404,"Ruhanga",248,261,509,5,507,50701,5070104
507010405,"Ruhanura",294,325,619,5,507,50701,5070104
507010406,"Rutanga",277,317,594,5,507,50701,5070104
507010501,"Dihiro",318,357,675,5,507,50701,5070105
507010502,"Kagasa I",309,353,662,5,507,50701,5070105
507010503,"Kagasa Ii",271,315,586,5,507,50701,5070105
507010504,"Karusine I",251,286,537,5,507,50701,5070105
507010505,"Karusine Ii",283,317,600,5,507,50701,5070105
507010506,"Migina",268,269,537,5,507,50701,5070105
507010507,"Munyinya",324,306,630,5,507,50701,5070105
507010508,"Rweru I",254,224,478,5,507,50701,5070105
507010509,"Rweru Ii",255,260,515,5,507,50701,5070105
507020101,"Ayabakiza",356,393,749,5,507,50702,5070201
507020102,"Bisagara",423,438,861,5,507,50702,5070201
507020103,"Nyamigende",387,385,772,5,507,50702,5070201
507020104,"Rugarama",398,439,837,5,507,50702,5070201
507020105,"Rwamakara",248,275,523,5,507,50702,5070201
507020106,"Twabagarama",324,343,667,5,507,50702,5070201
507020201,"Gikana",287,311,598,5,507,50702,5070202
507020202,"Gikurazo",252,214,466,5,507,50702,5070202
507020203,"Kabukuba",434,481,915,5,507,50702,5070202
507020204,"Kamatongo",240,241,481,5,507,50702,5070202
507020205,"Majanja",269,309,578,5,507,50702,5070202
507020206,"Mbuye",174,211,385,5,507,50702,5070202
507020207,"Rushubi",293,307,600,5,507,50702,5070202
507020301,"Cyirabo",257,291,548,5,507,50702,5070203
507020302,"Gatora",272,346,618,5,507,50702,5070203
507020303,"Kajevuba",360,356,716,5,507,50702,5070203
507020304,"Mugorore",196,225,421,5,507,50702,5070203
507020305,"Murambi",230,262,492,5,507,50702,5070203
507020306,"Rebero",251,292,543,5,507,50702,5070203
507020307,"Rwamurama",360,349,709,5,507,50702,5070203
507020308,"Tabarari",364,368,732,5,507,50702,5070203
507020401,"Bitega",271,294,565,5,507,50702,5070204
507020402,"Cyabasonga",335,327,662,5,507,50702,5070204
507020403,"Cyingaju",303,352,655,5,507,50702,5070204
507020404,"Kabeza",316,300,616,5,507,50702,5070204
507020405,"Nyaruhuru",262,299,561,5,507,50702,5070204
507020501,"Gisororo",330,406,736,5,507,50702,5070205
507020502,"Kabeza",322,363,685,5,507,50702,5070205
507020503,"Katarara",279,336,615,5,507,50702,5070205
507020504,"Kinihira",280,355,635,5,507,50702,5070205
507020505,"Rwimpyisi",307,323,630,5,507,50702,5070205
507020506,"Uwimpunga",377,397,774,5,507,50702,5070205
507030101,"Akanigo",153,160,313,5,507,50703,5070301
507030102,"Biharagu",184,214,398,5,507,50703,5070301
507030103,"Kanyonyera",200,246,446,5,507,50703,5070301
507030104,"Munazi",278,262,540,5,507,50703,5070301
507030105,"Muyigi",248,261,509,5,507,50703,5070301
507030106,"Nyarurama",99,135,234,5,507,50703,5070301
507030107,"Rubugu",194,209,403,5,507,50703,5070301
507030201,"Akabazeyi",207,244,451,5,507,50703,5070302
507030202,"Kagenge",272,295,567,5,507,50703,5070302
507030203,"Murambo",280,299,579,5,507,50703,5070302
507030204,"Nyabyondo",285,321,606,5,507,50703,5070302
507030205,"Nyakariba",277,284,561,5,507,50703,5070302
507030206,"Rebero",270,317,587,5,507,50703,5070302
507030207,"Senga",232,300,532,5,507,50703,5070302
507030301,"Byimana",204,240,444,5,507,50703,5070303
507030302,"Kampeka",151,155,306,5,507,50703,5070303
507030303,"Mabuye",141,165,306,5,507,50703,5070303
507030304,"Masangano",193,222,415,5,507,50703,5070303
507030305,"Mbuganzeri",144,159,303,5,507,50703,5070303
507030306,"Mparo",131,135,266,5,507,50703,5070303
507030307,"Ndama",215,265,480,5,507,50703,5070303
507030308,"Pamba I",170,184,354,5,507,50703,5070303
507030309,"Pamba Ii",110,137,247,5,507,50703,5070303
507030401,"Akaje",244,278,522,5,507,50703,5070304
507030402,"Fatinkanda",159,165,324,5,507,50703,5070304
507030403,"Murago",109,108,217,5,507,50703,5070304
507030404,"Murambi",198,214,412,5,507,50703,5070304
507030405,"Ntungamo I",123,128,251,5,507,50703,5070304
507030406,"Ntungamo Ii",101,135,236,5,507,50703,5070304
507030407,"Nyakayaga",276,306,582,5,507,50703,5070304
507030501,"Cyogamuyaga",158,171,329,5,507,50703,5070305
507030502,"Mububa I",151,137,288,5,507,50703,5070305
507030503,"Mububaya Ii",93,127,220,5,507,50703,5070305
507030504,"Rubirizi",118,133,251,5,507,50703,5070305
507030505,"Rusibya",141,139,280,5,507,50703,5070305
507030506,"Tunda",117,127,244,5,507,50703,5070305
507030507,"Twuruziramire",178,204,382,5,507,50703,5070305
507030508,"Uwibiraro I",127,132,259,5,507,50703,5070305
507030509,"Uwibiraro Ii",131,140,271,5,507,50703,5070305
507030510,"Uwumusave",164,198,362,5,507,50703,5070305
507040101,"Bigaga",270,246,516,5,507,50704,5070401
507040102,"Bukumba",245,249,494,5,507,50704,5070401
507040103,"Cyantwari",148,159,307,5,507,50704,5070401
507040104,"Gasagara",246,291,537,5,507,50704,5070401
507040105,"Gitega",138,159,297,5,507,50704,5070401
507040106,"Kabeza",157,169,326,5,507,50704,5070401
507040107,"Kagese",162,168,330,5,507,50704,5070401
507040108,"Kagogo",196,232,428,5,507,50704,5070401
507040109,"Kamasonga",169,185,354,5,507,50704,5070401
507040110,"Mareba",168,185,353,5,507,50704,5070401
507040111,"Muyange",189,219,408,5,507,50704,5070401
507040112,"Rukoyoyo",191,225,416,5,507,50704,5070401
507040113,"Runyonza",210,264,474,5,507,50704,5070401
507040114,"Rususa",192,196,388,5,507,50704,5070401
507040201,"Gatanga",150,161,311,5,507,50704,5070402
507040202,"Gitwa",231,263,494,5,507,50704,5070402
507040203,"Kabere",157,221,378,5,507,50704,5070402
507040204,"Kajevuba",323,331,654,5,507,50704,5070402
507040205,"Kamudeberi",191,202,393,5,507,50704,5070402
507040206,"Kamunana",123,158,281,5,507,50704,5070402
507040207,"Kanka",151,163,314,5,507,50704,5070402
507040208,"Kaziranyenzi",263,310,573,5,507,50704,5070402
507040209,"Rwintare",190,207,397,5,507,50704,5070402
507040301,"Gafunzo",137,194,331,5,507,50704,5070403
507040302,"Kabeza",137,167,304,5,507,50704,5070403
507040303,"Kabingo",110,141,251,5,507,50704,5070403
507040304,"Kabuye",169,161,330,5,507,50704,5070403
507040305,"Karwana",165,180,345,5,507,50704,5070403
507040306,"Ngugu",109,138,247,5,507,50704,5070403
507040307,"Nyamigisha",224,212,436,5,507,50704,5070403
507040308,"Ruhina",122,145,267,5,507,50704,5070403
507040309,"Rusenyi",195,211,406,5,507,50704,5070403
507040310,"Ruyenzi",157,197,354,5,507,50704,5070403
507040401,"Gatare",178,191,369,5,507,50704,5070404
507040402,"Gatinza",211,245,456,5,507,50704,5070404
507040403,"Gihoko",143,170,313,5,507,50704,5070404
507040404,"Kabuga",100,123,223,5,507,50704,5070404
507040405,"Kagarama",127,149,276,5,507,50704,5070404
507040406,"Matinza",288,358,646,5,507,50704,5070404
507040407,"Mbuga",162,165,327,5,507,50704,5070404
507040408,"Rango",323,355,678,5,507,50704,5070404
507040409,"Rusagara",280,333,613,5,507,50704,5070404
507040410,"Rwabikwano",180,175,355,5,507,50704,5070404
507040501,"Gasagara",142,158,300,5,507,50704,5070405
507040502,"Gatare",151,179,330,5,507,50704,5070405
507040503,"Kayonza",187,209,396,5,507,50704,5070405
507040504,"Keza",168,172,340,5,507,50704,5070405
507040505,"Kururama",183,207,390,5,507,50704,5070405
507040506,"Muyenzi",171,169,340,5,507,50704,5070405
507040507,"Ruduha",233,256,489,5,507,50704,5070405
507040508,"Rugarama",204,229,433,5,507,50704,5070405
507040509,"Rutaka",168,217,385,5,507,50704,5070405
507050101,"Gacucu",268,317,585,5,507,50705,5070501
507050102,"Gakamba",284,300,584,5,507,50705,5070501
507050103,"Gisenyi",259,284,543,5,507,50705,5070501
507050104,"Kamugenzi",280,335,615,5,507,50705,5070501
507050105,"Karambo",425,455,880,5,507,50705,5070501
507050106,"Kavumu",350,334,684,5,507,50705,5070501
507050107,"Rukora",344,352,696,5,507,50705,5070501
507050201,"Biryogo",446,444,890,5,507,50705,5070502
507050202,"Gakindo",439,439,878,5,507,50705,5070502
507050203,"Gitaramuka",256,285,541,5,507,50705,5070502
507050204,"Karama",278,295,573,5,507,50705,5070502
507050205,"Kiruhura",205,203,408,5,507,50705,5070502
507050206,"Remera",199,251,450,5,507,50705,5070502
507050207,"Rukindo",147,139,286,5,507,50705,5070502
507050208,"Taba",301,351,652,5,507,50705,5070502
507050209,"Tetero",231,290,521,5,507,50705,5070502
507050301,"Gahwiji A",279,276,555,5,507,50705,5070503
507050302,"Gahwiji B",235,274,509,5,507,50705,5070503
507050303,"Kindonyi",312,362,674,5,507,50705,5070503
507050304,"Murambi",250,251,501,5,507,50705,5070503
507050305,"Ruhorobero",273,306,579,5,507,50705,5070503
507050306,"Rwakaramira",291,314,605,5,507,50705,5070503
507050307,"Rwarusaku",179,226,405,5,507,50705,5070503
507050401,"Gacyamo",365,312,677,5,507,50705,5070504
507050402,"Gahinga",250,299,549,5,507,50705,5070504
507050403,"Gisenyi",259,306,565,5,507,50705,5070504
507050404,"Gitera",271,298,569,5,507,50705,5070504
507050405,"Kibirizi",222,277,499,5,507,50705,5070504
507050406,"Rugazi",323,348,671,5,507,50705,5070504
507050407,"Rwakibirizi",268,299,567,5,507,50705,5070504
507050501,"Cyaruhiririra",299,322,621,5,507,50705,5070505
507050502,"Kabyo",346,426,772,5,507,50705,5070505
507050503,"Rugarama",374,443,817,5,507,50705,5070505
507050504,"Rwimikoni I",1719,445,2164,5,507,50705,5070505
507050505,"Rwimikoni Ii",277,293,570,5,507,50705,5070505
507060101,"Bidudu",422,266,688,5,507,50706,5070601
507060102,"Cyanika",262,287,549,5,507,50706,5070601
507060103,"Cyarubazi",201,236,437,5,507,50706,5070601
507060104,"Gatare",216,229,445,5,507,50706,5070601
507060105,"Gihari",217,265,482,5,507,50706,5070601
507060106,"Kagusa",220,241,461,5,507,50706,5070601
507060107,"Kamahango",218,250,468,5,507,50706,5070601
507060108,"Kavumu",250,419,669,5,507,50706,5070601
507060109,"Kidudu",276,273,549,5,507,50706,5070601
507060110,"Migina",234,262,496,5,507,50706,5070601
507060111,"Ngarama",225,255,480,5,507,50706,5070601
507060112,"Remera",308,308,616,5,507,50706,5070601
507060113,"Rusagara",195,227,422,5,507,50706,5070601
507060201,"Bidudu",240,255,495,5,507,50706,5070602
507060202,"Bishinge",201,222,423,5,507,50706,5070602
507060203,"Bizenga",233,248,481,5,507,50706,5070602
507060204,"Cyeru",278,274,552,5,507,50706,5070602
507060205,"Gakomeye",183,220,403,5,507,50706,5070602
507060206,"Gakurazo",179,261,440,5,507,50706,5070602
507060207,"Kigarama",200,251,451,5,507,50706,5070602
507060208,"Kijuri",205,250,455,5,507,50706,5070602
507060209,"Kiringa",195,213,408,5,507,50706,5070602
507060210,"Muhanga",187,202,389,5,507,50706,5070602
507060211,"Nunga",220,242,462,5,507,50706,5070602
507060212,"Nyagasagara",197,212,409,5,507,50706,5070602
507060213,"Rugando",229,267,496,5,507,50706,5070602
507060214,"Rugeyo",211,252,463,5,507,50706,5070602
507060301,"Gatoki",338,354,692,5,507,50706,5070603
507060302,"Gitagata",943,350,1293,5,507,50706,5070603
507060303,"Kigusa",381,436,817,5,507,50706,5070603
507060304,"Kiruhura",306,348,654,5,507,50706,5070603
507060305,"Mbonwa",238,237,475,5,507,50706,5070603
507060306,"Nyakajuri",272,344,616,5,507,50706,5070603
507060307,"Rugarama",435,496,931,5,507,50706,5070603
507060308,"Rushubi",327,372,699,5,507,50706,5070603
507060309,"Rwankeri",249,267,516,5,507,50706,5070603
507060401,"Kabeza",333,369,702,5,507,50706,5070604
507060402,"Kabuye",291,297,588,5,507,50706,5070604
507060403,"Kagunga",305,331,636,5,507,50706,5070604
507060404,"Kanyamata",231,252,483,5,507,50706,5070604
507060405,"Karambo",264,315,579,5,507,50706,5070604
507060406,"Karubanzangabo",302,326,628,5,507,50706,5070604
507060407,"Kinyovi",267,331,598,5,507,50706,5070604
507060408,"Nyamuri",313,326,639,5,507,50706,5070604
507060409,"Rulindo",354,400,754,5,507,50706,5070604
507060410,"Runyonza",360,344,704,5,507,50706,5070604
507070101,"Bitaba",233,236,469,5,507,50707,5070701
507070102,"Gatwe",244,258,502,5,507,50707,5070701
507070103,"Gisasa",257,313,570,5,507,50707,5070701
507070104,"Misatsi",278,290,568,5,507,50707,5070701
507070105,"Rebero",237,229,466,5,507,50707,5070701
507070106,"Rukoronko",220,263,483,5,507,50707,5070701
507070201,"Gatare",190,206,396,5,507,50707,5070702
507070202,"Gisenyi",189,216,405,5,507,50707,5070702
507070203,"Karutabana",475,346,821,5,507,50707,5070702
507070204,"Ngando",259,410,669,5,507,50707,5070702
507070205,"Rubumba",310,389,699,5,507,50707,5070702
507070206,"Rwintenderi",266,291,557,5,507,50707,5070702
507070301,"Kagerero",274,310,584,5,507,50707,5070703
507070302,"Nyamabuye",181,171,352,5,507,50707,5070703
507070303,"Nyarukombe",214,234,448,5,507,50707,5070703
507070304,"Rugazi",340,416,756,5,507,50707,5070703
507070305,"Rukira",321,326,647,5,507,50707,5070703
507070306,"Rukore",264,304,568,5,507,50707,5070703
507070307,"Rusagara",291,341,632,5,507,50707,5070703
507070401,"Gatoki",200,238,438,5,507,50707,5070704
507070402,"Gitaraga",320,356,676,5,507,50707,5070704
507070403,"Kaboshya",281,303,584,5,507,50707,5070704
507070404,"Kaziramire",440,445,885,5,507,50707,5070704
507070405,"Rurenge",363,338,701,5,507,50707,5070704
507070406,"Rwabashenyi",234,260,494,5,507,50707,5070704
507080101,"Buhara",278,270,548,5,507,50708,5070801
507080102,"Kabaya",153,149,302,5,507,50708,5070801
507080103,"Kabuye",186,227,413,5,507,50708,5070801
507080104,"Kadebu",237,276,513,5,507,50708,5070801
507080105,"Kagasa",327,350,677,5,507,50708,5070801
507080106,"Karambo",241,255,496,5,507,50708,5070801
507080107,"Kirasaniro",162,189,351,5,507,50708,5070801
507080108,"Kururama",199,206,405,5,507,50708,5070801
507080109,"Nyakariba",323,312,635,5,507,50708,5070801
507080110,"Nyarubande",200,230,430,5,507,50708,5070801
507080111,"Rusagara",307,292,599,5,507,50708,5070801
507080112,"Rutare",187,256,443,5,507,50708,5070801
507080113,"Ruzinge",256,284,540,5,507,50708,5070801
507080114,"Shitwe",180,250,430,5,507,50708,5070801
507080201,"Agashyamba",237,287,524,5,507,50708,5070802
507080202,"Bishenyi",181,203,384,5,507,50708,5070802
507080203,"Fatinkanda",152,153,305,5,507,50708,5070802
507080204,"Gakurazo",127,130,257,5,507,50708,5070802
507080205,"Gatanga",136,167,303,5,507,50708,5070802
507080206,"Ikoni",172,208,380,5,507,50708,5070802
507080207,"Kagege",261,267,528,5,507,50708,5070802
507080208,"Kankuriyingoma",107,121,228,5,507,50708,5070802
507080209,"Kigandu",126,169,295,5,507,50708,5070802
507080210,"Kinamba",172,215,387,5,507,50708,5070802
507080211,"Murama",260,271,531,5,507,50708,5070802
507080212,"Muyange",237,257,494,5,507,50708,5070802
507080213,"Nyakagarama",210,241,451,5,507,50708,5070802
507080214,"Rusamaza",252,269,521,5,507,50708,5070802
507080215,"Rwabisheshe",203,222,425,5,507,50708,5070802
507080216,"Shami",214,287,501,5,507,50708,5070802
507080301,"Binyonzwe",206,272,478,5,507,50708,5070803
507080302,"Kamajeri",197,219,416,5,507,50708,5070803
507080303,"Kamasonga",254,338,592,5,507,50708,5070803
507080304,"Karugondo",309,359,668,5,507,50708,5070803
507080305,"Kivugiza",387,431,818,5,507,50708,5070803
507080306,"Muyange",310,390,700,5,507,50708,5070803
507080307,"Ngeruka",264,320,584,5,507,50708,5070803
507080401,"Heru",250,301,551,5,507,50708,5070804
507080402,"Kabuye",170,216,386,5,507,50708,5070804
507080403,"Karama",183,186,369,5,507,50708,5070804
507080404,"Kavumu",223,266,489,5,507,50708,5070804
507080405,"Kibaya",195,154,349,5,507,50708,5070804
507080406,"Kibungo",318,306,624,5,507,50708,5070804
507080407,"Kimiduha",236,251,487,5,507,50708,5070804
507080408,"Murambi",189,213,402,5,507,50708,5070804
507080409,"Nyakayenzi",344,381,725,5,507,50708,5070804
507080410,"Twimpara",244,290,534,5,507,50708,5070804
507080501,"Akajuri",217,224,441,5,507,50708,5070805
507080502,"Kabare",181,180,361,5,507,50708,5070805
507080503,"Kabumbwe",243,254,497,5,507,50708,5070805
507080504,"Kagano",234,240,474,5,507,50708,5070805
507080505,"Kamugera",142,171,313,5,507,50708,5070805
507080506,"Kamugore",196,211,407,5,507,50708,5070805
507080507,"Kigarama",226,307,533,5,507,50708,5070805
507080508,"Rubirizi",253,297,550,5,507,50708,5070805
507080509,"Rugazi",166,186,352,5,507,50708,5070805
507080510,"Runyonza",178,208,386,5,507,50708,5070805
507080511,"Rusibya",214,230,444,5,507,50708,5070805
507090101,"Gatoro",210,203,413,5,507,50709,5070901
507090102,"Kayenzi",247,296,543,5,507,50709,5070901
507090103,"Kidudu",236,226,462,5,507,50709,5070901
507090104,"Kingabo",222,209,431,5,507,50709,5070901
507090105,"Rubomborana",177,186,363,5,507,50709,5070901
507090106,"Rugarama",203,223,426,5,507,50709,5070901
507090107,"Rugunga",316,303,619,5,507,50709,5070901
507090201,"Cyeru",310,351,661,5,507,50709,5070902
507090202,"Gasagara",109,136,245,5,507,50709,5070902
507090203,"Kabaha",216,222,438,5,507,50709,5070902
507090204,"Kabeza",254,308,562,5,507,50709,5070902
507090205,"Karumuna",272,298,570,5,507,50709,5070902
507090206,"Kurugenge",258,283,541,5,507,50709,5070902
507090207,"Nyamabuye",292,337,629,5,507,50709,5070902
507090208,"Rwangara",194,203,397,5,507,50709,5070902
507090301,"Kagoma I",194,210,404,5,507,50709,5070903
507090302,"Kagoma Ii",352,434,786,5,507,50709,5070903
507090303,"Kiganwa",379,436,815,5,507,50709,5070903
507090304,"Nganwa",377,421,798,5,507,50709,5070903
507090305,"Nyarunazi",239,248,487,5,507,50709,5070903
507090306,"Ruhengeri",249,303,552,5,507,50709,5070903
507090307,"Rusekera",253,292,545,5,507,50709,5070903
507100101,"Bihari",189,202,391,5,507,50710,5071001
507100102,"Cyeru",267,275,542,5,507,50710,5071001
507100103,"Gitovu",249,306,555,5,507,50710,5071001
507100104,"Kagirazina",245,251,496,5,507,50710,5071001
507100105,"Musagara",272,293,565,5,507,50710,5071001
507100106,"Nyarugati I",238,285,523,5,507,50710,5071001
507100107,"Nyarugati Ii",182,180,362,5,507,50710,5071001
507100108,"Rugando",200,222,422,5,507,50710,5071001
507100109,"Sumbure",248,267,515,5,507,50710,5071001
507100201,"Gatare",252,288,540,5,507,50710,5071002
507100202,"Karambi",269,251,520,5,507,50710,5071002
507100203,"Kayenzi",263,271,534,5,507,50710,5071002
507100204,"Murambi",264,236,500,5,507,50710,5071002
507100205,"Nyagatovu",286,305,591,5,507,50710,5071002
507100206,"Nyakwibereka",110,100,210,5,507,50710,5071002
507100207,"Nyiramatuntu",201,215,416,5,507,50710,5071002
507100208,"Rwanza",157,156,313,5,507,50710,5071002
507100301,"Gahembe",217,245,462,5,507,50710,5071003
507100302,"Gisunzu",169,194,363,5,507,50710,5071003
507100303,"Mukoma",193,195,388,5,507,50710,5071003
507100304,"Muyange",275,313,588,5,507,50710,5071003
507100305,"Rugarama",178,208,386,5,507,50710,5071003
507100306,"Rusagara",279,257,536,5,507,50710,5071003
507100401,"Bishweshwe",243,313,556,5,507,50710,5071004
507100402,"Gataraga",186,204,390,5,507,50710,5071004
507100403,"Gatare",141,138,279,5,507,50710,5071004
507100404,"Kasebigege",257,293,550,5,507,50710,5071004
507100405,"Kivugiza",181,226,407,5,507,50710,5071004
507100406,"Kiyogoma",217,265,482,5,507,50710,5071004
507100407,"Mwesa",234,286,520,5,507,50710,5071004
507100408,"Rucucu",170,200,370,5,507,50710,5071004
507100409,"Ruhanga",172,185,357,5,507,50710,5071004
507100410,"Rutobotobo",137,171,308,5,507,50710,5071004
507100411,"Rutukura",148,189,337,5,507,50710,5071004
507100501,"Gasenga I",232,296,528,5,507,50710,5071005
507100502,"Gasenga Ii",259,317,576,5,507,50710,5071005
507100503,"Gatare I",296,320,616,5,507,50710,5071005
507100504,"Gatare Ii",196,197,393,5,507,50710,5071005
507100505,"Gatare Iii",200,220,420,5,507,50710,5071005
507100506,"Nyabivumu ",252,254,506,5,507,50710,5071005
507100507,"Nyamata I",243,163,406,5,507,50710,5071005
507100508,"Nyamata Ii",441,365,806,5,507,50710,5071005
507100509,"Rugarama I",724,759,1483,5,507,50710,5071005
507100510,"Rugarama Ii",310,384,694,5,507,50710,5071005
507100511,"Rugarama Iii",172,116,288,5,507,50710,5071005
507100512,"Rwakibirizi I",406,321,727,5,507,50710,5071005
507100513,"Rwakibirizi Ii",304,336,640,5,507,50710,5071005
507110101,"Mabanga",252,279,531,5,507,50711,5071101
507110102,"Mwoshya",263,313,576,5,507,50711,5071101
507110103,"Ntungamo",215,267,482,5,507,50711,5071101
507110104,"Nyabuhoro",269,284,553,5,507,50711,5071101
507110105,"Nyagasozi",159,213,372,5,507,50711,5071101
507110106,"Nyarubande",288,341,629,5,507,50711,5071101
507110107,"Rwabusoro",218,273,491,5,507,50711,5071101
507110201,"Cyahafi",226,231,457,5,507,50711,5071102
507110202,"Gateko",229,260,489,5,507,50711,5071102
507110203,"Gatoki",152,165,317,5,507,50711,5071102
507110204,"Karubagazi",165,197,362,5,507,50711,5071102
507110205,"Nyakabingo",215,263,478,5,507,50711,5071102
507110206,"Nyakabuye",294,330,624,5,507,50711,5071102
507110207,"Nyarusambu",205,220,425,5,507,50711,5071102
507110301,"Cundaminega",161,199,360,5,507,50711,5071103
507110302,"Cyeru",215,260,475,5,507,50711,5071103
507110303,"Kadogori",267,329,596,5,507,50711,5071103
507110304,"Kanombe",158,191,349,5,507,50711,5071103
507110305,"Kayitanga",171,130,301,5,507,50711,5071103
507110306,"Nyagakombe",212,252,464,5,507,50711,5071103
507110307,"Rugandara",177,218,395,5,507,50711,5071103
507110308,"Rurama",193,253,446,5,507,50711,5071103
507110309,"Rushorezo",212,285,497,5,507,50711,5071103
507110401,"Bushonyi",137,144,281,5,507,50711,5071104
507110402,"Kamabare",425,527,952,5,507,50711,5071104
507110403,"Kamugera",182,224,406,5,507,50711,5071104
507110404,"Kiyovu",244,298,542,5,507,50711,5071104
507110405,"Muyange",212,226,438,5,507,50711,5071104
507110406,"Nyagisenyi",165,190,355,5,507,50711,5071104
507110407,"Rubona",192,223,415,5,507,50711,5071104
507110408,"Rugasa",196,209,405,5,507,50711,5071104
507110409,"Rwashangwe",231,245,476,5,507,50711,5071104
507110410,"Tubumba",138,159,297,5,507,50711,5071104
507110501,"Bushenyi",179,226,405,5,507,50711,5071105
507110502,"Gako",245,262,507,5,507,50711,5071105
507110503,"Kamahirwe",250,251,501,5,507,50711,5071105
507110504,"Nsoro",271,250,521,5,507,50711,5071105
507110505,"Rebero",191,215,406,5,507,50711,5071105
507110506,"Rugero",211,228,439,5,507,50711,5071105
507120101,"Bidenge",106,132,238,5,507,50712,5071201
507120102,"Biraro",172,180,352,5,507,50712,5071201
507120103,"Bwiza",121,134,255,5,507,50712,5071201
507120104,"Gako",134,140,274,5,507,50712,5071201
507120105,"Gasarwe",128,165,293,5,507,50712,5071201
507120106,"Gasave",78,104,182,5,507,50712,5071201
507120107,"Gitega",158,170,328,5,507,50712,5071201
507120108,"Kabeza",149,136,285,5,507,50712,5071201
507120109,"Kagarama",133,144,277,5,507,50712,5071201
507120110,"Karambi",194,220,414,5,507,50712,5071201
507120111,"Karambo",162,188,350,5,507,50712,5071201
507120112,"Karirisi",144,162,306,5,507,50712,5071201
507120113,"Marembo",112,122,234,5,507,50712,5071201
507120114,"Nyamisagara",111,112,223,5,507,50712,5071201
507120201,"Gakurazo",135,157,292,5,507,50712,5071202
507120202,"Gatare",185,183,368,5,507,50712,5071202
507120203,"Kamahoro",375,413,788,5,507,50712,5071202
507120204,"Mutarama",305,328,633,5,507,50712,5071202
507120205,"Ruyenzi",167,189,356,5,507,50712,5071202
507120206,"Rwankomati",211,207,418,5,507,50712,5071202
507120207,"Rwavuningoma",214,236,450,5,507,50712,5071202
507120208,"Rwimirama",191,225,416,5,507,50712,5071202
507120301,"Akintwari",256,256,512,5,507,50712,5071203
507120302,"Akumunezero",120,146,266,5,507,50712,5071203
507120303,"Amizero",630,489,1119,5,507,50712,5071203
507120304,"Buhoro",270,343,613,5,507,50712,5071203
507120305,"Byimana",110,127,237,5,507,50712,5071203
507120306,"Gasabo",258,328,586,5,507,50712,5071203
507120307,"Gihushi",185,199,384,5,507,50712,5071203
507120308,"Kabahaya",179,220,399,5,507,50712,5071203
507120309,"Kidogo",171,139,310,5,507,50712,5071203
507120310,"Kimaranzara",211,193,404,5,507,50712,5071203
507120311,"Kivumu",174,205,379,5,507,50712,5071203
507120401,"Akabeza",149,157,306,5,507,50712,5071204
507120402,"Gasave",100,128,228,5,507,50712,5071204
507120403,"Gaseke",120,138,258,5,507,50712,5071204
507120404,"Gasenyi",154,191,345,5,507,50712,5071204
507120405,"Gitovu",107,136,243,5,507,50712,5071204
507120406,"Kagugu",153,168,321,5,507,50712,5071204
507120407,"Kamashya",163,177,340,5,507,50712,5071204
507120408,"Kavumu",172,153,325,5,507,50712,5071204
507120409,"Ntarama",216,235,451,5,507,50712,5071204
507120410,"Nyamure",162,171,333,5,507,50712,5071204
507120411,"Rurambo",184,192,376,5,507,50712,5071204
507120412,"Saruduha",146,145,291,5,507,50712,5071204
507120501,"Cyoma ",2695,375,3070,5,507,50712,5071205
507120502,"Gicaca",278,289,567,5,507,50712,5071205
507120503,"Kamabuye",170,203,373,5,507,50712,5071205
507120504,"Karama",249,277,526,5,507,50712,5071205
507120505,"Mataba",236,250,486,5,507,50712,5071205
507120506,"Mubuga",187,204,391,5,507,50712,5071205
507120507,"Mukoma",230,268,498,5,507,50712,5071205
507120508,"Murambi",245,298,543,5,507,50712,5071205
507120509,"Nyabagendwa",297,327,624,5,507,50712,5071205
507120510,"Nyamizi",188,247,435,5,507,50712,5071205
507120511,"Rwibikara",137,168,305,5,507,50712,5071205
507130101,"Bihari",269,286,555,5,507,50713,5071301
507130102,"Busasamana",180,201,381,5,507,50713,5071301
507130103,"Masenga I",195,208,403,5,507,50713,5071301
507130104,"Masenga Ii",112,143,255,5,507,50713,5071301
507130105,"Mukoma",240,298,538,5,507,50713,5071301
507130106,"Nyagafunzo",328,397,725,5,507,50713,5071301
507130107,"Rugarama",219,224,443,5,507,50713,5071301
507130108,"Rwanzunga",238,284,522,5,507,50713,5071301
507130201,"Butereri",284,294,578,5,507,50713,5071302
507130202,"Kayigi",293,397,690,5,507,50713,5071302
507130203,"Kibaza",271,335,606,5,507,50713,5071302
507130204,"Nyaburiba",210,229,439,5,507,50713,5071302
507130205,"Nyakagarama",290,339,629,5,507,50713,5071302
507130206,"Rwanika",292,321,613,5,507,50713,5071302
507130301,"Gikundamvura",243,294,537,5,507,50713,5071303
507130302,"Kanombe",303,323,626,5,507,50713,5071303
507130303,"Kazabagarura",284,322,606,5,507,50713,5071303
507130304,"Kiyovu",273,271,544,5,507,50713,5071303
507130305,"Rukurazo ",234,255,489,5,507,50713,5071303
507130306,"Rusenyi",196,240,436,5,507,50713,5071303
507130401,"Gatare",217,229,446,5,507,50713,5071304
507130402,"Gatovu",193,261,454,5,507,50713,5071304
507130403,"Kagasera",296,356,652,5,507,50713,5071304
507130404,"Kamweru",315,322,637,5,507,50713,5071304
507130405,"Kibaza",137,167,304,5,507,50713,5071304
507130406,"Kindama",267,277,544,5,507,50713,5071304
507130407,"Rebero",354,360,714,5,507,50713,5071304
507130408,"Ruramba",266,327,593,5,507,50713,5071304
507130409,"Rutare",198,234,432,5,507,50713,5071304
507130410,"Saruduha",329,375,704,5,507,50713,5071304
507130501,"Kimikamba",283,322,605,5,507,50713,5071305
507130502,"Mubano",236,247,483,5,507,50713,5071305
507130503,"Nyabaranga",394,440,834,5,507,50713,5071305
507130504,"Ruhuha I",296,306,602,5,507,50713,5071305
507130505,"Ruhuha Ii",364,314,678,5,507,50713,5071305
507140101,"Agahonnyo",316,319,635,5,507,50714,5071401
507140102,"Batima",419,434,853,5,507,50714,5071401
507140103,"Gasororo",375,405,780,5,507,50714,5071401
507140104,"Gikoma",450,467,917,5,507,50714,5071401
507140105,"Ihara",241,248,489,5,507,50714,5071401
507140106,"Kamudusi",388,410,798,5,507,50714,5071401
507140107,"Mbuganzeri",294,321,615,5,507,50714,5071401
507140108,"Rubira",238,292,530,5,507,50714,5071401
507140109,"Ruhehe",382,382,764,5,507,50714,5071401
507140110,"Twinyange",247,259,506,5,507,50714,5071401
507140201,"Gakindo",284,320,604,5,507,50714,5071402
507140202,"Gasenyi",223,284,507,5,507,50714,5071402
507140203,"Maburane",246,323,569,5,507,50714,5071402
507140204,"Mugina",282,318,600,5,507,50714,5071402
507140205,"Nyiragiseke",264,279,543,5,507,50714,5071402
507140206,"Nyirakanemba",159,153,312,5,507,50714,5071402
507140207,"Nyirarubomboza",246,264,510,5,507,50714,5071402
507140208,"Nzangwa",307,282,589,5,507,50714,5071402
507140209,"Ubukoroco",170,213,383,5,507,50714,5071402
507140301,"Gasasa",122,121,243,5,507,50714,5071403
507140302,"Rukira",31,39,70,5,507,50714,5071403
507140303,"Rusenyi",177,172,349,5,507,50714,5071403
507140401,"Kigina",394,425,819,5,507,50714,5071404
507140402,"Kimpara",366,410,776,5,507,50714,5071404
507140403,"Kimvubu",213,223,436,5,507,50714,5071404
507140404,"Muyoboro",271,327,598,5,507,50714,5071404
507140405,"Nemba",445,405,850,5,507,50714,5071404
507140406,"Nyakabingo",435,437,872,5,507,50714,5071404
507140407,"Rutete",204,191,395,5,507,50714,5071404
507140408,"Rwibinyogote",302,320,622,5,507,50714,5071404
507140409,"Rwiminazi",434,458,892,5,507,50714,5071404
507140501,"Agashoro",266,322,588,5,507,50714,5071405
507140502,"Kivusha",253,306,559,5,507,50714,5071405
507140503,"Mujwiri",388,399,787,5,507,50714,5071405
507140504,"Mushyoroti",216,255,471,5,507,50714,5071405
507140505,"Nkanga",221,248,469,5,507,50714,5071405
507140506,"Ruzo",340,403,743,5,507,50714,5071405
507140601,"Karizinge",109,127,236,5,507,50714,5071406
507140602,"Sharita",207,260,467,5,507,50714,5071406
507150101,"Kabagugu",382,437,819,5,507,50715,5071501
507150102,"Kinteko",192,199,391,5,507,50715,5071501
507150103,"Ngaruye",189,240,429,5,507,50715,5071501
507150104,"Rwamanyoni",259,319,578,5,507,50715,5071501
507150201,"Gakoni",295,313,608,5,507,50715,5071502
507150202,"Nyabaguma",326,403,729,5,507,50715,5071502
507150203,"Rubwirwa",243,242,485,5,507,50715,5071502
507150301,"Gahosha",275,305,580,5,507,50715,5071503
507150302,"Kagarama",350,367,717,5,507,50715,5071503
507150303,"Nziranziza",293,299,592,5,507,50715,5071503
507150304,"Ruli",239,255,494,5,507,50715,5071503
507150401,"Gateko",420,444,864,5,507,50715,5071504
507150402,"Nyamirama",227,256,483,5,507,50715,5071504
507150403,"Rebero",205,238,443,5,507,50715,5071504
507150404,"Rutebe",217,251,468,5,507,50715,5071504
507150501,"Gaseke",312,330,642,5,507,50715,5071505
507150502,"Kamweru",286,276,562,5,507,50715,5071505
507150503,"Ruhanga",273,251,524,5,507,50715,5071505
507150504,"Rutare",318,362,680,5,507,50715,5071505
507150505,"Shyara",244,294,538,5,507,50715,5071505
